price,bedrooms,bathrooms,sqft_living,view,grade,sqft_above,sqft_basement,lat,sqft_living15
221900.0,3,1.0,1180,0,7,1180,0,47.5112,1340
538000.0,3,2.25,2570,0,7,2170,400,47.721,1690
180000.0,2,1.0,770,0,6,770,0,47.7379,2720
604000.0,4,3.0,1960,0,7,1050,910,47.5208,1360
510000.0,3,2.0,1680,0,8,1680,0,47.6168,1800
1225000.0,4,4.5,5420,0,11,3890,1530,47.6561,4760
257500.0,3,2.25,1715,0,7,1715,0,47.3097,2238
291850.0,3,1.5,1060,0,7,1060,0,47.4095,1650
229500.0,3,1.0,1780,0,7,1050,730,47.5123,1780
323000.0,3,2.5,1890,0,7,1890,0,47.3684,2390
662500.0,3,2.5,3560,0,8,1860,1700,47.6007,2210
468000.0,2,1.0,1160,0,7,860,300,47.69,1330
310000.0,3,1.0,1430,0,7,1430,0,47.7558,1780
400000.0,3,1.75,1370,0,7,1370,0,47.6127,1370
530000.0,5,2.0,1810,0,7,1810,0,47.67,1360
650000.0,4,3.0,2950,3,9,1980,970,47.5714,2140
395000.0,3,2.0,1890,0,7,1890,0,47.7277,1890
485000.0,4,1.0,1600,0,7,1600,0,47.6648,1610
189000.0,2,1.0,1200,0,7,1200,0,47.3089,1060
230000.0,3,1.0,1250,0,7,1250,0,47.3343,1280
385000.0,4,1.75,1620,0,7,860,760,47.7025,1400
2000000.0,3,2.75,3050,4,9,2330,720,47.5316,4110
285000.0,5,2.5,2270,0,8,2270,0,47.3266,2240
252700.0,2,1.5,1070,0,7,1070,0,47.3533,1220
329000.0,3,2.25,2450,0,8,2450,0,47.3739,2200
233000.0,3,2.0,1710,0,6,1710,0,47.3048,1030
937000.0,3,1.75,2450,0,8,1750,700,47.6386,1760
667000.0,3,1.0,1400,0,8,1400,0,47.6221,1860
438000.0,3,1.75,1520,0,7,790,730,47.695,1520
719000.0,4,2.5,2570,0,8,2570,0,47.7073,2630
580500.0,3,2.5,2320,0,8,2320,0,47.5391,2580
280000.0,2,1.5,1190,0,7,1190,0,47.7274,1390
687500.0,4,1.75,2330,0,7,1510,820,47.6823,1460
535000.0,3,1.0,1090,0,8,1090,0,47.6889,1570
322500.0,4,2.75,2060,0,7,1280,780,47.4276,2020
696000.0,3,2.5,2300,0,8,1510,790,47.6827,1590
550000.0,4,1.0,1660,0,5,930,730,47.6621,2160
640000.0,4,2.0,2360,0,8,2360,0,47.6702,1730
240000.0,4,1.0,1220,0,7,890,330,47.3341,1290
605000.0,4,2.5,2620,0,8,2620,0,47.5301,2620
625000.0,4,2.5,2570,0,9,2570,0,47.6145,2470
775000.0,4,2.25,4220,0,8,2600,1620,47.445,2410
861990.0,5,2.75,3595,0,9,3595,0,47.6848,3625
685000.0,3,1.0,1570,0,7,1570,0,47.6413,1580
309000.0,3,1.0,1280,0,6,920,360,47.4485,1340
488000.0,3,2.5,3160,0,8,3160,0,47.7443,3050
210490.0,3,1.0,990,0,6,990,0,47.3066,1228
785000.0,4,2.5,2290,0,9,2290,0,47.6194,2680
450000.0,3,1.75,1250,0,7,1250,0,47.6796,970
1350000.0,3,2.5,2753,2,9,2165,588,47.4041,2680
228000.0,3,1.0,1190,0,7,1190,0,47.4258,1190
345000.0,5,2.5,3150,0,8,1640,1510,47.4934,1990
600000.0,3,1.75,1410,0,7,1000,410,47.6808,1410
585000.0,2,1.75,1980,0,7,990,990,47.6989,1480
920000.0,5,2.25,2730,0,8,2130,600,47.6571,2730
885000.0,4,2.5,2830,0,9,2830,0,47.6597,1950
292500.0,4,2.5,2250,0,7,2250,0,47.3663,2250
301000.0,3,2.5,2420,0,8,2420,0,47.3663,2690
951000.0,5,3.25,3250,4,8,3250,0,47.588,2960
430000.0,4,3.0,1850,0,8,1850,0,47.5059,2270
650000.0,3,2.25,2150,3,8,1590,560,47.4336,2570
289000.0,3,1.75,1260,0,7,1260,0,47.4366,1290
505000.0,3,1.75,2519,0,8,2519,0,47.4428,2500
549000.0,3,1.75,1540,0,8,1540,0,47.6765,1580
425000.0,3,2.25,1660,0,7,1110,550,47.6113,1440
317625.0,3,2.75,2770,0,7,1770,1000,47.5747,1440
975000.0,4,2.5,2720,0,10,2720,0,47.5815,2750
287000.0,4,2.5,2240,0,7,2240,0,47.3378,2221
204000.0,3,1.0,1000,0,7,1000,0,47.3621,1010
1325000.0,5,2.25,3200,0,8,1600,1600,47.6303,3390
1040000.0,5,3.25,4770,0,11,3070,1700,47.6525,3530
325000.0,3,2.0,1260,0,7,1260,0,47.7362,1640
571000.0,4,2.0,2750,0,7,2250,500,47.7168,1510
360000.0,4,2.5,2380,0,8,2380,0,47.3608,2420
349000.0,3,1.75,1790,0,7,1090,700,47.3511,1940
832500.0,4,4.0,3430,0,10,2390,1040,47.5822,3240
380000.0,4,1.75,1760,0,7,880,880,47.6034,1680
480000.0,3,1.0,1040,0,7,1040,0,47.5636,890
410000.0,3,1.0,1410,0,7,910,500,47.7073,1130
720000.0,4,2.5,3450,0,10,3450,0,47.342,3350
390000.0,3,2.5,2350,0,8,2350,0,47.3512,2350
360000.0,4,2.5,1900,0,7,1900,0,47.349,1870
355000.0,2,1.0,2020,0,7,1010,1010,47.5474,1720
356000.0,3,1.5,1680,0,8,1680,0,47.4811,1850
315000.0,3,1.0,960,0,6,960,0,47.7264,1570
940000.0,3,1.5,2140,0,9,1900,240,47.6337,2020
305000.0,5,2.25,2660,0,7,2660,0,47.2909,1590
461000.0,3,3.25,2770,0,9,1980,790,47.5228,1900
215000.0,2,2.25,1610,0,7,1610,0,47.518,1950
335000.0,2,1.75,1030,0,7,765,265,47.5394,1030
243500.0,4,2.5,1980,0,7,1980,0,47.2897,1980
1099880.0,5,2.75,3520,0,10,3520,0,47.6506,2520
153000.0,3,1.0,1200,0,7,1200,0,47.322,1350
430000.0,3,1.5,1580,0,8,1290,290,47.687,1570
700000.0,3,1.5,1580,0,8,1290,290,47.687,1570
905000.0,4,2.5,3300,0,7,2390,910,47.5873,1950
247500.0,3,1.75,1960,0,7,1960,0,47.3576,1750
199000.0,4,1.5,1160,0,7,1160,0,47.3036,1160
314000.0,3,1.75,1810,0,7,1210,600,47.4109,1650
437500.0,3,2.5,2320,2,9,2320,0,47.4838,2550
850830.0,3,2.5,2070,0,9,1270,800,47.6415,2200
555000.0,3,2.0,1980,0,7,1440,540,47.6775,1610
699950.0,3,2.25,2190,0,8,2190,0,47.7731,2570
1088000.0,3,2.5,2920,0,8,2920,0,47.5814,2370
290000.0,3,1.0,1210,0,7,1210,0,47.4375,1640
375000.0,3,2.5,2340,0,8,1460,880,47.4431,2250
460000.0,3,1.0,1670,0,7,1170,500,47.6878,1240
188500.0,2,1.75,1240,0,8,1240,0,47.3813,1270
680000.0,4,2.5,3140,0,10,3140,0,47.7304,2990
470000.0,5,1.75,2030,0,7,2030,0,47.6417,2500
597750.0,4,2.5,2310,0,8,2310,0,47.5386,1940
570000.0,3,1.75,1260,0,6,700,560,47.6823,1380
272500.0,3,1.75,1540,0,7,1160,380,47.3624,1540
329950.0,3,1.75,2080,2,7,1080,1000,47.5474,2090
480000.0,4,2.5,3230,3,9,2520,710,47.3183,2640
740500.0,3,3.5,4380,0,8,2780,1600,47.6981,1830
518500.0,3,3.5,1590,0,8,1590,0,47.6824,1620
205425.0,2,1.0,880,0,6,880,0,47.5009,1190
171800.0,4,2.0,1570,0,6,1570,0,47.4965,1880
535000.0,4,1.0,1610,0,7,1610,0,47.587,1610
660000.0,3,2.5,2400,2,8,1560,840,47.7728,2340
391500.0,3,2.0,1450,0,7,1450,0,47.7288,1580
395000.0,2,1.0,770,0,6,770,0,47.6999,1710
445000.0,4,1.75,2100,0,7,1720,380,47.5299,1850
770000.0,3,2.25,2910,0,9,2910,0,47.6897,2700
1450000.0,4,2.75,2750,0,8,1980,770,47.6141,3060
445000.0,3,2.25,2100,2,8,1620,480,47.5091,2660
260000.0,4,2.25,2160,0,8,1360,800,47.3129,2090
822500.0,5,3.5,2320,0,7,1720,600,47.6763,1700
430000.0,4,2.5,2070,0,7,2070,0,47.5319,1970
212000.0,3,1.75,1060,0,7,1060,0,47.2761,1420
660500.0,4,2.25,2010,0,8,1440,570,47.5343,2060
784000.0,3,3.5,3950,0,9,2460,1490,47.697,2480
453246.0,3,2.5,2010,0,8,1390,620,47.5517,1690
675000.0,4,3.5,2140,0,9,2140,0,47.6734,1540
199000.0,3,1.75,1320,0,7,1320,0,47.3257,1550
220000.0,4,1.75,2020,0,7,1010,1010,47.3309,1750
452000.0,4,2.25,2590,0,8,1340,1250,47.7689,1550
382500.0,2,1.0,1190,0,6,1190,0,47.7135,1060
519950.0,3,2.25,1170,0,8,1170,0,47.6722,1350
665000.0,2,1.0,1110,0,7,1110,0,47.6338,1170
527700.0,5,2.5,2820,0,8,1550,1270,47.5707,2820
205000.0,3,1.0,1610,0,7,1010,600,47.4563,1610
420000.0,3,1.0,1060,0,7,940,120,47.7144,1560
500000.0,4,2.25,2030,0,8,1380,650,47.5495,2230
921500.0,4,2.5,3670,0,9,3670,0,47.7421,2840
890000.0,4,1.0,2550,0,8,2370,180,47.6354,2200
430000.0,2,2.5,2420,0,7,2420,0,47.5262,1940
258000.0,5,2.0,2260,0,8,1130,1130,47.3887,1360
511000.0,3,1.0,1430,0,7,980,450,47.6873,1450
532170.0,3,2.0,1360,0,8,1360,0,47.6838,1500
560000.0,3,1.0,1110,0,7,1110,0,47.655,1420
282950.0,3,1.0,1250,0,7,1250,0,47.3255,1680
2250000.0,4,3.25,5180,3,12,3540,1640,47.562,3160
350000.0,1,1.0,700,0,7,700,0,47.679,1010
215000.0,3,1.0,1180,0,7,1180,0,47.4479,1190
650000.0,5,3.5,3960,0,9,2500,1460,47.525,2640
320000.0,4,2.75,2640,0,8,1620,1020,47.3135,1980
247000.0,3,2.0,1270,0,7,1270,0,47.2086,1160
320000.0,4,1.75,1760,0,8,1760,0,47.4715,1730
255000.0,5,2.25,2060,0,7,1030,1030,47.4877,1010
438000.0,3,1.75,1780,0,7,1780,0,47.7171,1200
900000.0,3,2.5,3400,0,10,3400,0,47.6012,3400
441000.0,3,2.75,1910,0,7,1160,750,47.7319,1710
420000.0,3,2.0,2020,0,7,1010,1010,47.4582,2110
370000.0,3,1.75,1580,0,7,1180,400,47.7209,1640
269950.0,2,1.75,1340,0,5,700,640,47.408,1830
807100.0,4,2.5,2680,0,9,2680,0,47.565,2920
653000.0,3,2.5,2680,0,8,1610,1070,47.7028,2480
371500.0,3,2.0,1370,0,7,1370,0,47.7458,1770
284000.0,3,1.75,1560,0,7,1560,0,47.4776,1070
272000.0,3,1.75,2160,0,7,1670,490,47.3026,1930
313000.0,3,1.5,1340,0,7,1340,0,47.7658,1480
917500.0,4,2.5,3880,0,10,2570,1310,47.6477,3740
673000.0,4,2.25,2590,0,8,2590,0,47.5619,2260
425000.0,3,2.5,1120,0,8,820,300,47.6106,1590
399950.0,5,2.75,1970,0,7,1320,650,47.5868,1280
385000.0,3,1.0,1220,0,6,1220,0,47.6101,1200
269950.0,3,1.5,1950,2,7,1320,630,47.1976,1950
330000.0,2,1.0,1350,0,7,1060,290,47.7224,1540
260000.0,3,2.5,1670,0,7,1670,0,47.3505,1670
470000.0,4,3.0,2380,0,7,1680,700,47.5384,1410
589000.0,4,3.0,2440,0,7,2440,0,47.7044,2290
163500.0,2,1.5,1050,0,7,1050,0,47.3848,1050
835000.0,4,2.75,3130,0,9,2140,990,47.6993,2260
1095000.0,5,3.0,4090,2,10,2090,2000,47.6627,2540
269000.0,4,1.75,1490,0,8,1100,390,47.3099,2190
560000.0,3,2.5,1900,0,8,1900,0,47.62,2030
615000.0,4,1.0,1330,0,6,1330,0,47.65,1330
585188.0,3,2.25,2230,0,8,1430,800,47.6647,2230
305000.0,3,1.75,1650,0,7,1220,430,47.726,1540
166950.0,3,1.0,1190,0,6,1190,0,47.4616,1230
799000.0,3,2.5,2140,0,8,2140,0,47.5505,2680
400000.0,3,2.5,2180,0,7,1420,760,47.7606,1900
230000.0,3,1.0,1060,0,7,1060,0,47.7481,1570
256883.0,3,2.5,1690,0,8,1690,0,47.2779,2550
423000.0,4,2.0,1970,0,7,1130,840,47.5511,1500
465000.0,3,2.5,2150,0,8,2150,0,47.5488,1750
440000.0,3,2.5,1910,0,7,1910,0,47.5385,2330
385000.0,3,1.75,1350,0,7,1350,0,47.4058,1560
210000.0,3,1.0,860,0,6,860,0,47.5093,1300
297000.0,3,2.5,1940,0,8,1940,0,47.3777,2030
470000.0,3,1.0,1010,0,7,1010,0,47.675,1680
226500.0,3,1.5,1300,0,7,900,400,47.3025,1430
274250.0,3,1.0,910,0,6,910,0,47.4787,1400
840000.0,4,1.75,2480,0,9,1630,850,47.5378,2770
677900.0,3,2.5,2440,0,8,2440,0,47.7073,2750
425000.0,3,1.0,1010,0,7,1010,0,47.5733,1290
180250.0,2,0.75,900,0,6,900,0,47.4604,1250
464000.0,6,3.0,2300,0,7,1600,700,47.7067,1560
320000.0,4,2.25,1550,0,8,1550,0,47.354,1630
625504.0,3,2.25,1270,0,8,1060,210,47.6647,1160
592500.0,4,2.5,2240,0,9,2240,0,47.6143,2520
465000.0,3,2.5,2714,0,9,2714,0,47.3185,2590
477000.0,4,2.75,1720,0,8,1720,0,47.5458,2130
280000.0,2,1.0,850,0,6,850,0,47.4889,1100
1505000.0,5,3.0,3300,3,9,1870,1430,47.5673,3836
445838.0,3,2.5,2250,0,8,2250,0,47.5133,1320
1072000.0,2,2.25,3900,3,8,1950,1950,47.5884,2580
467000.0,2,1.5,1320,0,8,1320,0,47.7145,2120
686000.0,4,2.5,2760,0,10,2760,0,47.5836,3070
279950.0,3,2.0,1750,0,7,1350,400,47.398,1900
527000.0,4,2.25,2330,0,8,2330,0,47.7663,1910
325000.0,3,2.25,2220,0,8,1780,440,47.3758,2080
328000.0,3,2.25,2020,0,7,2020,0,47.3828,2020
390000.0,3,2.25,1250,0,7,1250,0,47.5123,1280
479950.0,2,2.0,1510,0,8,1510,0,47.7076,1640
264950.0,4,2.25,1720,0,7,1120,600,47.2922,1510
235000.0,3,1.0,1430,0,7,980,450,47.4075,1960
516500.0,3,2.5,1480,0,7,1480,0,47.6794,2250
655000.0,2,1.75,1450,4,7,1230,220,47.4497,2030
500000.0,4,2.75,2280,0,7,2280,0,47.5218,2280
315000.0,6,2.75,2940,0,8,1780,1160,47.3103,2120
213000.0,2,1.0,1000,0,6,1000,0,47.5687,1150
475000.0,3,1.5,2480,0,7,1620,860,47.5575,2090
1025000.0,5,4.0,3760,0,10,3760,0,47.6489,3430
416000.0,3,2.0,2220,0,7,1640,580,47.3459,2070
410000.0,4,1.0,1970,0,7,1670,300,47.6136,1510
800000.0,3,3.5,3830,0,10,3530,300,47.7641,2920
472000.0,6,2.5,4410,2,9,2350,2060,47.3376,2600
225000.0,3,1.75,1430,0,7,1430,0,47.3173,1190
210000.0,2,1.0,830,0,6,830,0,47.5308,830
455000.0,2,1.0,1430,0,7,1430,0,47.6727,1450
225000.0,3,1.0,1300,0,6,1300,0,47.3221,1260
480000.0,2,1.0,1030,2,7,790,240,47.6779,1390
363000.0,3,2.5,2740,0,9,2740,0,47.3076,2570
2400000.0,4,2.5,3650,4,9,1830,1820,47.6338,3120
181000.0,2,1.5,720,0,6,720,0,47.5218,1150
250000.0,4,2.0,2010,0,7,2010,0,47.2785,2010
481000.0,3,1.75,1560,0,6,770,790,47.6846,1390
260000.0,3,2.0,1810,0,7,1240,570,47.3656,1750
455000.0,4,2.5,3360,0,9,3360,0,47.4369,3060
415000.0,3,2.25,1510,0,8,1510,0,47.4616,1730
349500.0,3,1.0,1400,0,7,800,600,47.5405,1620
245000.0,3,2.5,1730,0,7,1730,0,47.3507,1630
592500.0,2,2.0,1420,2,7,1420,0,47.6979,1420
385000.0,4,1.75,2360,0,7,1180,1180,47.5278,1910
315000.0,3,1.75,1580,0,7,1200,380,47.4756,1550
255000.0,3,1.0,1230,0,7,1230,0,47.4437,1380
693000.0,4,2.5,2460,0,8,2460,0,47.7048,2990
780000.0,3,1.0,1660,0,8,1460,200,47.6362,1660
237000.0,3,1.75,1270,0,7,1270,0,47.4207,1600
525000.0,3,2.25,2100,0,10,1320,780,47.6154,2380
425000.0,2,1.0,770,0,5,770,0,47.5964,1330
369900.0,1,0.75,760,4,5,760,0,47.4683,1230
290000.0,4,2.5,1700,0,7,1700,0,47.4045,1950
285000.0,3,1.0,1120,0,7,1120,0,47.5544,1130
415000.0,2,1.0,1070,0,7,1070,0,47.6802,1320
272500.0,3,2.5,2070,0,8,1420,650,47.2988,2070
2900000.0,4,3.25,5050,2,11,4750,300,47.6312,3890
1365000.0,4,4.75,5310,0,11,5310,0,47.7285,4180
436000.0,2,1.0,1040,0,7,1040,0,47.7107,1440
210000.0,3,1.0,1700,0,7,1700,0,47.3271,1350
236000.0,3,1.0,1300,0,7,1300,0,47.5053,1320
331000.0,3,1.75,1080,0,7,580,500,47.6601,1440
365000.0,3,2.5,2653,0,8,2653,0,47.4145,2653
450000.0,3,2.0,2290,0,8,2290,0,47.4672,1660
770000.0,4,2.75,3820,0,9,2850,970,47.7618,1860
455000.0,4,2.5,2210,0,8,2210,0,47.3828,2670
405000.0,3,1.75,2390,0,6,1240,1150,47.5362,2020
304900.0,4,1.75,2600,0,7,1610,990,47.3954,1720
170000.0,2,1.0,860,0,6,860,0,47.5048,1650
2050000.0,5,3.0,3830,1,9,2630,1200,47.6166,3050
780000.0,4,2.5,3500,0,9,3500,0,47.6811,3920
330000.0,3,3.0,2420,0,8,1740,680,47.7486,2570
370000.0,4,2.5,2720,0,9,2720,0,47.3846,2410
467000.0,5,2.25,2500,0,7,1850,650,47.7564,2300
405000.0,3,1.75,1670,0,7,1140,530,47.7198,1670
675000.0,5,2.25,2900,0,8,1450,1450,47.5461,2310
500000.0,2,1.0,1640,0,7,1140,500,47.5712,1520
389999.0,4,2.5,1890,0,7,1890,0,47.4281,2410
630000.0,4,1.75,2950,2,8,1780,1170,47.7128,2120
360000.0,4,2.5,2160,0,9,2160,0,47.3341,2280
580000.0,4,3.0,3280,0,8,2270,1010,47.5399,2320
550000.0,3,2.0,1970,3,8,1270,700,47.5717,2390
879000.0,4,2.5,3360,0,10,3360,0,47.5951,3150
265000.0,3,2.0,1320,0,7,1320,0,47.3536,1740
446500.0,3,2.5,2650,0,8,2650,0,47.5084,2400
404000.0,3,1.5,2030,0,7,1330,700,47.5586,2140
267500.0,3,1.75,1590,2,7,1090,500,47.4427,1630
3075000.0,4,5.0,4550,4,10,2600,1950,47.6053,4550
335000.0,3,2.5,2440,0,8,2440,0,47.3494,2510
576000.0,3,2.5,1940,0,7,970,970,47.6933,2190
208633.0,3,2.5,2040,0,8,2040,0,47.3537,2370
315000.0,3,2.25,2200,0,7,1120,1080,47.476,1460
725000.0,3,1.75,1920,0,8,960,960,47.6239,1740
550000.0,4,2.75,1800,0,8,1400,400,47.7776,1800
610750.0,4,2.25,2180,0,8,2180,0,47.6459,2250
550700.0,2,1.0,1010,0,6,1010,0,47.6692,1460
665000.0,4,2.75,3320,0,8,2220,1100,47.5376,2720
834000.0,4,2.5,2370,2,8,1980,390,47.601,2440
201000.0,5,1.75,1660,0,6,1660,0,47.529,1660
2384000.0,5,2.5,3650,4,10,3370,280,47.6345,2880
1384000.0,4,3.25,4290,3,11,2690,1600,47.5503,3860
1400000.0,4,3.25,4290,3,11,2690,1600,47.5503,3860
305000.0,4,2.25,1950,0,8,1350,600,47.4441,2150
487000.0,3,2.0,2590,0,8,1720,870,47.7357,1570
390000.0,3,2.5,1930,0,8,1930,0,47.346,2350
548000.0,2,1.0,1470,0,7,1170,300,47.6638,1570
268750.0,4,1.0,800,0,6,800,0,47.48,1310
819900.0,5,2.75,3150,0,9,3150,0,47.6759,1560
520000.0,3,2.25,2030,0,8,2030,0,47.5162,2660
230000.0,3,2.0,1450,0,7,1450,0,47.2639,1520
240000.0,3,1.75,1510,0,7,1510,0,47.2929,1510
232000.0,2,1.0,1240,0,6,960,280,47.4957,1820
240500.0,2,1.0,1240,0,6,960,280,47.4957,1820
274975.0,3,2.5,3030,0,9,3030,0,47.7721,3080
740000.0,4,2.0,2050,0,9,2050,0,47.644,2320
186375.0,3,1.0,1000,0,7,1000,0,47.472,1150
790000.0,3,2.25,2370,0,9,1590,780,47.592,2500
880000.0,4,3.5,2800,0,9,1890,910,47.669,2370
279000.0,6,1.75,2240,0,7,2240,0,47.42,1590
295000.0,3,2.0,1810,2,8,1810,0,47.1913,1910
640000.0,2,1.0,1070,0,7,1070,0,47.6666,1710
940000.0,4,2.0,2490,0,9,2490,0,47.5639,2770
260000.0,4,2.5,1960,0,7,1960,0,47.3483,1800
559900.0,3,2.75,2930,0,9,1860,1070,47.7648,2580
791500.0,4,2.0,1510,0,7,1510,0,47.6794,1820
265000.0,3,1.75,1420,0,7,1420,0,47.7535,1740
245000.0,3,1.75,1740,0,7,1740,0,47.4945,880
485000.0,4,1.75,2560,0,7,2560,0,47.6945,2560
684000.0,4,3.5,3040,0,9,2420,620,47.5222,3470
425000.0,3,1.75,2500,0,8,1300,1200,47.7222,1580
309600.0,4,1.75,1275,0,6,1275,0,47.3796,1660
552250.0,4,2.5,2580,0,8,2580,0,47.5374,2380
165000.0,4,1.0,1000,0,6,1000,0,47.4897,1020
239900.0,4,1.0,1000,0,6,1000,0,47.4897,1020
320000.0,2,1.0,1070,0,6,1070,0,47.4716,1360
206600.0,3,2.0,1390,0,7,1390,0,47.3581,1720
387000.0,4,1.75,2500,0,7,1250,1250,47.7713,2040
299000.0,1,0.75,560,0,4,560,0,47.675,1300
855000.0,4,2.75,2270,0,9,2270,0,47.5603,2610
315000.0,3,1.0,1900,0,7,1300,600,47.4147,1940
437500.0,2,1.0,990,2,7,790,200,47.68,1930
252000.0,4,1.5,1550,0,7,1050,500,47.3117,1640
375000.0,4,1.75,2200,0,7,1100,1100,47.543,1600
300000.0,4,2.5,1910,0,7,1910,0,47.3607,2010
420000.0,4,1.0,1750,0,7,1750,0,47.5759,1750
900000.0,3,1.0,1330,0,7,1330,0,47.6891,1340
679900.0,3,2.5,2440,2,9,1980,460,47.565,1520
463000.0,3,2.5,1640,0,7,1640,0,47.6359,1580
380000.0,5,2.5,2760,0,9,2760,0,47.4769,2470
329500.0,4,2.5,1820,0,7,1820,0,47.3845,1820
604950.0,3,2.5,2110,0,8,1340,770,47.6743,2040
795000.0,5,2.5,3040,2,8,1640,1400,47.5651,2920
465000.0,3,2.0,1840,0,7,1840,0,47.4853,1380
673000.0,4,2.5,2990,0,9,2990,0,47.4508,2140
810000.0,4,2.5,3520,0,10,3520,0,47.6375,3400
785000.0,4,2.75,2440,0,8,1910,530,47.5944,2770
338000.0,4,3.0,2090,0,7,1370,720,47.4888,1810
280000.0,3,2.25,1430,0,7,1430,0,47.5112,1430
315000.0,4,2.25,2180,0,7,1100,1080,47.7711,1810
530000.0,4,2.25,2180,0,7,1100,1080,47.7711,1810
380000.0,5,3.0,3450,0,9,3450,0,47.2813,2860
297000.0,3,2.25,1450,0,7,1450,0,47.5038,1650
730000.0,4,2.5,3230,0,10,3230,0,47.5823,3480
450000.0,3,1.75,1640,0,7,1110,530,47.7164,1770
275000.0,3,3.0,1590,0,7,1060,530,47.3624,1680
595000.0,4,2.0,2020,0,7,2020,0,47.6831,1910
435000.0,3,1.5,1300,0,7,1300,0,47.592,1590
270000.0,2,1.5,1380,0,6,1380,0,47.7461,3130
950000.0,3,3.0,4040,0,10,3030,1010,47.7268,3360
389000.0,4,2.25,2130,0,7,2130,0,47.7237,2300
560000.0,4,2.25,2550,0,8,1580,970,47.6283,2420
1350000.0,5,3.5,4800,2,11,3480,1320,47.5543,4050
799000.0,4,2.25,2510,0,8,2510,0,47.5483,2450
365500.0,3,2.0,1410,0,7,1410,0,47.7591,1410
252350.0,3,2.0,1650,0,7,1160,490,47.4612,1710
403950.0,4,2.5,2120,0,8,2120,0,47.4987,1880
385000.0,4,1.5,2040,0,7,1380,660,47.772,1610
345000.0,4,1.0,1550,0,7,1550,0,47.5287,1450
490000.0,3,2.75,1980,0,9,1980,0,47.6109,1950
330000.0,3,2.5,1600,0,8,1600,0,47.7736,1790
927000.0,4,2.75,3300,0,8,3300,0,47.6294,3180
1118000.0,4,2.5,3840,1,10,3840,0,47.5634,3600
330000.0,2,1.0,1220,0,7,1220,0,47.7405,2000
530000.0,5,2.25,2720,0,7,1500,1220,47.5976,2110
365000.0,4,2.0,1940,0,8,1940,0,47.5722,2000
378750.0,3,2.5,2160,0,7,1260,900,47.5644,1060
269900.0,4,1.75,1530,0,7,1530,0,47.4556,1390
557000.0,3,3.5,1710,0,8,1290,420,47.6055,1630
360000.0,4,1.75,3730,0,7,2150,1580,47.1775,1880
352000.0,2,1.0,940,0,7,940,0,47.6879,1560
437000.0,3,2.5,1750,0,8,1750,0,47.4807,2430
322500.0,4,2.5,1820,0,7,1820,0,47.3845,1820
650000.0,3,3.25,1510,0,9,1330,180,47.5815,1510
450000.0,3,2.0,1290,0,8,1290,0,47.6609,1290
278500.0,3,2.0,1570,0,7,1570,0,47.3163,1570
364950.0,4,2.5,1930,0,8,1930,0,47.4309,2090
840000.0,4,3.5,2840,4,10,2840,0,47.401,3180
268000.0,3,2.5,1550,0,7,1550,0,47.404,1550
517534.0,2,1.0,833,0,5,833,0,47.3889,1380
632925.0,3,2.5,2990,0,8,2990,0,47.7718,2990
577500.0,3,2.5,2000,0,9,2000,0,47.7067,2450
339000.0,4,1.5,2390,2,7,2390,0,47.504,2850
570000.0,3,1.75,2910,0,7,1530,1380,47.7015,2520
563500.0,4,1.75,2085,0,7,1610,475,47.5753,2690
423000.0,4,2.25,2200,0,7,1290,910,47.7448,1910
355000.0,3,2.25,1860,0,8,1860,0,47.7318,2320
1550000.0,5,4.25,6070,0,12,6070,0,47.5954,4680
482000.0,2,1.0,950,0,7,950,0,47.6885,1320
625000.0,3,1.75,1600,0,7,1600,0,47.5724,1580
538000.0,3,2.5,2250,0,8,2250,0,47.5272,2360
380000.0,3,2.5,2280,0,8,2280,0,47.4334,2310
375000.0,2,1.0,940,0,7,940,0,47.6073,1300
245000.0,3,2.5,1530,0,7,1030,500,47.3592,1850
310000.0,5,1.75,2190,0,7,2190,0,47.4546,1620
1300000.0,3,2.0,2350,0,8,1770,580,47.6408,3530
397000.0,4,2.0,1440,0,7,1200,240,47.7245,1460
365000.0,3,2.5,2200,0,8,2200,0,47.4362,2310
328500.0,4,3.0,2290,0,9,2290,0,47.3739,2290
988000.0,4,3.0,4040,0,11,4040,0,47.7205,3930
1000000.0,4,2.5,2610,0,8,1920,690,47.6636,1810
237000.0,3,2.5,1490,0,7,1490,0,47.4324,1490
525000.0,4,2.5,2450,0,8,2450,0,47.7734,2300
749000.0,4,2.5,1710,0,9,1440,270,47.559,2140
722500.0,5,2.5,4870,0,10,3470,1400,47.633,3180
843000.0,3,2.5,3130,0,10,3130,0,47.6954,2860
438000.0,2,2.0,1270,0,8,1270,0,47.6776,1610
578000.0,3,1.75,2120,2,8,1540,580,47.504,2460
227950.0,3,1.5,1670,0,7,1670,0,47.2613,2077
196000.0,3,2.25,2070,0,7,2070,0,47.3417,1890
641000.0,2,1.0,1420,0,8,1070,350,47.6694,2400
350000.0,3,1.5,1250,0,6,1250,0,47.4056,1930
205000.0,3,1.0,940,0,7,940,0,47.3838,1150
400000.0,3,1.75,1920,0,7,1920,0,47.7487,1920
1030000.0,3,2.5,3545,0,10,2610,935,47.5534,3630
505000.0,3,2.0,1260,0,7,1260,0,47.7355,1510
475000.0,5,2.5,2340,0,7,1300,1040,47.7206,1930
520000.0,3,2.25,2590,0,8,1440,1150,47.7691,2580
1450000.0,3,4.5,3970,2,10,3260,710,47.7183,2610
333500.0,3,1.75,1220,0,7,1220,0,47.7736,1630
232000.0,3,1.0,1400,0,6,1400,0,47.362,1230
691100.0,3,2.75,2360,0,8,1710,650,47.5698,2120
811000.0,3,1.75,1870,0,8,1870,0,47.5505,1900
551000.0,3,2.5,2830,0,9,2830,0,47.7605,2500
496500.0,3,2.5,2260,0,8,2260,0,47.7356,2350
705000.0,3,3.0,1970,3,9,1770,200,47.3844,2280
578000.0,4,2.5,3140,2,9,1770,1370,47.4904,2460
255000.0,3,1.75,1240,0,7,1240,0,47.3663,1490
1050000.0,4,3.5,3450,0,10,3450,0,47.5637,3220
348000.0,3,2.25,2570,0,8,2570,0,47.3759,2400
230000.0,3,2.0,1510,0,7,1510,0,47.3912,1570
359500.0,4,2.25,2390,0,9,2390,0,47.3305,2480
330000.0,3,1.0,980,0,6,980,0,47.7617,1220
80000.0,1,0.75,430,0,4,430,0,47.6499,1200
465000.0,3,1.75,1480,0,7,1480,0,47.7311,1480
325000.0,4,2.5,1850,0,8,1850,0,47.3701,2100
340500.0,3,2.0,2270,0,7,1920,350,47.4857,1770
342500.0,3,2.5,1810,0,8,1810,0,47.3724,1810
290900.0,2,2.0,1610,0,6,1610,0,47.4855,1310
868700.0,3,4.25,3840,0,10,3840,0,47.6336,3230
1199000.0,4,2.75,4110,1,9,3130,980,47.717,2820
1150000.0,4,3.25,4190,0,11,3150,1040,47.6332,4300
859900.0,4,2.75,3390,0,9,3390,0,47.5906,3390
520000.0,4,2.25,1890,0,7,1890,0,47.5461,1580
460000.0,3,2.5,1610,2,9,1080,530,47.5674,1610
438924.0,3,1.5,1050,0,7,850,200,47.6943,1770
315000.0,2,1.0,630,0,5,630,0,47.5486,1420
590000.0,4,2.75,2910,2,8,1780,1130,47.6658,2920
378500.0,4,1.75,1700,0,7,850,850,47.5772,1620
328500.0,3,2.5,1950,0,9,1950,0,47.3875,2350
849950.0,3,3.0,2990,0,8,2990,0,47.6344,2230
525000.0,3,1.5,1350,2,7,900,450,47.5275,1730
1385000.0,4,3.25,4860,0,9,4860,0,47.6179,3850
295000.0,4,2.5,2160,0,8,1460,700,47.3078,2060
1067000.0,6,3.5,4860,0,11,3860,1000,47.5521,3600
207950.0,2,2.0,890,0,6,890,0,47.5158,1860
699900.0,4,2.75,2810,0,9,2810,0,47.5985,2820
1280000.0,5,2.5,3400,1,8,3400,0,47.5645,3080
452000.0,4,1.5,1580,0,7,960,620,47.6734,1560
370000.0,3,2.0,1680,1,7,1680,0,47.4734,1680
232000.0,3,1.75,1300,0,7,1300,0,47.3811,1300
669950.0,5,2.5,2820,0,7,2380,440,47.7081,1910
397500.0,3,2.0,1510,0,7,1070,440,47.7193,1660
490000.0,2,2.5,1230,0,8,870,360,47.6192,1240
725000.0,4,2.0,2110,0,9,1710,400,47.5836,1440
299000.0,3,2.75,3080,2,7,1610,1470,47.3841,2424
625000.0,2,1.5,1490,0,7,1190,300,47.5872,1590
437500.0,3,2.5,2120,0,7,2120,0,47.5322,2530
650000.0,4,2.5,3180,0,9,3180,0,47.5416,3030
475000.0,2,1.0,1490,0,7,860,630,47.6799,1460
342000.0,3,2.0,1930,0,8,1930,0,47.3672,2200
1197350.0,4,2.5,2770,0,10,2770,0,47.684,2720
280000.0,3,1.5,1670,0,7,1670,0,47.4404,1930
240000.0,2,1.75,1330,0,7,1330,0,47.4467,1450
529000.0,3,1.0,1210,0,7,1210,0,47.6729,1640
442000.0,3,1.0,1190,0,7,1030,160,47.5346,1690
615000.0,2,1.0,1540,0,7,820,720,47.6454,1420
1485000.0,4,3.75,4030,0,10,4030,0,47.6821,2160
585000.0,4,1.75,2430,0,8,1580,850,47.7206,1980
480000.0,4,2.5,2600,0,8,2600,0,47.4877,2830
1095000.0,5,3.5,4410,0,9,4410,0,47.6554,2900
290000.0,4,1.0,1330,0,7,1330,0,47.7343,1220
615000.0,3,1.75,1900,0,7,950,950,47.5789,1770
300000.0,2,1.0,1100,0,7,1100,0,47.7439,1460
308000.0,3,1.0,1980,0,6,1580,400,47.3818,1860
750000.0,3,2.5,2400,0,9,2400,0,47.6734,2080
2250000.0,4,2.25,4760,0,9,3390,1370,47.6415,2950
890000.0,4,3.25,3180,0,10,3180,0,47.4711,2200
288000.0,3,1.0,1190,0,6,1190,0,47.452,1190
190000.0,2,1.0,630,0,6,630,0,47.4973,1470
515000.0,5,3.0,2530,0,8,1520,1010,47.7546,2290
235000.0,4,1.5,1690,0,5,1690,0,47.4667,1690
275000.0,2,1.0,940,0,6,940,0,47.5186,940
727500.0,2,2.0,1240,0,7,1240,0,47.6221,1380
650000.0,4,2.5,3040,0,7,3040,0,47.683,2740
1600000.0,6,5.0,6050,3,11,6050,0,47.6033,4210
365000.0,4,1.0,1590,0,6,1590,0,47.7315,1320
662000.0,3,1.75,2500,0,9,2500,0,47.6917,2590
270500.0,3,2.5,1780,0,7,1320,460,47.3608,1680
200000.0,2,1.5,1360,0,7,1360,0,47.2852,1360
970000.0,4,3.25,4740,0,10,4740,0,47.5931,3340
160000.0,3,1.5,1010,0,7,1010,0,47.4097,1400
204000.0,3,1.0,1040,0,6,1040,0,47.3105,1580
358000.0,3,2.25,1610,0,7,1610,0,47.4296,1780
452000.0,4,1.75,1570,0,7,1570,0,47.7373,1870
595000.0,2,2.0,1510,0,7,1010,500,47.6582,1920
249000.0,3,2.0,1360,0,7,1360,0,47.3577,1360
346900.0,4,2.5,1970,0,8,1970,0,47.449,2230
2125000.0,3,2.5,5403,4,12,5403,0,47.4169,3980
280000.0,4,2.5,1560,0,7,1560,0,47.5025,1560
318888.0,4,1.75,2320,0,8,2270,50,47.3644,2120
530000.0,3,2.25,2120,0,8,2120,0,47.5896,2480
375000.0,3,2.25,2120,0,8,2120,0,47.3914,2120
910000.0,4,2.5,3350,0,11,3350,0,47.7197,3920
782000.0,4,2.5,2380,0,10,2380,0,47.5623,2560
259950.0,2,2.0,1070,0,9,720,350,47.5213,1070
315000.0,4,2.75,2300,0,7,1560,740,47.4518,1870
215000.0,2,1.0,1320,0,6,1320,0,47.4949,1190
705000.0,3,1.75,2180,2,7,1140,1040,47.5885,2180
1450000.0,3,3.0,4380,3,10,3580,800,47.6452,3080
451000.0,3,1.75,1790,0,7,1790,0,47.749,1520
261000.0,2,1.0,750,0,6,750,0,47.4727,1340
396000.0,3,1.5,1300,0,7,1300,0,47.7403,1570
725000.0,4,2.5,2990,3,9,2990,0,47.5146,3715
1950000.0,7,3.5,4640,1,11,2860,1780,47.5666,3230
238000.0,4,1.0,1400,0,7,1400,0,47.4339,1310
750000.0,6,1.75,2750,0,8,2750,0,47.6368,2040
331500.0,4,2.5,2050,0,7,2050,0,47.3628,2050
460000.0,4,3.0,2230,0,7,1410,820,47.52,1960
404950.0,4,2.25,2340,0,8,2340,0,47.2953,2340
880000.0,3,2.5,2870,0,9,2870,0,47.6935,1630
863000.0,4,2.5,4120,0,10,4120,0,47.6239,3180
638700.0,3,1.75,2080,0,7,1370,710,47.5846,1870
435000.0,3,2.5,1840,0,7,1840,0,47.6969,1600
260000.0,3,1.0,1180,0,6,1180,0,47.505,1490
671500.0,5,2.75,2160,0,7,1530,630,47.667,2040
610000.0,3,1.0,1180,0,8,1180,0,47.6376,1440
405000.0,2,0.75,1160,0,6,870,290,47.6929,1870
338900.0,4,2.5,1830,0,7,1830,0,47.3572,1830
720000.0,4,4.0,3200,0,10,3200,0,47.5816,3480
442000.0,5,3.0,2560,0,7,1760,800,47.5502,1080
650000.0,5,2.75,2550,0,8,2550,0,47.6136,1590
263500.0,3,1.75,1330,0,7,1040,290,47.4478,1330
300000.0,2,1.0,1220,0,7,1220,0,47.4219,2010
266000.0,3,2.5,1805,0,7,1805,0,47.3521,2095
930000.0,4,4.0,6050,2,9,4150,1900,47.7466,2700
530000.0,4,2.5,2320,0,8,2320,0,47.7727,2450
180000.0,3,1.0,1384,0,6,1384,0,47.3062,1000
619000.0,3,2.5,2720,0,9,2720,0,47.5422,3180
264000.0,3,1.5,1820,0,7,1820,0,47.3366,1380
730000.0,2,2.25,2130,4,7,1530,600,47.573,2130
439000.0,4,2.25,2060,0,7,2060,0,47.7258,2060
268500.0,4,1.75,1420,0,7,1080,340,47.4025,1500
330000.0,3,1.75,1510,0,7,1510,0,47.476,1470
640000.0,3,2.5,2160,0,8,1960,200,47.6045,2160
900000.0,3,2.5,3180,0,11,3180,0,47.6366,3030
370000.0,3,2.25,2110,0,8,2110,0,47.3725,2470
685000.0,3,2.0,2060,0,8,1330,730,47.5897,1910
505000.0,3,1.5,1830,0,7,1010,820,47.6277,2450
265000.0,3,1.75,1820,0,7,1820,0,47.1803,2050
290000.0,3,2.5,1610,0,8,1610,0,47.4489,1610
296000.0,4,2.5,1780,0,7,1780,0,47.3665,2020
360000.0,4,2.5,1840,0,7,1840,0,47.4964,1830
240500.0,3,1.75,1460,0,7,990,470,47.492,1220
372500.0,2,2.5,1400,0,8,1400,0,47.5496,1540
595000.0,3,2.5,3370,2,9,3370,0,47.5008,3330
515000.0,4,3.0,3590,0,9,3590,0,47.2846,2860
1220000.0,4,2.25,3200,0,9,3200,0,47.5494,3070
507000.0,2,1.75,1670,0,8,1670,0,47.7123,2170
399950.0,4,2.0,2420,0,9,2420,0,47.3131,2560
185000.0,3,1.75,1430,0,7,1430,0,47.3122,1560
460000.0,3,1.75,1440,0,7,1440,0,47.6947,1440
435500.0,3,2.25,1450,0,7,1450,0,47.5665,1560
469000.0,4,2.75,3550,0,8,2100,1450,47.425,2050
531000.0,2,3.0,1270,0,8,1110,160,47.6634,1290
443500.0,2,1.0,940,0,7,940,0,47.7047,1150
223000.0,3,2.0,1670,0,7,1300,370,47.3666,1660
590000.0,4,3.5,3100,0,8,2400,700,47.7466,2200
340000.0,2,2.5,1100,0,7,1100,0,47.6972,1200
650000.0,3,2.0,1870,0,8,1230,640,47.6372,1780
533600.0,3,2.5,1930,0,8,1930,0,47.5694,2190
695000.0,3,2.75,2540,0,9,2540,0,47.6214,2600
242000.0,3,1.75,1280,0,7,1280,0,47.3961,1500
425000.0,3,2.25,1820,0,7,1280,540,47.7162,1810
525000.0,3,2.25,1490,0,7,1490,0,47.6844,1290
485000.0,3,2.5,1880,0,8,1880,0,47.5737,2040
175000.0,3,1.0,1250,0,7,1250,0,47.4474,1390
210000.0,3,2.0,1440,0,8,1440,0,47.3128,1700
260000.0,3,2.5,1920,0,7,1920,0,47.4022,1930
577000.0,3,2.5,2060,0,7,1330,730,47.5671,1920
200000.0,3,1.5,1210,0,7,1210,0,47.2876,1408
605000.0,2,1.75,1760,0,7,940,820,47.682,1530
325000.0,3,1.0,990,0,6,990,0,47.7125,1440
289500.0,3,1.0,960,0,6,820,140,47.496,1200
559950.0,3,2.5,1660,0,9,1660,0,47.5876,1660
1042500.0,3,1.75,1900,1,8,1330,570,47.6821,2760
543500.0,3,2.25,1270,0,7,990,280,47.6581,1920
480000.0,4,2.25,3250,0,9,3250,0,47.3496,3110
218000.0,3,1.0,960,0,6,960,0,47.1951,1080
565000.0,2,1.75,1330,0,7,960,370,47.6539,1620
426700.0,3,1.75,2080,0,7,1600,480,47.5375,1680
650000.0,3,2.5,2690,3,8,2130,560,47.7605,2390
542000.0,2,1.0,890,0,7,770,120,47.6663,1760
415000.0,3,1.75,1070,0,7,1070,0,47.6978,1200
214000.0,3,1.0,1200,0,6,1200,0,47.3221,1200
245000.0,3,1.5,1360,0,7,1360,0,47.4488,1220
314500.0,3,2.0,2050,0,8,2050,0,47.2681,2180
1120000.0,3,1.5,3000,0,9,2000,1000,47.5821,1820
378000.0,2,2.0,1300,0,7,800,500,47.5395,950
305000.0,4,2.5,2250,0,7,1340,910,47.336,1540
595000.0,5,2.75,3740,0,8,1980,1760,47.7679,2620
729500.0,3,2.5,1660,1,9,1530,130,47.5818,1510
430000.0,3,2.5,2360,0,7,2360,0,47.5317,2360
240000.0,3,1.75,1760,0,7,1150,610,47.3647,1760
545000.0,3,1.75,1680,0,7,1680,0,47.5338,1680
530000.0,3,1.75,1320,0,7,870,450,47.6681,1580
157000.0,1,1.0,870,0,6,870,0,47.4152,1250
425000.0,4,1.0,1260,0,6,1260,0,47.5044,1170
220000.0,3,1.0,1000,0,6,1000,0,47.4793,1300
521000.0,4,1.75,2020,0,8,1550,470,47.7627,2520
325000.0,3,1.0,1920,2,7,1120,800,47.5193,2000
597500.0,3,2.0,2150,0,7,1380,770,47.555,1940
337000.0,3,2.5,1470,0,7,1470,0,47.526,1490
1000000.0,3,2.5,3180,2,10,3180,0,47.655,3000
3070000.0,3,2.5,3930,4,8,2330,1600,47.7022,2730
495000.0,3,1.0,990,0,6,990,0,47.6718,1250
748000.0,4,3.5,2770,0,8,1970,800,47.6327,2180
888000.0,3,1.5,1250,0,7,1250,0,47.6245,1750
269900.0,3,1.75,1140,0,7,1140,0,47.4761,1150
496500.0,4,2.5,2250,0,7,1550,700,47.5221,2090
475000.0,3,2.5,1640,0,7,1640,0,47.7522,1880
312000.0,3,1.5,1255,0,7,1255,0,47.7145,1307
323000.0,3,1.0,1290,0,7,1290,0,47.7404,1390
331000.0,3,1.75,1300,0,7,1300,0,47.4834,1890
306000.0,3,1.5,1220,0,8,1220,0,47.7049,1220
655000.0,4,2.5,2630,0,8,2630,0,47.6915,1640
290000.0,3,1.5,1950,0,8,1950,0,47.336,1940
1250000.0,4,3.25,3160,0,9,2360,800,47.6597,2220
460000.0,3,1.75,1550,0,7,860,690,47.6759,1880
435000.0,4,2.5,1700,0,7,850,850,47.6988,1380
664000.0,4,2.75,2510,0,8,1630,880,47.5427,2390
865000.0,4,1.75,1800,3,8,1800,0,47.6462,2180
385000.0,3,1.75,1800,0,8,1200,600,47.4406,1800
497000.0,3,2.25,1870,0,7,1350,520,47.705,2230
280000.0,2,1.0,1010,0,7,1010,0,47.4965,1150
188000.0,2,1.5,1120,0,6,1120,0,47.5024,1690
478500.0,3,1.0,2090,2,8,1200,890,47.5304,1850
1145000.0,4,3.5,4370,0,11,4370,0,47.544,4190
222000.0,3,2.0,1440,0,7,970,470,47.291,1440
799000.0,4,3.0,2580,0,8,2580,0,47.6932,3440
609900.0,4,2.5,3190,0,10,3190,0,47.3558,3250
413000.0,4,3.5,2380,0,7,1750,630,47.5536,1620
400000.0,4,1.0,1420,0,7,1420,0,47.6942,1110
802541.0,5,2.75,2990,0,9,2990,0,47.5462,2870
320000.0,3,2.5,2680,0,8,2680,0,47.2918,2430
507000.0,4,2.5,2730,0,7,2730,0,47.5441,2730
387500.0,3,1.0,1220,0,6,1220,0,47.6982,1490
396000.0,3,1.0,1500,0,7,1500,0,47.7415,1820
373000.0,3,1.75,1830,1,8,1430,400,47.4862,2140
1484900.0,5,2.5,4570,0,10,4570,0,47.5553,3180
359900.0,4,2.25,2470,0,8,2470,0,47.4406,2330
410000.0,2,1.0,800,0,6,670,130,47.6997,1210
690000.0,4,2.5,2900,0,9,2900,0,47.6726,2900
245000.0,3,2.0,1410,0,7,1410,0,47.3702,1670
700000.0,5,2.5,2830,1,8,1610,1220,47.5896,2670
268000.0,4,1.75,1680,0,7,1100,580,47.3923,2400
225000.0,3,1.75,1760,0,7,920,840,47.3664,1350
980000.0,4,2.25,2240,0,8,2240,0,47.5894,2300
795000.0,2,1.0,1380,2,5,1380,0,47.5708,1500
195000.0,2,1.0,820,0,6,820,0,47.5156,1170
480000.0,4,2.0,2180,0,6,1730,450,47.589,2180
485000.0,4,2.0,1400,0,7,1100,300,47.6385,1630
130000.0,2,1.0,880,0,5,880,0,47.4672,1410
325000.0,2,1.0,1060,2,6,1060,0,47.3444,2240
440000.0,3,1.75,1530,0,7,1530,0,47.731,1530
550000.0,4,1.75,2480,3,8,1460,1020,47.7646,2910
310000.0,3,1.75,1490,0,6,1490,0,47.5015,1350
530000.0,3,2.5,3660,2,9,3260,400,47.2413,2700
390000.0,4,2.5,2340,0,8,2340,0,47.4206,1970
243000.0,3,1.75,1450,0,7,1450,0,47.3575,1210
639000.0,4,2.5,2210,0,9,2210,0,47.6285,2440
215000.0,4,1.0,1130,0,7,1130,0,47.3437,1540
405000.0,5,1.75,1550,0,7,1100,450,47.7573,1420
250000.0,4,1.75,1710,0,7,1010,700,47.3745,1770
405500.0,3,1.5,1010,0,7,1010,0,47.7359,1300
452000.0,6,2.25,2660,0,7,2660,0,47.7142,1120
730000.0,6,2.25,2660,0,7,2660,0,47.7142,1120
267000.0,3,2.0,1300,0,7,1300,0,47.3131,1430
289950.0,3,2.5,1670,0,7,1670,0,47.3668,2390
565000.0,2,1.0,960,0,7,960,0,47.6893,1300
1578000.0,4,3.25,4670,0,12,4670,0,47.635,4230
636000.0,3,2.5,2140,0,8,1770,370,47.6664,2510
350000.0,5,3.0,2520,0,8,1550,970,47.4938,1700
320000.0,3,1.5,1650,0,7,1130,520,47.4525,1720
210000.0,2,1.75,1440,0,8,1440,0,47.3825,1320
245000.0,2,1.0,1050,0,7,1050,0,47.5326,1280
328000.0,3,1.75,1470,0,7,1130,340,47.4818,1590
985000.0,4,2.25,4230,0,11,4230,0,47.7287,3890
501000.0,3,1.75,1970,3,8,1370,600,47.4908,2460
315000.0,3,2.25,1540,0,7,1540,0,47.4429,1560
403000.0,3,2.75,2090,0,8,2090,0,47.7336,2280
550000.0,3,2.0,2380,0,8,2110,270,47.7591,2030
347500.0,4,2.5,2156,0,9,2156,0,47.3591,1708
365000.0,4,2.25,2070,0,8,2070,0,47.4388,2390
588000.0,3,1.0,1910,0,8,1270,640,47.7004,1500
605000.0,3,1.75,1920,0,8,1260,660,47.5633,2360
1300000.0,3,3.25,3400,0,9,2290,1110,47.6585,3090
233000.0,3,2.0,1400,0,7,1400,0,47.3415,2020
360000.0,4,2.5,2210,0,8,2210,0,47.3818,2210
459000.0,2,1.75,1170,0,6,1020,150,47.695,1170
740000.0,3,2.0,2100,0,9,2100,0,47.7479,2290
305000.0,3,1.0,1160,0,7,1160,0,47.7422,1160
395000.0,3,1.0,1500,0,6,900,600,47.6921,950
560000.0,4,2.5,2940,0,8,2940,0,47.7533,2510
650000.0,4,1.75,2010,1,7,1300,710,47.5793,2180
449950.0,3,2.5,2170,0,7,2170,0,47.7767,2010
517500.0,3,1.5,1430,3,7,1250,180,47.6988,2210
435000.0,4,1.5,1510,0,7,1070,440,47.7121,1450
329999.0,3,1.0,1150,0,6,800,350,47.7447,1150
950000.0,3,1.75,2150,4,8,1140,1010,47.5671,2510
447000.0,3,1.0,1370,0,7,1230,140,47.5646,1370
699800.0,2,2.5,2380,0,8,2380,0,47.717,1870
850000.0,3,1.75,1370,0,7,770,600,47.6374,1390
316500.0,3,1.75,1600,0,7,1070,530,47.3272,2140
942500.0,5,3.5,3750,2,9,2030,1720,47.5511,3270
1310000.0,2,2.25,3950,4,10,2910,1040,47.5912,3220
856600.0,4,2.25,2400,0,9,2400,0,47.5987,2580
405600.0,5,1.5,2830,0,8,2830,0,47.5132,1480
565000.0,4,2.5,2440,0,8,2440,0,47.6333,2560
400000.0,3,2.25,1190,0,8,1050,140,47.5818,1210
330000.0,3,2.0,1400,0,7,1400,0,47.7576,2230
374950.0,4,2.75,2730,0,7,2730,0,47.3608,2230
405300.0,3,2.75,2390,0,7,1610,780,47.4987,1920
560000.0,3,2.25,2060,0,8,2060,0,47.6216,2160
824000.0,4,2.25,2490,0,8,1290,1200,47.6051,2360
260000.0,3,1.75,1100,0,7,1100,0,47.363,1400
760000.0,4,2.5,2430,0,8,1470,960,47.6777,2180
405000.0,3,2.5,3170,0,10,2360,810,47.3384,2970
429900.0,4,2.5,2640,0,8,2640,0,47.4598,2240
341500.0,3,1.5,1130,0,7,1130,0,47.5089,1320
465250.0,5,2.0,1940,0,7,1940,0,47.7751,1940
450000.0,2,2.0,1100,0,7,1100,0,47.6797,1390
390000.0,3,1.0,1200,0,7,1200,0,47.5771,1370
420000.0,3,2.25,2000,0,8,1000,1000,47.6188,2070
269950.0,3,2.5,1890,0,8,1730,160,47.4802,1910
493000.0,4,2.0,1910,0,7,1060,850,47.6101,1520
370000.0,4,2.5,2710,0,9,2710,0,47.3314,2520
2250000.0,5,4.25,4860,1,10,3100,1760,47.6196,3150
305000.0,3,1.0,1250,0,7,1250,0,47.475,1450
400000.0,3,1.75,1590,0,6,970,620,47.7146,2030
320000.0,3,1.5,1240,0,8,1050,190,47.7073,1180
715000.0,4,1.0,2000,0,7,2000,0,47.6583,1260
650000.0,6,2.75,3610,0,8,3610,0,47.6261,2560
218000.0,5,1.75,1930,0,8,1930,0,47.3109,2370
500000.0,2,1.0,1280,0,7,1280,0,47.6949,1540
460000.0,4,2.0,2090,0,7,2090,0,47.4691,2380
232500.0,3,1.5,1940,0,7,1140,800,47.3289,1410
408200.0,3,2.5,1800,0,7,1800,0,47.5293,1800
522000.0,3,1.75,1730,0,7,1400,330,47.6792,1830
675000.0,4,2.5,2810,0,9,2810,0,47.6337,3100
1355000.0,4,3.5,3550,2,11,2260,1290,47.5506,4100
249950.0,4,1.0,1330,0,6,1330,0,47.492,1570
210000.0,2,1.0,750,0,6,750,0,47.4781,1460
429950.0,4,1.0,1760,0,7,1090,670,47.7041,1180
737500.0,4,2.5,3200,0,9,3200,0,47.6304,2930
710000.0,4,2.0,1740,0,8,1740,0,47.6815,1850
470000.0,3,2.5,2100,0,8,2100,0,47.5341,2100
1100000.0,4,3.5,4270,0,12,4270,0,47.7354,3510
650000.0,3,2.0,1340,0,7,1340,0,47.6518,2030
1216000.0,4,2.5,3190,3,9,1680,1510,47.5619,3160
422120.0,3,2.5,1630,0,8,1630,0,47.7148,1380
625000.0,5,2.5,2990,0,9,2990,0,47.746,3150
385200.0,4,1.0,1550,0,6,1550,0,47.5222,1220
500000.0,3,2.25,1690,0,8,1690,0,47.5756,1800
308000.0,4,2.25,1960,0,8,1960,0,47.3405,1910
565000.0,3,2.75,2390,0,8,1360,1030,47.5433,2140
581000.0,3,2.5,2600,0,7,2600,0,47.6799,2600
361000.0,3,2.0,1950,0,8,1950,0,47.39,2330
345000.0,3,1.0,1250,0,7,1250,0,47.6329,1530
419000.0,2,2.25,1180,0,8,840,340,47.6124,1310
347000.0,3,2.5,1680,0,7,1680,0,47.4802,2160
625000.0,4,2.25,2220,0,9,2220,0,47.5839,3000
2400000.0,4,4.25,4890,2,11,3090,1800,47.5602,3470
379000.0,3,3.25,2660,0,8,2660,0,47.3077,1320
310000.0,3,1.5,1150,0,7,1150,0,47.5707,1150
250000.0,2,2.0,1130,0,6,1130,0,47.3839,1320
682000.0,5,2.75,2760,0,9,2760,0,47.539,2870
246500.0,3,2.0,1430,0,7,1430,0,47.2118,1580
325000.0,3,1.0,1490,0,5,1490,0,47.2597,1580
310950.0,4,2.5,2030,0,8,2030,0,47.393,2095
1100000.0,3,2.0,3010,2,9,1890,1120,47.6347,2688
287500.0,3,1.0,1810,0,7,1130,680,47.7493,1810
431000.0,3,1.0,1810,0,7,1130,680,47.7493,1810
226000.0,3,1.0,970,0,6,970,0,47.5282,1290
825000.0,3,1.75,2010,0,7,1510,500,47.682,1600
175000.0,4,1.0,1300,0,6,1300,0,47.4778,1240
465750.0,3,1.5,1260,0,7,1260,0,47.6357,1800
659000.0,4,2.25,2610,0,8,2610,0,47.5771,2550
595000.0,3,1.75,1910,3,8,1110,800,47.6898,1630
350000.0,3,2.25,1780,0,8,1780,0,47.4622,1780
270000.0,4,2.25,1900,0,8,1900,0,47.3102,2120
662500.0,6,2.25,2450,2,7,1340,1110,47.6061,1850
249900.0,3,1.75,1380,0,5,1380,0,47.294,1490
324500.0,3,1.75,1920,0,7,1230,690,47.3272,1980
430000.0,2,1.75,1350,0,8,1350,0,47.7176,1350
419950.0,2,1.75,1350,0,8,1350,0,47.7176,1350
285000.0,4,1.75,2510,2,8,1290,1220,47.3748,1790
332000.0,4,2.5,2470,0,8,2470,0,47.3337,2100
282000.0,4,1.75,1660,0,7,960,700,47.5033,1340
320000.0,3,1.0,1340,0,7,940,400,47.7321,1020
428750.0,3,1.0,1620,0,7,1620,0,47.5719,2440
330000.0,3,2.25,2300,0,8,2300,0,47.2477,1760
456500.0,4,3.5,2000,0,8,2000,0,47.7027,1440
352000.0,3,2.25,1640,0,8,1640,0,47.4723,1870
664000.0,4,2.0,1530,0,7,1530,0,47.6645,1860
628000.0,3,1.75,4000,0,9,2190,1810,47.7738,2530
512000.0,3,1.75,1610,0,7,1080,530,47.6618,1780
254000.0,3,2.0,2070,0,7,1450,620,47.3085,1630
535800.0,4,2.5,1900,0,8,1900,0,47.5691,2030
287653.0,3,1.0,1050,0,7,1050,0,47.3841,1610
438000.0,3,2.5,1520,0,8,1180,340,47.5446,1270
450000.0,4,1.75,2390,0,7,1750,640,47.7557,1840
327000.0,5,2.75,2400,0,8,2400,0,47.2635,2400
370500.0,4,2.5,1790,0,7,1790,0,47.4829,1950
265000.0,3,2.5,1720,0,7,1720,0,47.3898,1570
450000.0,4,2.75,2980,0,8,1800,1180,47.5152,1920
425000.0,3,1.0,1520,3,8,1520,0,47.5081,2640
166600.0,3,1.75,1150,0,7,1150,0,47.3729,1330
245000.0,1,0.75,380,0,5,380,0,47.481,1170
565000.0,3,1.0,910,0,7,910,0,47.6742,1520
539900.0,3,1.75,1650,0,8,1230,420,47.6963,1930
910000.0,3,3.5,2480,0,10,2480,0,47.5951,1980
280000.0,4,2.5,2050,0,8,2050,0,47.2658,2050
275000.0,3,2.25,1420,0,7,1420,0,47.3576,1560
467000.0,3,2.5,3460,0,7,3460,0,47.4802,2490
457500.0,3,2.5,1500,0,8,1500,0,47.5682,1730
381156.0,2,1.0,1320,0,7,1320,0,47.5517,1270
289999.0,5,2.5,2180,0,8,1220,960,47.3122,2050
642450.0,3,1.75,1830,0,7,1230,600,47.5962,1950
469950.0,3,2.25,1620,0,7,1220,400,47.6071,1600
795000.0,3,2.0,2920,2,8,1460,1460,47.6652,2920
785000.0,4,2.5,3300,0,10,3300,0,47.6323,2820
860000.0,3,2.25,3060,0,10,3060,0,47.5611,3060
1095000.0,0,0.0,3064,2,7,3064,0,47.6362,2360
147500.0,3,1.0,1530,0,7,1530,0,47.404,1380
390000.0,3,2.0,1910,0,7,1410,500,47.7356,2040
229000.0,3,1.0,1020,0,7,1020,0,47.3586,1020
185000.0,3,1.0,1150,0,6,1150,0,47.494,1120
414900.0,3,1.5,1260,0,7,870,390,47.7004,1620
200000.0,4,2.0,1920,0,6,920,1000,47.5507,1120
225000.0,4,2.25,1800,0,8,1800,0,47.2959,2060
720000.0,3,1.75,2040,0,7,1360,680,47.6675,1610
930000.0,4,2.5,2200,0,8,1430,770,47.6402,2100
1270000.0,5,2.5,3200,0,7,2160,1040,47.6209,4090
700000.0,5,3.25,2400,0,7,1780,620,47.6094,2100
466000.0,2,1.5,1140,0,7,1140,0,47.6608,1170
374000.0,3,1.5,1330,0,7,1330,0,47.7364,1460
480000.0,3,2.5,1940,0,8,1940,0,47.7438,2810
740000.0,3,2.5,3000,0,9,3000,0,47.6724,3000
1010000.0,4,1.0,1820,0,8,1820,0,47.6476,1820
395000.0,4,2.5,2910,0,8,2910,0,47.3782,2740
340000.0,2,1.0,1090,0,6,1090,0,47.5185,1200
209000.0,3,2.0,1230,0,7,1020,210,47.526,1260
431650.0,5,2.5,1710,0,7,1710,0,47.5922,1530
980000.0,5,2.5,3160,0,9,1780,1380,47.5368,3260
660000.0,3,2.5,2680,0,9,2680,0,47.7637,2670
730000.0,4,2.25,2190,0,8,1840,350,47.6916,2190
291500.0,3,1.75,1260,0,7,1260,0,47.3592,1640
905000.0,4,3.5,2970,0,9,2340,630,47.5627,3680
800000.0,4,2.5,2570,0,10,2570,0,47.7418,3420
839900.0,4,3.5,3810,1,9,2560,1250,47.5134,3230
200000.0,1,1.5,1010,0,8,950,60,47.5492,1360
300000.0,3,2.0,1480,0,7,1080,400,47.4614,1850
530000.0,3,1.75,1250,0,7,1250,0,47.69,1180
314950.0,3,2.25,1654,0,7,1654,0,47.3627,1654
255000.0,3,1.75,1410,0,7,1410,0,47.3969,1630
550000.0,5,2.75,2160,0,7,1500,660,47.5728,2160
435000.0,3,1.0,1400,0,6,700,700,47.5499,1470
234000.0,3,1.75,1420,0,7,1420,0,47.3113,1660
615000.0,4,2.25,2500,0,8,1600,900,47.639,2500
205000.0,3,2.0,1410,0,7,1410,0,47.3315,1410
384000.0,4,1.75,2100,0,7,1050,1050,47.5353,1730
324000.0,3,2.5,1750,0,8,1750,0,47.4315,2050
645000.0,3,1.75,2070,0,7,1130,940,47.6733,1800
570000.0,3,3.25,1570,0,8,1260,310,47.6655,1000
324000.0,3,2.5,1920,0,8,1920,0,47.4095,1920
270000.0,2,1.0,1000,0,6,1000,0,47.527,1100
290000.0,5,1.5,2120,0,7,2120,0,47.4599,1730
250000.0,3,2.0,1440,0,7,1440,0,47.3702,1390
342000.0,3,1.75,1660,0,7,1660,0,47.6903,1520
255000.0,3,1.5,1340,0,7,1340,0,47.4405,1340
800000.0,3,2.25,2380,0,9,1450,930,47.5371,2750
451000.0,3,1.75,1560,2,7,1000,560,47.5666,1430
990000.0,4,2.5,2780,3,7,1390,1390,47.6597,2860
288400.0,4,2.5,1860,0,7,1220,640,47.4046,1860
420000.0,3,1.5,2390,0,8,1750,640,47.5383,1690
359000.0,2,2.75,1370,0,8,1080,290,47.7052,1370
390000.0,4,3.0,2570,0,7,1420,1150,47.4417,2260
300000.0,3,2.5,1320,0,7,1320,0,47.5355,1320
545000.0,5,2.5,2520,0,7,1500,1020,47.7096,2030
288349.0,3,1.0,1250,0,6,1250,0,47.3414,1920
299900.0,3,2.25,1560,0,7,1290,270,47.3023,1660
891000.0,4,2.0,2330,0,7,1720,610,47.6804,2090
1200000.0,3,2.0,3660,3,9,1830,1830,47.6972,2680
378000.0,4,2.5,2790,0,8,2790,0,47.3556,2820
299995.0,2,1.0,1060,0,6,1060,0,47.7463,1850
253000.0,3,2.5,2020,0,7,1310,710,47.3545,1710
350000.0,3,2.25,1580,0,7,1580,0,47.5583,1980
565000.0,4,3.0,2020,0,6,2020,0,47.6653,1290
315000.0,2,1.0,970,0,6,970,0,47.5513,1490
570000.0,4,3.0,1490,1,7,1490,0,47.5446,1990
971000.0,5,3.5,4390,0,9,3350,1040,47.7174,2010
915000.0,5,2.5,2750,0,9,1840,910,47.6364,1460
419000.0,4,1.5,2150,0,7,2150,0,47.4522,2150
260000.0,4,1.75,1810,0,7,1230,580,47.3275,1870
1321500.0,3,3.0,2230,0,9,2230,0,47.6271,2260
369950.0,3,1.0,2430,0,7,2430,0,47.4895,1660
1029900.0,3,2.5,3680,0,10,3680,0,47.5484,3600
435000.0,5,1.0,1410,0,6,1410,0,47.5453,1360
601000.0,3,1.75,1330,0,8,1330,0,47.7012,2600
460500.0,3,1.0,1490,0,7,1150,340,47.663,1730
720000.0,3,2.5,2020,3,8,2020,0,47.6617,1920
851000.0,4,2.5,3130,0,10,3130,0,47.5878,2840
550000.0,4,3.0,2670,2,7,2670,0,47.5784,2300
700000.0,4,1.0,1980,0,7,1980,0,47.6606,1810
323000.0,3,1.75,2100,0,7,2100,0,47.3622,1930
345500.0,3,1.0,1350,0,6,1350,0,47.7612,2080
378000.0,4,1.5,2140,0,7,1190,950,47.5491,2140
650000.0,4,2.0,2208,0,8,2208,0,47.5711,1760
385000.0,3,2.0,1010,0,7,1010,0,47.6273,1650
425000.0,2,1.0,970,0,7,970,0,47.6233,1670
210000.0,4,2.0,1520,0,6,1520,0,47.2105,1390
630000.0,4,2.5,2740,0,9,2740,0,47.7649,2740
335000.0,3,1.75,1570,1,7,1300,270,47.4999,1590
196500.0,3,1.0,1320,0,7,1320,0,47.3461,1320
582800.0,4,2.75,2550,0,8,1440,1110,47.6471,2290
440000.0,3,1.75,1560,0,7,1250,310,47.7283,1540
752500.0,4,2.25,2360,0,8,2360,0,47.6495,2360
532500.0,3,1.75,1330,0,7,1210,120,47.5724,1500
265000.0,3,1.0,1070,0,7,1070,0,47.4061,1840
397500.0,3,1.25,1510,3,6,810,700,47.7289,2560
524250.0,3,2.5,1710,0,8,1710,0,47.546,2120
765000.0,4,2.75,2790,0,10,2790,0,47.5515,3080
648000.0,4,2.5,2620,0,9,2620,0,47.6301,2590
469500.0,5,2.5,2970,0,8,1670,1300,47.3908,2100
237500.0,3,1.75,1050,0,7,1050,0,47.3011,1360
216000.0,3,1.0,1280,0,7,1280,0,47.3298,1420
427200.0,3,1.0,1030,0,7,1030,0,47.5364,1270
280000.0,3,2.25,1900,0,8,1390,510,47.4545,1730
718000.0,5,3.0,3070,0,9,1740,1330,47.5702,2550
420000.0,2,2.75,1760,0,8,1760,0,47.5175,1870
379000.0,2,1.0,930,0,7,930,0,47.6971,1050
326100.0,2,1.0,880,0,6,880,0,47.7145,1370
535000.0,3,2.5,1360,0,7,1310,50,47.6774,1365
283000.0,4,2.75,2130,0,7,1560,570,47.1949,2130
260000.0,3,1.0,1480,0,6,1120,360,47.5048,1460
399000.0,4,1.0,1500,0,7,1500,0,47.5303,980
484950.0,3,2.25,1670,0,8,1670,0,47.5688,1850
640000.0,4,1.75,2060,0,8,2060,0,47.5867,2260
585000.0,4,2.5,2160,0,8,1660,500,47.6948,1520
645000.0,4,2.0,2780,3,8,1190,1590,47.7293,2580
253000.0,3,2.0,1490,0,7,1490,0,47.3211,1590
178500.0,2,1.0,740,0,6,740,0,47.5077,1170
291000.0,4,2.5,1860,0,7,1860,0,47.3492,1860
199950.0,2,2.75,1590,0,5,1590,0,47.2786,1310
553500.0,2,1.0,850,0,7,850,0,47.6707,1300
189950.0,2,1.0,1030,0,8,1030,0,47.3738,1450
289000.0,3,2.0,1850,0,8,1850,0,47.3225,2250
700000.0,4,2.0,1830,0,8,1830,0,47.6593,1650
270000.0,3,2.0,1560,0,7,1560,0,47.4312,1610
258000.0,4,1.75,1730,0,7,1230,500,47.327,1840
530000.0,3,2.5,1930,0,8,1930,0,47.7191,1930
245000.0,3,2.25,1422,0,7,1422,0,47.3204,1677
563000.0,3,2.0,1380,0,7,1380,0,47.6807,1350
515000.0,3,2.5,2430,0,8,2430,0,47.5346,2500
325000.0,4,2.5,2610,0,9,2610,0,47.3017,2610
540000.0,3,2.25,2000,0,8,2000,0,47.5599,2220
280300.0,2,1.0,920,0,6,490,430,47.7008,1500
460000.0,4,1.75,1750,0,7,1050,700,47.6802,1640
475000.0,3,1.75,2020,0,7,1180,840,47.7571,2140
900000.0,4,2.25,2460,0,9,2460,0,47.6042,2830
538200.0,4,3.0,1780,0,8,1780,0,47.627,1810
429000.0,2,1.0,1080,0,7,1080,0,47.6078,2230
164808.0,3,1.0,1250,0,7,1250,0,47.5064,1490
520000.0,4,2.25,1870,0,7,1870,0,47.6937,1970
475000.0,3,1.75,1700,0,8,1230,470,47.7221,1800
283000.0,4,1.5,1480,0,6,1480,0,47.4809,1530
321500.0,4,2.5,1930,0,8,1930,0,47.3572,1930
840000.0,4,2.75,3130,0,10,3130,0,47.7083,3330
287000.0,3,2.25,1370,0,7,1370,0,47.3484,1370
375000.0,3,1.75,960,0,7,960,0,47.6737,1650
349500.0,3,1.75,1260,0,7,1260,0,47.7263,1330
446450.0,3,1.5,1480,0,7,1480,0,47.5144,1140
315000.0,4,2.5,1930,0,7,1930,0,47.4065,1930
271310.0,2,1.0,870,0,6,870,0,47.5849,1190
315000.0,4,1.0,1300,0,7,1300,0,47.7612,1330
245000.0,3,1.75,1490,0,7,1490,0,47.3682,1880
543115.0,2,1.0,1380,0,8,1030,350,47.6382,1380
900000.0,4,2.0,1190,0,7,1190,0,47.6908,1190
2450000.0,4,4.25,4250,3,10,2870,1380,47.5747,3640
554000.0,2,2.0,1920,0,8,1920,0,47.7107,1670
249900.0,3,1.75,2080,0,6,2080,0,47.267,1690
768000.0,3,2.5,3220,2,9,2690,530,47.5468,3460
980000.0,4,3.0,3680,3,10,2060,1620,47.6327,3140
395000.0,5,2.5,2070,0,7,1270,800,47.4997,1950
415000.0,3,1.75,1480,0,7,1480,0,47.6969,1360
380000.0,4,2.5,2000,0,8,2000,0,47.3559,2430
566000.0,3,2.5,1560,0,8,1560,0,47.5985,2170
218500.0,2,1.0,1600,0,7,1390,210,47.3098,1502
550000.0,4,2.5,1940,0,7,1140,800,47.683,2200
512031.0,3,1.75,1540,2,7,770,770,47.6769,1420
197500.0,2,1.0,820,0,6,820,0,47.452,1660
470000.0,3,2.25,1780,0,7,1230,550,47.701,1780
590000.0,3,1.75,1560,0,7,1560,0,47.6493,2320
465000.0,4,2.25,2210,0,8,1270,940,47.7725,2030
499000.0,2,1.75,2040,0,7,2040,0,47.4985,1850
515000.0,3,2.25,1920,0,8,1920,0,47.5498,2260
716500.0,3,1.75,1930,0,9,1230,700,47.6582,2300
410000.0,3,2.0,1700,0,6,890,810,47.6542,1440
850000.0,4,3.25,3450,0,8,2450,1000,47.5437,1750
1050000.0,4,3.25,3440,0,10,3440,0,47.6476,3440
648000.0,4,2.5,2380,0,10,2380,0,47.5833,2730
620000.0,4,2.25,2400,0,7,1460,940,47.6763,1250
935000.0,4,4.5,5670,2,11,5670,0,47.323,4100
379000.0,3,1.0,1140,0,7,1140,0,47.7168,1140
699000.0,3,1.75,1670,0,7,1270,400,47.6416,1460
528000.0,4,2.25,1910,0,8,1280,630,47.7259,1860
425000.0,3,1.75,1560,0,8,1560,0,47.5197,2200
249500.0,2,1.75,1500,0,7,1500,0,47.3643,1220
1035480.0,5,3.25,4475,0,9,4475,0,47.6849,3720
790000.0,4,2.75,2840,3,9,1640,1200,47.5271,2790
399950.0,3,1.0,1020,0,7,1020,0,47.5254,1750
275000.0,3,1.5,1410,0,7,1410,0,47.7635,1910
550000.0,3,1.0,1520,0,8,1520,0,47.6347,1880
140000.0,1,1.0,730,0,4,730,0,47.467,1790
250000.0,3,1.0,1190,0,7,990,200,47.5658,1760
318000.0,3,2.25,1410,2,7,1410,0,47.3983,2050
505000.0,2,1.0,1240,0,7,1240,0,47.597,3050
470500.0,5,2.5,2500,0,8,1300,1200,47.5415,2090
360000.0,3,1.0,1050,0,7,1050,0,47.7071,1380
1242500.0,4,2.75,2680,4,9,1480,1200,47.5634,2940
986000.0,3,2.5,2380,2,9,1340,1040,47.5262,2560
515000.0,2,1.0,1060,0,7,860,200,47.6231,1060
320000.0,3,1.75,2300,0,8,1310,990,47.477,1160
310000.0,4,3.0,2010,0,7,1090,920,47.5042,1470
356700.0,2,1.0,1090,0,7,730,360,47.5258,990
775000.0,4,1.75,2320,0,7,1510,810,47.6397,1840
325000.0,3,1.0,1040,0,6,1040,0,47.7565,1140
208000.0,4,2.75,1810,0,7,1810,0,47.3668,1740
825000.0,2,1.0,1150,4,6,1150,0,47.502,2440
515000.0,3,2.5,2360,2,9,2360,0,47.3356,2390
490000.0,3,1.5,1970,0,8,1420,550,47.6163,1940
675000.0,4,3.0,2690,0,8,2690,0,47.4458,2820
360000.0,4,2.5,2080,0,7,1040,1040,47.572,1340
550000.0,4,2.5,2080,0,7,1040,1040,47.572,1340
225000.0,3,1.5,1370,0,7,1370,0,47.4973,1400
500000.0,3,2.75,3410,0,8,3410,0,47.4497,2260
385000.0,4,2.0,1850,0,8,1850,0,47.4702,2110
837700.0,5,2.75,3010,0,10,3010,0,47.696,2890
448000.0,3,2.25,1530,0,7,1530,0,47.6817,1560
730000.0,5,1.75,2690,0,7,1420,1270,47.5831,2600
575000.0,4,1.5,2810,2,8,1490,1320,47.5252,2240
430000.0,3,1.75,1810,0,7,1240,570,47.7299,1460
435000.0,3,2.5,1560,0,7,1560,0,47.687,1600
241000.0,3,1.0,1010,0,6,1010,0,47.3006,1200
453500.0,2,1.75,1000,0,6,600,400,47.6261,2120
285000.0,2,1.5,990,0,7,990,0,47.7218,1050
151000.0,2,1.0,720,0,5,720,0,47.4965,860
1570000.0,5,4.5,6070,0,11,6070,0,47.5306,4750
631000.0,5,2.0,2270,0,7,2270,0,47.6051,1320
285000.0,2,2.5,1380,0,7,1140,240,47.5462,1580
195000.0,3,1.0,1260,0,6,840,420,47.3274,1140
817500.0,4,2.5,2910,0,9,2910,0,47.5859,2720
550000.0,3,2.0,1810,0,7,1810,0,47.5953,1490
1127000.0,4,2.5,3160,0,9,3160,0,47.6699,3000
609850.0,2,2.75,1910,0,9,1910,0,47.6544,1910
200000.0,3,1.0,1230,0,6,1230,0,47.5352,1525
367000.0,4,2.5,2960,0,9,2960,0,47.3603,2960
285167.0,3,2.25,2200,0,8,2200,0,47.2626,2200
275000.0,2,1.5,1270,0,7,1270,0,47.3347,1270
350900.0,4,2.5,2540,0,9,2540,0,47.3866,2410
660000.0,4,3.25,3030,0,8,3030,0,47.5747,2360
525000.0,3,1.75,1520,0,7,1520,0,47.6054,1760
262000.0,4,2.5,1560,0,7,1560,0,47.514,1160
690000.0,2,1.0,970,0,7,970,0,47.6561,1500
624000.0,5,3.75,3570,0,9,3570,0,47.7377,3160
353000.0,3,1.0,1350,0,6,860,490,47.7098,1130
552500.0,4,3.5,3710,0,8,2290,1420,47.5041,1720
224500.0,4,1.0,1430,0,7,1430,0,47.3178,1550
239000.0,3,1.0,940,0,6,940,0,47.5006,1100
975000.0,5,4.5,4300,0,10,4300,0,47.5557,3950
1200000.0,4,1.75,3990,0,11,3990,0,47.5305,5790
505000.0,3,1.0,1380,0,7,1380,0,47.6261,1690
302000.0,4,1.75,2020,0,7,1010,1010,47.5008,1650
170000.0,3,1.0,1480,0,6,780,700,47.5175,760
195000.0,2,1.0,1190,0,5,1190,0,47.524,1730
272000.0,5,1.5,2550,0,7,1560,990,47.5014,1380
369000.0,5,1.5,2550,0,7,1560,990,47.5014,1380
332500.0,3,1.5,1500,0,7,1500,0,47.7274,1500
515000.0,3,2.5,3000,0,8,1760,1240,47.6191,2040
269000.0,3,1.0,1690,0,7,1020,670,47.4945,1820
1278000.0,4,4.0,4390,0,11,2430,1960,47.5283,3090
303000.0,3,2.5,1560,0,7,1560,0,47.4733,1660
420000.0,7,3.0,2940,0,8,1690,1250,47.7555,1850
400000.0,3,1.0,1130,0,7,990,140,47.6856,1800
225000.0,3,1.0,1020,0,6,1020,0,47.2093,1420
219000.0,2,2.0,1310,0,6,1310,0,47.3496,1310
605000.0,3,2.5,2570,3,9,2570,0,47.7408,2490
625000.0,4,2.0,2020,0,8,1010,1010,47.7,1250
380000.0,5,2.0,1680,0,5,840,840,47.5965,1380
620000.0,4,2.0,1770,0,7,1770,0,47.5916,1710
687500.0,4,2.75,3190,0,10,3190,0,47.5862,2850
225500.0,4,2.0,1440,0,6,1440,0,47.4517,1530
252500.0,3,2.0,1150,0,7,1150,0,47.498,1980
510000.0,3,2.5,1860,0,8,1860,0,47.5703,1840
510000.0,4,2.5,2430,0,8,2430,0,47.7402,2260
725000.0,3,2.5,1940,0,7,1940,0,47.6372,1440
75000.0,1,0.0,670,0,3,670,0,47.2638,1160
492000.0,2,1.0,880,0,7,880,0,47.6868,1370
425000.0,4,2.5,1930,0,7,1330,600,47.7407,1470
1955000.0,4,2.75,3120,4,8,1560,1560,47.7165,2630
298900.0,3,2.5,1830,0,8,1830,0,47.3291,1860
699000.0,4,2.5,3230,0,10,3230,0,47.4856,2990
310000.0,2,1.0,700,0,6,700,0,47.6846,1560
350000.0,3,1.75,1010,0,7,1010,0,47.6703,1500
790000.0,4,1.75,2460,4,7,1410,1050,47.5105,2300
305000.0,4,2.5,2230,0,8,2230,0,47.3919,2230
315000.0,3,2.5,1570,0,7,1570,0,47.5412,1610
267500.0,5,3.5,2390,0,7,2390,0,47.3737,1140
1750000.0,4,3.25,3460,1,10,3020,440,47.6849,3030
435000.0,6,3.5,2400,0,8,1640,760,47.7152,1940
482500.0,6,4.5,2940,0,8,2940,0,47.7208,2010
5110800.0,5,5.25,8010,4,12,5990,2020,47.6767,3430
439995.0,3,1.75,1570,0,7,1570,0,47.76,1860
460000.0,3,3.0,1520,0,7,1180,340,47.7276,2080
194000.0,3,1.0,1070,0,7,1070,0,47.3186,1190
290000.0,2,0.75,440,3,5,440,0,47.4339,880
274700.0,4,2.0,2440,0,7,1220,1220,47.4142,1370
900000.0,4,2.5,2660,0,8,1800,860,47.6609,1510
1150000.0,4,4.0,4460,0,11,4460,0,47.634,3470
605000.0,3,2.5,2010,0,9,2010,0,47.545,2350
359000.0,3,2.5,1450,0,7,1450,0,47.5318,1970
850000.0,3,1.75,1400,0,7,1400,0,47.6272,1810
505000.0,3,2.0,1500,0,8,1500,0,47.6748,1550
565000.0,3,2.5,2500,0,9,2500,0,47.7441,2790
585000.0,2,1.75,1280,0,7,1000,280,47.5569,1550
328000.0,4,3.25,3380,3,7,2420,960,47.4092,1920
749950.0,4,2.75,2910,0,9,2210,700,47.7557,2420
826000.0,4,2.5,3060,0,9,3060,0,47.5393,3240
535000.0,3,1.0,1330,0,7,1330,0,47.552,1710
925000.0,4,2.5,3300,0,10,3300,0,47.576,2880
875000.0,3,3.5,3250,0,10,2500,750,47.5533,1650
902000.0,4,2.25,2530,0,9,1570,960,47.5612,3030
423000.0,3,1.0,1830,0,7,1830,0,47.7654,1840
235000.0,3,1.0,1170,0,6,1170,0,47.4954,2080
545000.0,2,2.0,2930,2,8,1680,1250,47.4025,2234
343000.0,2,1.0,1230,0,7,1230,0,47.7298,1270
334950.0,3,2.5,1620,0,8,1620,0,47.4491,1900
405000.0,3,1.75,1760,0,7,1160,600,47.5368,1790
220000.0,4,1.0,1440,0,7,1440,0,47.4325,1440
173000.0,2,1.0,1740,0,6,1050,690,47.4942,960
655000.0,3,1.0,1270,0,7,1270,0,47.6368,1710
406000.0,2,1.0,880,0,6,880,0,47.6749,890
632000.0,6,2.5,2560,0,7,1370,1190,47.7021,2360
357000.0,5,2.75,1540,0,7,1140,400,47.533,1630
361000.0,3,1.75,1150,0,7,1150,0,47.6503,1200
277000.0,2,1.0,770,0,6,770,0,47.7458,1160
630000.0,4,3.75,4610,0,10,2500,2110,47.4599,3050
254000.0,3,2.5,1850,0,8,1850,0,47.3755,2210
472800.0,3,2.25,1840,0,8,1290,550,47.5497,2110
263000.0,3,1.75,1490,0,6,700,790,47.5554,2180
510000.0,3,1.75,1490,0,6,700,790,47.5554,2180
179950.0,3,1.0,960,0,7,960,0,47.3335,1250
525000.0,4,2.25,1580,0,8,1160,420,47.569,2020
479000.0,3,2.5,1260,0,8,1260,0,47.6277,1340
651000.0,3,2.0,1940,2,7,970,970,47.5664,1730
949000.0,4,1.75,2490,3,8,1240,1250,47.6851,3210
392400.0,5,2.5,2520,0,7,1890,630,47.7733,1830
585000.0,4,1.75,1760,0,7,920,840,47.679,1680
460000.0,4,2.5,4190,0,7,4190,0,47.4394,2480
470000.0,3,1.0,1170,0,7,870,300,47.6584,1240
245000.0,3,2.5,1600,0,7,1600,0,47.386,1520
500000.0,4,2.0,2760,0,8,1800,960,47.7484,2490
455000.0,3,2.5,2090,0,8,2090,0,47.7498,2090
485500.0,4,2.5,2320,0,7,2320,0,47.532,2620
1875000.0,5,3.25,4110,3,9,3150,960,47.617,3890
100000.0,2,1.0,770,0,7,770,0,47.2997,1480
307000.0,3,1.75,1410,0,7,1410,0,47.6927,1550
475000.0,4,3.5,3660,0,10,2660,1000,47.3076,2780
330000.0,4,2.5,2180,0,7,1190,990,47.7419,2070
130000.0,3,1.0,1110,0,7,1110,0,47.683,1440
320000.0,3,2.5,2280,0,8,2280,0,47.3557,2370
735000.0,4,2.5,2820,0,9,2050,770,47.5529,1390
365000.0,4,2.5,1570,0,7,800,770,47.7757,1340
234000.0,3,1.5,1200,0,7,1200,0,47.3434,1350
211000.0,4,2.0,1710,0,7,1710,0,47.3947,1710
680000.0,6,3.5,3000,2,8,2400,600,47.562,1720
457000.0,4,3.0,2800,0,8,2800,0,47.3544,2800
349000.0,3,2.25,1640,0,7,1640,0,47.7192,1640
360000.0,3,2.75,2030,0,7,1210,820,47.5413,1910
350000.0,4,2.5,2530,0,8,2530,0,47.351,2330
208000.0,3,1.0,990,0,6,990,0,47.2898,1010
250275.0,2,1.0,790,0,6,790,0,47.4413,1930
435000.0,2,1.0,790,0,6,790,0,47.4413,1930
270000.0,3,1.75,1800,0,6,1470,330,47.3766,1440
438000.0,3,1.75,1650,0,7,1650,0,47.7629,2830
659000.0,4,2.0,1980,0,8,1980,0,47.7553,2300
645000.0,4,2.75,2340,0,7,1310,1030,47.5559,2020
685100.0,4,2.5,2790,0,9,2790,0,47.6085,2450
350000.0,7,3.0,2800,2,7,1400,1400,47.5102,2150
375000.0,2,1.0,1840,0,6,1840,0,47.7694,2550
170000.0,3,1.5,1350,0,7,1350,0,47.3099,2220
880000.0,4,2.5,3030,0,9,3030,0,47.6781,1080
410500.0,4,2.5,1980,0,8,1980,0,47.6492,1400
780000.0,4,2.5,3690,2,10,3690,0,47.5872,3600
1225000.0,5,4.5,3732,0,10,2932,800,47.6189,2950
449000.0,2,1.75,1510,0,8,1510,0,47.7073,1510
546000.0,3,1.75,2000,0,7,1110,890,47.6859,1750
317000.0,3,2.0,1760,0,7,1060,700,47.4528,1680
276900.0,3,1.0,1270,0,7,1270,0,47.5074,1780
399000.0,5,2.0,2620,0,8,1420,1200,47.7338,1360
495000.0,5,2.75,2630,0,8,1690,940,47.5196,2440
258000.0,3,1.75,2270,0,8,1330,940,47.3077,2090
600000.0,2,2.5,2410,0,7,1940,470,47.5629,2460
265000.0,3,2.75,1120,0,8,1120,0,47.6914,1120
321000.0,5,2.75,3030,0,7,1540,1490,47.3661,1790
682000.0,5,2.25,2120,0,7,1720,400,47.644,1960
295700.0,4,2.5,1720,0,8,1720,0,47.3286,2360
609000.0,4,2.5,2150,0,9,2150,0,47.7227,2450
995000.0,3,4.5,4380,3,9,3720,660,47.4734,2460
530000.0,3,2.25,2010,0,8,2010,0,47.5665,2190
614000.0,5,2.5,3150,0,8,1870,1280,47.5506,1550
390000.0,3,2.5,2500,0,8,1770,730,47.3282,2670
467000.0,3,2.5,1690,0,7,1690,0,47.6793,2120
484000.0,6,2.5,3300,0,8,2060,1240,47.5116,2060
340000.0,3,2.5,1240,0,8,1240,0,47.6985,1410
302495.0,3,2.5,2200,0,8,2200,0,47.3821,2250
532500.0,3,1.75,1620,0,7,980,640,47.6886,1400
441500.0,3,2.5,2420,0,8,1780,640,47.5093,2420
470000.0,4,2.5,2680,3,7,1530,1150,47.4132,1920
2300000.0,4,3.25,4250,0,9,4250,0,47.6154,2830
590000.0,3,2.5,2400,0,9,2400,0,47.3917,2800
320000.0,3,1.75,2300,0,8,1770,530,47.7599,2030
363000.0,2,2.0,920,0,8,800,120,47.5926,1150
747500.0,4,2.25,2350,0,9,2350,0,47.7473,2880
750000.0,2,2.5,2630,0,8,2630,0,47.7106,2305
831000.0,4,3.0,2170,0,9,1610,560,47.6196,1670
403000.0,3,2.5,1700,0,7,1700,0,47.5305,1970
445000.0,3,2.5,2470,0,7,2470,0,47.514,2470
345000.0,3,1.0,1250,0,7,1250,0,47.7502,1410
2260000.0,3,3.5,3110,0,10,3110,0,47.6178,3110
371025.0,3,2.0,1530,0,7,1530,0,47.736,2040
355000.0,2,1.0,960,0,6,960,0,47.5491,1350
270000.0,3,1.0,1240,0,7,1240,0,47.4579,2060
425000.0,4,2.75,2440,1,7,2440,0,47.4117,2280
364808.0,3,1.75,2320,0,8,1620,700,47.4524,1990
320000.0,3,2.25,1580,0,8,1200,380,47.4394,1710
325000.0,4,2.5,2963,0,9,2963,0,47.3831,2665
350000.0,3,2.25,2470,0,8,2230,240,47.4459,1970
170000.0,3,1.5,1370,0,6,1370,0,47.4738,1650
255000.0,2,1.0,960,0,6,960,0,47.3356,1860
550000.0,3,1.0,1130,0,7,880,250,47.6973,2190
835000.0,4,4.25,4930,0,12,4930,0,47.3069,3620
420000.0,3,1.0,1150,0,6,800,350,47.5588,1220
925000.0,4,2.5,2190,0,8,2190,0,47.5786,1880
389250.0,2,1.5,1490,0,7,930,560,47.5344,1320
748000.0,3,2.5,2600,0,8,1300,1300,47.6984,1860
284000.0,3,1.75,1530,0,7,1200,330,47.3594,1680
588000.0,4,2.0,1680,0,7,980,700,47.6858,1680
372500.0,3,1.75,1680,0,7,1680,0,47.7338,1290
285000.0,4,3.0,1900,0,7,1900,0,47.3768,1690
360000.0,3,1.0,1570,0,7,1570,0,47.7683,1570
275000.0,3,1.0,1370,0,7,1150,220,47.5617,1460
428000.0,2,2.0,1350,0,8,1350,0,47.7106,1660
847000.0,6,2.5,3010,0,8,3010,0,47.7209,2560
316000.0,3,1.0,1010,0,6,1010,0,47.7422,1380
375000.0,3,2.5,2050,0,8,2050,0,47.3487,2050
533000.0,3,1.0,1670,0,7,1170,500,47.6899,1560
556000.0,5,2.5,3840,0,11,3840,0,47.2996,3270
225000.0,4,2.0,2220,0,7,1200,1020,47.361,1300
537250.0,4,2.5,2590,0,8,1640,950,47.7752,2710
255000.0,3,1.0,1180,0,7,1180,0,47.4551,1460
530000.0,4,2.5,2950,0,7,2950,0,47.479,2120
5300000.0,6,6.0,7390,4,12,5000,2390,47.5631,4320
595000.0,3,2.75,2150,0,9,2150,0,47.6596,2650
548000.0,4,2.0,2100,0,7,2100,0,47.6115,1280
234975.0,3,1.75,1650,0,7,1100,550,47.3187,1280
600000.0,3,1.75,1620,0,9,1430,190,47.6498,1750
432000.0,4,1.0,1750,0,7,1750,0,47.743,1550
455000.0,3,1.5,1380,0,7,1380,0,47.7085,1420
279950.0,3,1.75,1510,0,7,1210,300,47.7571,2080
267500.0,3,1.5,1600,0,7,1600,0,47.3737,1710
620000.0,4,2.5,1840,0,8,1840,0,47.4306,1890
110000.0,2,1.0,830,0,6,830,0,47.4784,980
625000.0,3,3.5,1810,0,8,1440,370,47.607,1480
389000.0,2,1.0,910,0,7,910,0,47.6999,1260
1200000.0,4,2.0,2120,0,9,2120,0,47.6227,2090
788500.0,4,2.25,2510,0,8,2510,0,47.4569,2510
567000.0,5,2.25,2100,0,8,1600,500,47.6737,2100
515000.0,2,2.25,2690,2,8,1870,820,47.3361,2690
605000.0,4,2.5,2430,0,8,1590,840,47.7761,2430
430000.0,4,3.75,2452,0,7,2452,0,47.4744,1180
805000.0,2,1.75,1550,1,7,1550,0,47.6712,2360
567500.0,3,2.5,2080,0,8,2080,0,47.6036,1530
647500.0,3,1.75,1290,0,7,1290,0,47.5873,2020
495000.0,2,1.75,1850,0,7,1850,0,47.6106,1500
825000.0,4,2.5,3370,0,9,3370,0,47.541,3370
435000.0,4,2.25,2730,0,8,2730,0,47.4627,2390
445950.0,3,1.75,1300,0,7,1300,0,47.7321,1520
960000.0,5,2.75,3040,0,10,3040,0,47.5531,2860
780000.0,4,3.0,2440,0,8,1480,960,47.6853,1770
274500.0,3,2.25,1720,0,8,1320,400,47.3191,1930
729953.0,5,3.0,3230,0,8,2000,1230,47.7053,1509
464950.0,3,1.5,1200,0,8,1030,170,47.6384,1230
620000.0,4,1.75,2350,2,8,2350,0,47.5904,3050
735000.0,4,3.5,3100,0,9,3100,0,47.5968,3080
450000.0,4,2.25,2040,0,8,1400,640,47.7356,1890
450000.0,4,1.0,2000,0,7,1250,750,47.5529,1140
842500.0,4,2.5,2160,0,9,2160,0,47.6106,1720
360000.0,3,2.0,1970,0,7,1070,900,47.4674,1890
585000.0,3,2.5,2270,0,8,2270,0,47.4815,1277
461000.0,3,2.25,1850,0,7,1150,700,47.7011,1780
345000.0,2,1.0,1350,0,7,920,430,47.5315,1470
1075000.0,3,2.5,3280,0,10,1680,1600,47.6948,1550
643000.0,4,2.5,2270,0,8,2270,0,47.574,2420
690000.0,4,2.5,2820,0,9,2820,0,47.6253,2820
282000.0,4,1.0,1200,0,7,1200,0,47.7529,1350
549000.0,3,1.75,2000,0,8,1120,880,47.6925,2140
815000.0,3,2.0,2310,1,9,1560,750,47.648,2000
2200000.0,5,4.25,4640,4,8,2860,1780,47.6393,3140
700000.0,3,2.25,2330,0,8,2330,0,47.6386,2050
933399.0,3,2.5,3940,0,9,3110,830,47.6468,2720
290000.0,3,1.0,1440,0,7,1440,0,47.4627,2200
372000.0,4,1.75,1960,0,7,1340,620,47.4487,1500
450000.0,2,1.75,1250,0,7,790,460,47.6795,1500
303700.0,3,2.5,1981,0,8,1981,0,47.3668,1981
672000.0,4,2.5,2440,0,9,2440,0,47.5744,2820
334000.0,4,1.5,1150,0,6,1150,0,47.7197,1480
260000.0,2,1.0,1120,0,6,1120,0,47.4979,1270
749950.0,3,1.75,1800,0,8,1000,800,47.6491,1680
330000.0,4,2.25,2380,0,8,2380,0,47.2624,2030
830000.0,5,3.0,2920,0,8,2140,780,47.654,1620
1131000.0,3,2.25,2790,3,8,2790,0,47.4389,2720
320000.0,3,1.0,1560,0,6,910,650,47.7552,1200
260000.0,2,1.0,1550,0,7,1550,0,47.407,1520
225000.0,3,2.0,1700,0,6,970,730,47.4851,1560
279200.0,1,1.0,640,0,5,640,0,47.6976,1270
520000.0,4,3.5,2680,0,8,2040,640,47.726,1530
505000.0,3,2.5,1860,0,8,1860,0,47.5674,1850
234000.0,3,1.75,1490,0,7,1010,480,47.375,1490
503000.0,4,2.5,2470,0,9,2470,0,47.7728,2790
606000.0,4,2.25,2390,0,8,1740,650,47.6925,2240
433500.0,3,1.0,1230,0,7,780,450,47.6839,1570
250000.0,3,1.5,2840,0,8,1510,1330,47.524,2210
719000.0,3,2.5,2120,0,9,2120,0,47.5477,2290
381000.0,3,2.0,1770,0,8,1770,0,47.415,1900
267000.0,3,2.5,2495,0,8,2495,0,47.288,2434
275000.0,1,0.75,1170,0,7,880,290,47.2653,1130
651000.0,4,2.5,2740,0,8,2740,0,47.6334,2260
439000.0,2,1.0,1050,0,7,850,200,47.6767,1850
325000.0,2,1.0,1130,0,7,1130,0,47.5141,860
490000.0,2,1.0,880,0,7,880,0,47.6924,1340
519900.0,4,2.5,2403,0,9,2403,0,47.7361,2380
545000.0,4,2.75,3410,0,9,3410,0,47.4054,2580
1062500.0,4,4.0,5320,0,11,5320,0,47.5852,4640
542000.0,4,1.75,1900,0,7,950,950,47.5765,1480
465000.0,4,1.75,1810,0,7,1810,0,47.7358,2700
408000.0,2,2.0,1200,0,8,1200,0,47.72,1440
292000.0,4,2.5,2060,0,8,2060,0,47.3631,2242
253000.0,3,1.75,1250,0,7,1250,0,47.3277,1980
280000.0,2,1.0,910,0,6,910,0,47.5232,890
658588.0,3,2.25,2560,0,10,2560,0,47.4871,3040
635000.0,4,2.25,1920,0,8,1200,720,47.5897,2250
439000.0,4,2.25,2240,0,8,2240,0,47.7746,2340
300000.0,3,2.5,1260,0,8,1260,0,47.4908,1310
345000.0,3,1.5,1360,0,8,1360,0,47.4032,1900
283500.0,4,2.25,2100,0,8,2100,0,47.4391,2190
425000.0,2,1.0,2110,0,7,1460,650,47.6872,1390
685000.0,3,1.75,2210,1,8,1560,650,47.6621,2210
750000.0,3,2.5,2360,0,8,2360,0,47.5471,2480
245000.0,4,1.5,1280,0,6,1280,0,47.4949,1420
585444.0,6,3.75,2740,2,7,1640,1100,47.5816,1940
706000.0,4,2.5,2740,0,9,2740,0,47.6962,2880
445000.0,4,2.0,2630,0,7,1830,800,47.5067,1430
241000.0,3,2.0,1650,0,7,1650,0,47.2904,1870
1175000.0,2,2.5,1770,4,8,1770,0,47.7345,2410
530000.0,3,1.0,1500,0,7,1050,450,47.5677,1500
350000.0,3,1.5,1430,0,7,1130,300,47.7352,1490
1700000.0,4,3.75,3190,4,10,3190,0,47.5115,2290
389000.0,3,1.0,1280,0,7,1280,0,47.7677,1300
799000.0,4,2.75,2390,0,7,2140,250,47.6788,1980
1400000.0,4,2.5,4040,3,9,2020,2020,47.6408,3160
340895.0,2,1.0,920,0,7,920,0,47.734,1500
780000.0,4,2.5,2730,2,9,2730,0,47.6227,2750
350000.0,2,1.5,1320,0,7,1320,0,47.2755,1320
470000.0,3,2.5,2620,0,7,2620,0,47.5328,2360
914600.0,4,3.0,3180,0,11,3180,0,47.7336,3180
354000.0,4,2.5,2900,0,8,2900,0,47.3663,2900
470000.0,5,2.0,1900,0,6,1900,0,47.6831,2110
715000.0,3,2.0,1760,0,7,1160,600,47.6558,1640
265000.0,2,1.0,760,0,6,760,0,47.5466,1640
2537000.0,4,3.0,3710,2,10,2760,950,47.6696,3970
640000.0,3,1.0,1530,0,7,1530,0,47.6857,1500
290000.0,4,1.75,1990,0,7,1870,120,47.5131,1710
480000.0,5,4.75,3830,0,8,2130,1700,47.7597,2750
535000.0,3,2.0,2040,1,7,1120,920,47.5959,2120
907000.0,3,1.75,2170,0,8,2170,0,47.6537,1980
459000.0,3,1.75,1620,0,7,1090,530,47.7148,1380
1355000.0,3,2.5,3600,3,9,2310,1290,47.6191,2830
264950.0,3,1.5,1470,0,7,1070,400,47.3632,1580
352950.0,3,1.0,1760,0,6,1760,0,47.6598,1320
491500.0,3,2.25,2230,0,8,1510,720,47.5413,2010
1229000.0,4,3.5,3770,0,10,2830,940,47.6463,3200
369500.0,3,1.0,1200,0,7,1200,0,47.7362,1330
566000.0,3,2.5,2090,0,9,2090,0,47.686,2520
290000.0,3,2.25,1500,0,7,1210,290,47.4621,1480
5350000.0,5,5.0,8000,4,12,6720,1280,47.6232,4600
180000.0,3,1.0,870,0,6,870,0,47.369,840
215000.0,2,1.0,1010,0,6,1010,0,47.771,1610
302000.0,2,1.0,1010,0,6,1010,0,47.771,1610
352500.0,3,1.75,1860,0,7,1160,700,47.3855,1490
235867.0,4,2.0,1330,0,5,1330,0,47.496,1150
500000.0,3,2.25,1760,0,8,1760,0,47.624,2080
382000.0,3,2.25,1800,0,7,1800,0,47.7462,1760
515000.0,5,2.5,1690,0,7,990,700,47.6903,1200
250000.0,1,1.0,660,0,6,660,0,47.5723,1560
672500.0,3,2.25,2400,0,7,1250,1150,47.6876,1540
755000.0,3,2.25,3020,0,9,3020,0,47.6897,2480
707500.0,3,1.0,1500,2,7,1500,0,47.627,1820
459000.0,4,2.0,1560,0,6,960,600,47.6882,1560
140000.0,3,1.0,1090,0,7,1090,0,47.3748,1380
495000.0,2,1.0,970,0,7,970,0,47.6667,2050
757000.0,3,3.25,3190,0,9,3190,0,47.5534,2950
765000.0,3,3.25,3190,0,9,3190,0,47.5534,2950
359000.0,4,1.5,1890,0,7,1890,0,47.7055,1510
440000.0,3,1.0,1050,0,6,1050,0,47.5473,1380
400000.0,4,1.5,1390,0,7,1140,250,47.7224,1630
652000.0,3,2.0,1700,0,7,850,850,47.6785,1480
260000.0,3,1.75,1050,0,7,1050,0,47.4574,1220
1328000.0,5,3.0,3340,2,9,2120,1220,47.5421,3290
519500.0,4,2.0,1540,0,6,1540,0,47.5326,1390
650000.0,3,1.0,1710,0,7,1560,150,47.6861,1240
280000.0,4,2.25,2100,0,8,2100,0,47.3251,2100
515000.0,4,1.75,1730,0,8,1730,0,47.6219,2080
400000.0,3,2.25,1500,0,7,1500,0,47.7159,1470
652100.0,3,2.5,2380,0,9,2380,0,47.6297,2670
235000.0,6,3.0,2180,0,7,2180,0,47.3054,2214
701000.0,4,1.5,1840,0,8,1840,0,47.5575,1830
640000.0,4,2.5,2341,0,9,2341,0,47.6993,2850
455800.0,3,2.5,1690,0,7,1690,0,47.6866,1600
504750.0,3,2.5,2490,0,8,2490,0,47.6442,2450
483000.0,3,3.0,2440,0,9,2440,0,47.6104,2440
530000.0,3,0.75,920,2,6,920,0,47.4781,1162
250000.0,2,1.0,1030,0,6,1030,0,47.4814,1480
229950.0,5,2.75,2000,0,7,1260,740,47.3155,1960
884744.0,4,3.5,4210,0,9,4210,0,47.6067,3950
514000.0,3,1.5,1610,0,7,1080,530,47.6681,1610
532000.0,3,2.25,1910,0,8,1430,480,47.4672,2340
423000.0,4,2.5,2660,0,8,2660,0,47.4981,2380
420000.0,2,1.0,820,2,6,820,0,47.5649,1410
521000.0,3,1.75,1730,0,8,1730,0,47.737,2180
577000.0,4,2.25,2360,0,8,2360,0,47.6988,2360
425000.0,3,1.0,970,0,7,970,0,47.603,1250
495000.0,4,2.5,2460,0,8,2460,0,47.7719,2900
340000.0,3,2.5,2690,0,9,2690,0,47.3026,2570
499950.0,3,3.5,1820,0,8,1430,390,47.596,1550
1218000.0,4,3.0,3470,2,9,2370,1100,47.5917,2420
720000.0,4,2.75,3370,2,8,2110,1260,47.5259,2460
249000.0,3,1.5,1700,0,7,1010,690,47.4216,1440
206135.0,3,1.0,1340,0,7,1340,0,47.3527,1650
300000.0,5,2.75,2000,0,7,2000,0,47.444,1240
612000.0,6,3.0,3840,3,8,2460,1380,47.506,2170
1102030.0,5,2.5,3890,2,10,3890,0,47.7291,3160
230000.0,4,2.0,1220,0,7,1220,0,47.2964,1160
850000.0,3,1.0,2280,2,8,1250,1030,47.6378,1910
355000.0,4,2.5,2770,0,7,1940,830,47.3396,2140
442000.0,4,2.5,2520,0,9,2520,0,47.5148,2570
399000.0,4,3.0,3060,0,8,3060,0,47.3786,3060
360000.0,4,2.5,2390,0,9,2390,0,47.2593,2600
390000.0,3,1.75,1320,0,8,1320,0,47.4425,2020
413000.0,5,2.5,2900,0,8,1650,1250,47.7752,2340
190000.0,2,1.0,700,0,6,700,0,47.5294,1020
432900.0,3,2.5,2210,0,8,2210,0,47.4849,2430
621138.0,3,2.25,2180,0,9,2180,0,47.6482,2300
270000.0,3,2.25,2080,0,7,1550,530,47.4203,2080
610000.0,4,2.25,2090,0,8,1490,600,47.5739,2910
500000.0,3,2.0,1720,2,7,960,760,47.559,1760
715000.0,4,2.25,2460,0,8,2460,0,47.6627,2250
264000.0,3,1.5,1470,0,7,1470,0,47.3658,1760
550000.0,3,1.75,1650,0,8,1650,0,47.6209,1500
337000.0,3,2.0,1690,0,8,1690,0,47.3724,2090
170000.0,3,1.0,970,0,6,970,0,47.4167,1280
405000.0,4,2.5,2030,0,7,1130,900,47.7321,1940
775000.0,4,2.5,2540,0,10,2540,0,47.7185,2790
425000.0,3,2.25,1570,0,7,1200,370,47.7223,1700
713000.0,5,2.75,2580,2,8,1720,860,47.5943,2240
555000.0,5,2.5,2090,0,8,1420,670,47.5968,2490
810000.0,4,2.5,3260,0,9,3260,0,47.5453,3010
1250000.0,4,3.75,3830,0,11,3830,0,47.7237,5600
819000.0,3,3.5,2130,2,8,1530,600,47.6491,2040
409900.0,3,2.5,1690,0,8,1410,280,47.5389,1690
935000.0,2,2.5,1780,0,9,1780,0,47.6132,2320
657500.0,4,1.75,1620,3,7,1380,240,47.6981,2170
900000.0,6,3.75,4210,0,9,3280,930,47.5211,3820
932800.0,5,3.25,2980,0,9,2980,0,47.6919,1670
391000.0,3,2.0,1490,0,8,1490,0,47.5455,2190
420000.0,4,2.5,2110,0,8,2110,0,47.4979,1650
1300000.0,6,3.5,6563,0,10,5153,1410,47.6078,2610
415000.0,3,1.5,1510,0,8,1510,0,47.751,1560
350000.0,3,1.75,1830,0,8,1590,240,47.5038,1670
375000.0,2,1.0,1230,0,7,830,400,47.6684,1660
860000.0,3,1.75,2180,2,8,1300,880,47.673,3540
495000.0,4,2.25,2220,0,8,1110,1110,47.5491,2220
250000.0,4,2.25,1730,0,7,1730,0,47.3386,1550
365000.0,4,2.25,1990,0,8,1990,0,47.439,2400
503000.0,3,2.75,1540,0,7,1210,330,47.7163,1540
150000.0,2,1.0,1100,0,6,1100,0,47.4752,1390
450000.0,4,1.75,1640,0,7,820,820,47.6684,1420
355000.0,4,3.0,2590,0,8,2590,0,47.2609,2550
245000.0,3,2.0,1450,0,7,1450,0,47.346,1910
265900.0,3,2.0,1180,0,7,1180,0,47.4053,1720
299000.0,4,2.5,1820,0,7,1220,600,47.4339,1840
957500.0,4,2.25,2360,0,10,2360,0,47.5318,2850
343000.0,3,1.0,1120,0,7,1120,0,47.7143,1340
307500.0,3,2.25,1646,0,7,1646,0,47.3646,1975
937500.0,5,3.75,4210,3,10,4210,0,47.5364,3950
610000.0,3,3.0,2480,0,8,1620,860,47.7591,1260
720000.0,3,1.5,1590,2,8,1310,280,47.5244,2080
610000.0,4,2.0,2130,0,7,1650,480,47.6515,1330
434500.0,3,1.75,1650,0,7,1650,0,47.7335,1560
602500.0,2,2.5,3090,0,10,2250,840,47.4291,1860
607010.0,4,2.5,2180,0,8,1700,480,47.5553,2180
610000.0,3,1.0,1800,0,7,1040,760,47.686,1320
828500.0,4,2.5,3720,0,10,3720,0,47.7582,3720
199990.0,3,1.0,1100,0,6,1100,0,47.329,1120
294000.0,3,1.75,1530,0,7,1530,0,47.3643,1480
789500.0,4,2.5,3010,0,9,3010,0,47.6647,2890
797000.0,3,3.5,3500,0,10,3500,0,47.5807,3510
539950.0,5,3.0,3100,0,7,3100,0,47.5369,2460
284950.0,4,1.5,2000,0,7,1170,830,47.3708,1940
776500.0,4,1.5,2290,0,7,1510,780,47.6888,1900
525000.0,4,2.5,2400,0,7,1510,890,47.7104,2030
303000.0,3,2.5,1850,0,8,1850,0,47.3311,2400
722080.0,3,3.25,3680,0,9,2340,1340,47.6272,2280
140000.0,3,1.0,1060,0,7,1060,0,47.3699,1320
235000.0,3,1.0,1060,0,7,1060,0,47.3699,1320
440000.0,3,1.0,1610,0,7,1610,0,47.698,1200
605000.0,3,1.75,2330,0,7,1630,700,47.5765,1600
380000.0,2,1.0,1210,0,8,1060,150,47.5625,1380
352000.0,4,1.0,1530,0,7,980,550,47.5308,1100
420000.0,4,2.25,2270,0,7,1360,910,47.7559,2500
1175000.0,4,2.0,2590,2,10,2590,0,47.647,2530
1375000.0,3,1.5,1850,0,8,1850,0,47.6194,3030
300000.0,3,1.5,1500,0,6,1500,0,47.495,1270
1150000.0,4,3.25,4740,0,11,4740,0,47.6624,4800
453500.0,2,1.5,1710,1,7,1160,550,47.5286,1530
443500.0,3,2.0,1920,0,8,1920,0,47.7735,2220
332000.0,2,1.0,1150,0,7,1150,0,47.737,1300
655000.0,3,2.5,2320,0,8,2320,0,47.591,2250
475000.0,4,1.0,1420,0,7,1420,0,47.6844,1420
372500.0,3,1.75,1550,0,7,1210,340,47.4711,1630
1050000.0,4,2.5,2920,3,8,1470,1450,47.5947,3210
500000.0,3,1.75,1620,0,7,830,790,47.6743,1580
900000.0,6,2.75,2300,0,9,2300,0,47.5833,2720
327500.0,3,1.0,1070,0,7,1070,0,47.5427,1390
390000.0,3,1.75,1790,0,7,1790,0,47.7429,1660
451101.0,2,1.5,1510,0,8,1510,0,47.6214,1510
455000.0,4,1.0,1340,2,7,1340,0,47.5658,1900
650000.0,4,2.5,3350,0,10,3350,0,47.3432,3350
895000.0,3,2.5,2500,0,10,1910,590,47.6393,2480
800000.0,4,2.25,2350,1,7,1510,840,47.5743,2350
703770.0,4,2.25,2550,0,9,2550,0,47.5623,2550
249950.0,3,1.75,1320,0,7,1320,0,47.2844,1680
512000.0,2,2.0,1270,0,6,610,660,47.6694,1370
780000.0,5,2.5,3480,0,8,1980,1500,47.4961,2610
336000.0,3,2.25,2820,0,8,2820,0,47.2621,2290
285000.0,3,2.0,2110,0,6,1220,890,47.504,1350
229900.0,3,1.75,1100,0,7,1100,0,47.3717,1700
667500.0,4,3.0,1920,0,8,1540,380,47.5718,1660
378000.0,4,2.5,1890,0,7,1230,660,47.4491,1390
454000.0,3,2.5,2530,0,8,1530,1000,47.46,1730
537500.0,4,2.5,2550,0,7,2550,0,47.5928,2550
425000.0,3,1.0,1550,0,6,1550,0,47.5387,1590
290000.0,3,2.0,1760,0,7,1760,0,47.3836,2590
349500.0,3,2.0,1270,0,7,1270,0,47.6099,1660
370000.0,3,2.75,1250,0,7,830,420,47.5554,1520
549500.0,3,1.75,1620,0,8,1620,0,47.703,2040
245000.0,2,1.0,710,0,6,710,0,47.5165,740
208000.0,3,1.75,1070,0,7,1070,0,47.3134,1480
248000.0,4,2.25,2320,0,8,1160,1160,47.3627,1970
610000.0,4,3.25,5450,0,9,5450,0,47.351,2800
550000.0,4,2.5,1670,0,8,1670,0,47.7667,1910
750000.0,3,2.75,3010,2,10,3010,0,47.4881,1580
192000.0,2,1.75,1340,0,6,1340,0,47.4785,1980
169317.0,2,1.0,790,2,7,790,0,47.6248,1700
1198000.0,4,3.5,3400,0,10,2790,610,47.6258,2030
880000.0,2,1.0,1530,0,7,1530,0,47.6325,2640
210000.0,1,1.0,930,0,6,930,0,47.7234,1300
180500.0,3,1.5,1540,0,7,1010,530,47.4676,1600
540000.0,4,2.0,1990,0,9,1990,0,47.6471,2310
520000.0,3,1.75,2300,0,9,2300,0,47.7455,2600
177500.0,3,1.5,1220,0,7,1220,0,47.4904,1660
415000.0,3,1.75,2380,2,8,1190,1190,47.5119,2350
495000.0,4,2.5,2020,0,7,1010,1010,47.7289,1620
325000.0,3,2.25,1890,0,8,1890,0,47.4838,1580
440000.0,2,1.75,1330,0,7,1330,0,47.6819,1470
411000.0,3,1.75,1490,0,7,1190,300,47.7626,1840
810000.0,5,3.5,3550,0,9,2550,1000,47.5484,2030
561750.0,5,1.75,2040,2,7,1020,1020,47.588,1950
835100.0,4,2.5,2380,0,9,2380,0,47.5984,2900
450000.0,3,2.25,1780,0,8,1450,330,47.7286,1950
238000.0,3,2.5,1650,0,7,1650,0,47.4328,1460
299000.0,3,1.0,1510,0,7,1510,0,47.3192,1330
570000.0,2,1.0,1100,0,7,1100,0,47.6446,1250
340000.0,3,1.75,2190,0,8,2190,0,47.3845,3110
450000.0,2,1.75,1760,0,6,1040,720,47.5803,1380
272750.0,4,1.5,1800,0,7,1330,470,47.4982,1780
520000.0,4,2.0,2000,0,6,1860,140,47.6956,1600
284950.0,3,1.0,990,0,7,990,0,47.4887,1460
255000.0,2,1.5,1480,0,7,1480,0,47.4577,1990
231500.0,2,1.0,1200,0,7,1200,0,47.4832,1200
415000.0,1,2.0,3000,2,8,3000,0,47.6331,2330
330000.0,4,2.5,3504,0,7,3504,0,47.3012,2790
365000.0,3,1.5,1300,0,7,1300,0,47.737,2040
425000.0,4,2.0,1330,0,7,1330,0,47.401,1770
400000.0,4,1.75,1850,0,7,1120,730,47.5525,1610
335000.0,4,2.5,2240,0,9,2240,0,47.3086,2240
342000.0,3,3.0,1260,0,7,1040,220,47.5943,1780
490000.0,8,5.0,2800,0,8,1880,920,47.6086,1800
331500.0,4,1.75,1820,0,7,1820,0,47.4757,1440
960000.0,3,2.5,1730,4,8,1730,0,47.645,2340
720500.0,4,2.5,3350,0,9,3350,0,47.6506,2620
830000.0,3,2.5,3370,2,8,2840,530,47.5442,1500
662990.0,3,1.75,1240,0,7,1240,0,47.5797,1660
220000.0,4,2.0,2340,0,6,2340,0,47.3578,990
349950.0,5,2.0,1880,0,7,940,940,47.5536,1350
550000.0,3,2.0,1810,0,7,1010,800,47.6273,1810
396000.0,3,1.75,2340,0,6,1200,1140,47.5588,860
635000.0,4,1.5,2820,0,7,2820,0,47.6638,1470
293000.0,3,1.0,1020,0,7,1020,0,47.7198,1440
339000.0,3,2.25,2090,0,7,1290,800,47.4654,1820
285000.0,4,2.25,1830,0,7,1830,0,47.3679,1870
775000.0,6,2.75,2980,0,7,2480,500,47.6684,1470
224000.0,4,1.5,1600,0,7,1600,0,47.3107,1540
2250000.0,4,3.5,4440,3,10,3140,1300,47.5744,3990
165050.0,3,1.0,1200,0,7,1200,0,47.2043,1210
275000.0,3,1.25,1230,0,7,1230,0,47.5301,1310
445000.0,5,3.0,2930,0,7,1750,1180,47.5572,1400
510000.0,3,2.25,2370,0,8,1930,440,47.771,2900
1230000.0,4,2.5,3040,0,9,3040,0,47.5934,2320
390000.0,3,1.5,1610,0,7,1060,550,47.7674,1540
460000.0,3,2.25,2350,0,8,1390,960,47.7433,2250
700000.0,3,1.75,2000,0,8,2000,0,47.6001,2620
874150.0,4,3.5,3530,1,10,2570,960,47.7073,3170
470000.0,3,2.25,2220,0,8,2220,0,47.7635,2420
374000.0,3,1.75,2000,0,6,2000,0,47.697,1440
510000.0,2,1.75,1210,0,7,1210,0,47.4599,2020
467000.0,2,2.5,1140,0,8,1140,0,47.6713,1220
576000.0,4,2.5,2440,0,8,2440,0,47.7386,2480
196440.0,3,2.0,1560,0,6,1560,0,47.2804,1120
825000.0,4,2.5,3210,0,10,3210,0,47.709,3330
281000.0,2,1.0,930,0,7,930,0,47.7242,1370
326000.0,3,2.5,1782,0,7,1782,0,47.7114,1550
340000.0,3,1.75,1740,0,7,1740,0,47.3583,1576
440000.0,5,1.75,3690,0,9,1890,1800,47.3473,2680
749000.0,4,2.5,2930,0,9,2930,0,47.5937,2930
340000.0,4,1.0,1230,0,7,1230,0,47.7269,1490
561000.0,3,2.0,2000,0,7,2000,0,47.5452,1840
270000.0,3,2.25,1520,0,7,1160,360,47.3605,1530
600000.0,2,1.0,1040,0,7,1040,0,47.619,2250
219900.0,4,1.5,1120,0,6,1120,0,47.3628,1150
617000.0,3,1.75,3020,0,8,3020,0,47.2662,1890
469000.0,3,2.25,1820,0,8,1820,0,47.7208,1850
229000.0,3,1.0,1370,0,7,1370,0,47.3058,1768
1265000.0,4,3.0,3130,0,9,2290,840,47.6272,2920
365000.0,3,1.5,1640,0,7,1290,350,47.7443,1640
429000.0,4,2.5,2650,0,9,2650,0,47.3477,2730
550000.0,4,2.5,2850,0,9,2850,0,47.7353,2820
453000.0,3,2.5,1820,0,7,1220,600,47.4582,1870
187500.0,3,1.5,1180,0,7,1180,0,47.2966,1180
520500.0,6,2.5,1880,0,7,1640,240,47.7556,1510
300000.0,3,1.75,1280,0,7,1280,0,47.4212,1680
799000.0,4,3.25,3120,0,9,2370,750,47.69,2520
338000.0,3,2.5,2470,0,8,2470,0,47.3438,2500
800000.0,3,1.0,1700,0,8,1700,0,47.612,1610
360000.0,2,2.0,1180,1,6,590,590,47.5275,1350
442500.0,6,2.5,2800,0,7,1400,1400,47.7735,2290
700000.0,4,1.0,1300,3,6,1300,0,47.2313,2560
830000.0,5,3.0,3040,0,9,1970,1070,47.5562,3180
360400.0,3,2.5,1630,0,8,1630,0,47.7574,1700
345000.0,3,1.0,1340,0,7,1340,0,47.5407,1310
300000.0,3,1.75,1830,0,7,1430,400,47.4774,1320
350000.0,3,1.0,1240,0,7,1240,0,47.5233,1810
368000.0,4,2.0,2500,0,7,1540,960,47.3708,1960
264000.0,3,1.75,1760,0,8,1760,0,47.3129,2000
435000.0,3,2.0,2660,0,9,2210,450,47.3689,2660
200000.0,3,1.5,2060,0,6,2060,0,47.4819,2190
620000.0,5,2.5,2540,0,8,1760,780,47.6848,2000
1679000.0,5,4.25,4830,0,10,3720,1110,47.5774,2180
337000.0,3,1.75,1400,0,7,700,700,47.5283,1030
1928000.0,4,3.25,4280,0,11,4280,0,47.6377,3420
544500.0,4,2.5,2230,0,7,1450,780,47.5816,1960
252000.0,1,1.0,680,4,6,680,0,47.5832,1010
445000.0,4,2.5,2340,0,8,2340,0,47.535,1730
379500.0,3,2.25,2070,0,7,2070,0,47.4617,1550
189950.0,4,2.0,1910,0,6,910,1000,47.3084,1060
469000.0,3,1.0,950,0,6,950,0,47.609,2130
600000.0,5,2.75,2910,0,7,1510,1400,47.7201,3210
785000.0,3,2.5,2930,2,9,2930,0,47.5151,3720
372000.0,4,2.75,2610,0,8,2610,0,47.3747,2390
445000.0,5,3.0,3880,0,7,3880,0,47.4797,2160
508000.0,4,2.25,3320,0,8,2000,1320,47.4724,3230
780000.0,5,1.5,1940,0,8,1940,0,47.6845,1750
541100.0,4,2.25,2510,0,9,2510,0,47.753,2440
729000.0,4,2.5,2660,0,9,2660,0,47.5449,3010
397000.0,3,2.0,1710,2,7,1710,0,47.2207,1700
451555.0,2,1.0,1320,1,6,1320,0,47.5655,1420
300000.0,2,1.0,960,0,6,960,0,47.7341,1160
416000.0,3,2.5,1790,0,7,1190,600,47.5124,1790
490000.0,2,1.0,950,0,6,810,140,47.6698,1510
480000.0,6,3.75,2940,0,7,2940,0,47.5122,1530
368000.0,2,2.0,930,0,7,670,260,47.6518,1780
1038000.0,3,2.5,4570,0,12,4570,0,47.5533,3860
545000.0,3,2.5,2370,3,8,1570,800,47.4922,2120
850000.0,5,2.75,3430,0,10,3430,0,47.5678,3430
550000.0,4,3.5,3540,0,10,3540,0,47.473,3310
600000.0,3,2.25,2240,0,9,2240,0,47.6216,2240
535000.0,4,2.5,2710,0,8,1700,1010,47.7657,2390
599950.0,3,2.5,2660,0,8,2660,0,47.5487,1840
531000.0,5,2.75,2540,0,8,1540,1000,47.5593,2510
530000.0,4,2.25,2210,0,8,2210,0,47.5424,1960
597326.0,4,4.0,3570,0,10,2860,710,47.5784,2230
805000.0,4,2.5,3450,0,9,3450,0,47.7673,2820
390000.0,4,1.75,2330,0,8,2330,0,47.4568,2180
487250.0,4,2.0,1690,0,7,1550,140,47.6637,1620
301000.0,3,1.5,1030,0,7,1030,0,47.7654,1750
1175000.0,5,2.75,2560,2,8,2220,340,47.6416,2740
299000.0,4,2.5,1950,0,7,1950,0,47.4977,1170
2350000.0,4,2.25,4370,3,10,3670,700,47.6878,2980
400000.0,4,2.5,2350,0,7,2350,0,47.5305,1120
467500.0,4,2.5,3160,0,7,1880,1280,47.7368,2070
305000.0,4,2.5,2430,0,8,2430,0,47.2939,2260
210000.0,3,1.0,1340,0,5,1340,0,47.7534,1800
300000.0,3,1.0,1010,0,6,1010,0,47.6453,1180
327500.0,3,2.25,1770,0,8,1330,440,47.4464,1910
269000.0,3,2.0,1210,0,7,1210,0,47.3996,1210
975000.0,4,3.25,3330,2,9,1750,1580,47.652,3340
355000.0,3,1.0,1240,0,7,1060,180,47.7115,1429
712000.0,3,1.0,1250,0,7,1150,100,47.651,1900
883000.0,4,2.5,2960,0,10,2960,0,47.7319,3900
190000.0,2,1.0,840,0,6,840,0,47.3069,1010
443000.0,3,1.75,1530,0,7,1200,330,47.7768,1530
920000.0,4,3.0,3750,0,10,3750,0,47.6367,2930
285000.0,4,2.25,2150,0,7,1240,910,47.3045,2050
901000.0,4,3.25,1560,0,7,1560,0,47.5347,1370
552500.0,3,1.75,2040,0,7,1410,630,47.6592,1360
256000.0,2,1.0,860,0,6,860,0,47.5133,1220
341000.0,3,1.5,1720,0,7,1720,0,47.7535,1590
279000.0,4,2.25,2090,0,7,2090,0,47.4332,1890
686000.0,4,2.25,2130,0,8,2130,0,47.5567,3380
225000.0,2,1.0,1300,0,6,1300,0,47.3221,820
215500.0,2,1.75,1220,0,6,1220,0,47.2853,1510
950000.0,4,3.0,2420,0,7,1520,900,47.6453,1090
503000.0,4,2.5,2940,2,9,1870,1070,47.6214,2940
780000.0,3,2.5,2610,0,9,2610,0,47.6654,2610
212000.0,4,2.0,1880,0,6,980,900,47.495,1670
580000.0,4,2.75,2330,0,7,1710,620,47.7066,2060
465000.0,4,2.5,2200,0,7,2060,140,47.5726,1660
206000.0,4,2.0,1720,0,7,1720,0,47.2845,1750
615000.0,3,2.5,2250,0,9,2250,0,47.5613,2440
519000.0,4,1.0,1640,0,6,1640,0,47.5563,1590
1135000.0,4,3.25,4130,0,11,4130,0,47.5208,3720
330000.0,5,2.5,2600,0,7,2600,0,47.4324,2180
240000.0,4,1.5,1920,0,8,1920,0,47.4961,2020
574000.0,3,2.0,2060,0,9,2060,0,47.5644,2110
930000.0,4,4.25,5710,0,11,5710,0,47.3065,4060
850000.0,4,3.0,2720,0,8,2720,0,47.6749,2140
415000.0,3,1.5,1490,0,7,1090,400,47.7148,1420
480000.0,3,2.5,2360,0,7,1340,1020,47.7076,1520
300000.0,5,1.0,1940,0,7,1940,0,47.4407,1380
439000.0,4,2.25,2570,0,8,2570,0,47.764,1950
450000.0,3,1.0,1160,0,7,1160,0,47.7507,1800
589000.0,3,2.5,2660,0,8,2660,0,47.6042,2660
477000.0,3,2.25,1260,0,7,1260,0,47.5459,1630
587500.0,4,2.25,1780,0,8,1310,470,47.6955,1780
1315000.0,4,2.25,3180,0,10,3180,0,47.6255,3180
1430000.0,4,2.5,3380,0,10,3380,0,47.6292,3390
700000.0,4,2.25,2690,0,9,1890,800,47.612,2670
275000.0,2,1.0,1180,0,6,1180,0,47.7477,1070
367500.0,3,1.0,1660,0,7,1160,500,47.7563,1320
453250.0,4,2.5,2260,0,7,2260,0,47.7235,2300
607000.0,5,1.75,1910,0,8,1390,520,47.5333,1820
255000.0,4,2.0,2430,0,7,1430,1000,47.4979,2430
501000.0,2,2.0,1300,0,7,770,530,47.6831,1160
450000.0,3,1.0,1060,0,7,910,150,47.5784,1480
360000.0,3,2.25,2200,0,8,2200,0,47.4522,2170
460000.0,4,1.75,1720,0,7,1040,680,47.5654,1570
753000.0,3,1.75,2360,0,7,1180,1180,47.6738,1880
389950.0,2,1.0,820,1,6,820,0,47.5294,1550
469000.0,2,1.0,1030,0,7,1030,0,47.681,1400
550000.0,4,1.75,2030,4,9,1730,300,47.5071,2320
565000.0,5,3.5,2700,2,6,1950,750,47.7172,2160
189650.0,2,1.75,1100,0,6,1100,0,47.4136,1230
1525000.0,4,3.25,3620,3,11,2350,1270,47.6499,2550
260000.0,3,1.75,1340,0,7,1340,0,47.3651,1690
243000.0,3,1.75,1790,0,7,1040,750,47.3945,1840
1100000.0,4,2.5,3830,4,9,2030,1800,47.5671,3460
249000.0,3,1.5,1580,0,7,1080,500,47.2761,1580
720000.0,2,1.0,2020,3,7,1700,320,47.506,2020
905000.0,4,2.5,3330,0,10,3330,0,47.5526,3360
824500.0,4,2.5,2610,0,7,1610,1000,47.6848,1820
762500.0,4,2.75,2610,0,8,1760,850,47.5875,2550
580000.0,3,2.5,1740,2,8,1740,0,47.589,1740
380000.0,3,2.0,1840,0,8,1840,0,47.4626,2190
805000.0,3,1.75,1080,0,7,880,200,47.6503,1780
520000.0,4,1.75,1240,0,7,1240,0,47.6892,1260
1569500.0,5,4.5,5620,3,11,4700,920,47.6482,2360
175000.0,2,1.0,1170,2,6,1170,0,47.4017,1380
353500.0,4,2.25,1760,0,7,1760,0,47.4248,1860
500000.0,4,2.5,2230,1,8,1400,830,47.4285,2570
386500.0,3,1.75,1520,0,7,1140,380,47.7167,1380
210000.0,2,1.0,1450,0,7,850,600,47.5293,1190
439500.0,3,2.5,1600,0,7,940,660,47.7679,1600
315000.0,5,2.5,3220,0,8,3220,0,47.3717,2740
339000.0,4,2.5,1830,0,7,1830,0,47.3576,1830
655000.0,4,2.25,2200,0,8,1430,770,47.5653,2420
740000.0,2,2.5,2170,0,8,2170,0,47.7161,2170
685000.0,5,2.5,1900,0,7,1900,0,47.6273,1900
550000.0,5,2.5,2960,0,7,1480,1480,47.5866,1900
405000.0,2,1.75,1710,0,7,1330,380,47.5319,1530
765000.0,4,2.25,2620,3,9,1430,1190,47.584,2620
625000.0,3,2.0,2140,0,8,1680,460,47.5846,2340
207000.0,4,2.5,2100,0,6,2100,0,47.4787,1340
370000.0,4,2.5,2100,0,6,2100,0,47.4787,1340
475000.0,3,2.5,1460,0,8,1150,310,47.6955,1550
365000.0,2,1.0,990,0,7,990,0,47.7252,1080
411800.0,4,2.25,2190,0,7,1340,850,47.7367,1560
668000.0,5,3.5,3990,0,9,2710,1280,47.461,3030
618000.0,3,2.5,2340,0,9,2340,0,47.6059,1820
247500.0,4,2.0,2460,0,7,1230,1230,47.308,1260
345000.0,5,3.0,2080,0,7,1040,1040,47.5707,1420
616300.0,3,2.0,1700,2,7,1700,0,47.6825,1820
348000.0,3,1.5,1330,0,7,1330,0,47.7366,1320
425000.0,3,2.5,1630,0,7,1630,0,47.7508,1770
850000.0,5,2.75,2920,0,8,1660,1260,47.5133,3910
820000.0,5,2.75,2830,0,9,2830,0,47.5932,3170
832000.0,4,2.25,3190,0,10,3190,0,47.5933,3190
835000.0,3,1.75,1490,0,8,1490,0,47.6916,3450
350000.0,3,2.5,1630,0,8,1630,0,47.4913,1420
349000.0,4,2.5,2280,0,7,2280,0,47.4834,2280
1125000.0,6,3.75,3010,0,9,2000,1010,47.6873,1600
320000.0,3,2.5,1590,0,7,1590,0,47.4805,1680
150000.0,3,1.0,1250,0,7,1250,0,47.4169,1010
340000.0,3,1.0,1710,0,6,1310,400,47.506,1200
785500.0,4,4.0,3280,0,10,3280,0,47.5818,3730
410500.0,4,2.5,3362,0,8,3362,0,47.2592,2770
580000.0,3,2.5,2200,2,9,2200,0,47.5916,2200
345000.0,2,1.5,830,0,7,830,0,47.5998,830
550000.0,3,2.25,2160,0,7,1760,400,47.7297,2540
449500.0,4,3.0,2580,0,8,2580,0,47.4646,2250
300000.0,3,1.0,2150,0,6,2150,0,47.7615,1720
915000.0,4,2.5,3510,0,10,3510,0,47.6671,2890
1575000.0,4,3.75,3810,0,11,3810,0,47.5739,3040
599000.0,4,2.75,2020,0,8,1010,1010,47.6053,1840
755000.0,4,2.5,2120,0,7,1620,500,47.5858,1570
400000.0,3,1.0,1250,0,7,1250,0,47.7323,1300
133000.0,3,1.0,980,0,7,980,0,47.3737,1470
330000.0,4,1.5,1250,0,7,960,290,47.7505,1560
330000.0,4,1.0,1100,0,6,1100,0,47.4868,1560
375000.0,3,1.75,1330,0,6,710,620,47.7231,1690
485000.0,4,2.75,2560,0,7,1500,1060,47.7278,2280
470000.0,4,2.5,1850,0,7,1210,640,47.6264,1650
1045000.0,4,3.0,2790,0,8,1880,910,47.6362,1360
548800.0,4,1.0,1660,0,7,1260,400,47.6918,1360
315000.0,2,1.0,1080,0,6,720,360,47.5595,1250
590000.0,3,2.0,3030,1,7,2100,930,47.5289,1990
439950.0,4,2.5,2380,0,7,2380,0,47.4873,2330
325000.0,3,1.75,2250,0,8,2250,0,47.3032,1830
400000.0,2,1.0,880,0,6,880,0,47.6997,1370
685000.0,4,2.5,2770,0,10,2770,0,47.6288,2730
339950.0,3,2.0,1340,0,7,1340,0,47.7756,1420
315000.0,3,1.75,1660,0,7,1660,0,47.4608,1490
411753.0,3,2.5,1710,0,7,1710,0,47.6968,1600
577000.0,2,1.75,1620,0,7,1040,580,47.5703,1500
500000.0,3,1.75,1530,0,8,1530,0,47.545,2060
210000.0,3,2.0,1440,0,7,1440,0,47.345,1580
640000.0,4,1.75,2020,0,7,2020,0,47.3413,1940
460000.0,4,1.75,1870,0,7,1870,0,47.7366,1560
265000.0,2,1.0,620,0,6,620,0,47.5286,620
740000.0,5,5.0,5774,2,11,4490,1284,47.3466,3260
230000.0,3,1.0,1240,0,6,1240,0,47.7681,1760
315000.0,3,1.75,1890,0,7,1460,430,47.3583,1680
432000.0,3,1.75,2410,0,8,1410,1000,47.7429,2410
467000.0,3,2.5,1530,0,8,1530,0,47.569,1720
255000.0,5,3.75,2800,0,7,2800,0,47.319,1700
316500.0,3,1.75,1460,2,7,1010,450,47.5311,1400
190000.0,4,2.0,1580,0,7,860,720,47.7659,1580
490000.0,3,2.0,1450,0,8,1450,0,47.6726,1450
378000.0,4,1.75,1990,0,7,1990,0,47.486,1950
598800.0,6,4.0,4470,3,9,3230,1240,47.4514,1790
333800.0,5,3.0,1980,0,7,1220,760,47.5173,1970
690000.0,4,2.5,2920,0,9,2920,0,47.5759,1810
320000.0,4,1.75,1660,0,6,830,830,47.56,1780
1249000.0,4,3.5,3190,3,9,2410,780,47.5846,2840
335000.0,3,1.5,1560,0,7,1560,0,47.6918,1520
840000.0,3,2.5,3050,0,8,3050,0,47.7034,1970
608250.0,4,2.75,3030,0,8,3030,0,47.4481,3020
550000.0,3,2.5,2260,0,7,2260,0,47.5922,2770
240000.0,3,1.0,1260,0,7,1260,0,47.3452,1300
998000.0,3,2.25,3370,2,9,3370,0,47.5573,2690
275000.0,3,1.75,1490,0,8,1490,0,47.3817,1740
284200.0,3,2.5,1570,0,7,1110,460,47.3386,1470
1715000.0,4,3.75,4490,0,10,3090,1400,47.6315,3760
2400000.0,4,3.75,4090,0,11,3400,690,47.6338,3910
930800.0,5,2.5,4150,0,10,4150,0,47.6664,3320
930000.0,4,3.0,2900,3,8,1530,1370,47.5854,2820
215000.0,4,1.5,1430,0,7,1030,400,47.3034,1390
480000.0,2,1.5,1008,4,6,1008,0,47.3853,1132
483945.0,2,1.75,1480,0,6,840,640,47.558,1090
347000.0,3,1.75,1240,0,7,1240,0,47.6108,1370
232500.0,3,2.0,1370,0,7,1110,260,47.3009,1640
390000.0,4,2.25,1770,0,8,1190,580,47.4413,2490
550000.0,3,2.25,2160,0,8,1410,750,47.6232,2180
590000.0,4,2.5,2340,0,9,2340,0,47.5679,2510
420850.0,1,1.0,960,0,5,960,0,47.6951,1320
345000.0,4,2.5,2280,3,7,1390,890,47.4414,1990
429800.0,3,2.0,1970,0,8,1970,0,47.3744,1970
302000.0,4,1.75,1530,0,7,1530,0,47.4549,1530
800000.0,4,1.5,1790,0,8,1790,0,47.689,1200
250000.0,3,2.5,1700,0,8,1700,0,47.2615,1940
605000.0,3,2.0,2660,0,7,1330,1330,47.6391,1790
412000.0,3,1.75,1950,0,8,1950,0,47.3133,2450
252000.0,3,2.0,1340,0,6,1340,0,47.4498,1290
375000.0,3,1.0,1130,0,7,1130,0,47.5491,2280
725000.0,2,1.75,1950,0,7,1010,940,47.6513,1360
471750.0,5,3.5,3790,1,8,2120,1670,47.4891,1740
490000.0,4,2.25,2020,0,7,2020,0,47.483,2120
439000.0,2,1.0,800,0,7,800,0,47.6775,1330
355000.0,4,2.0,1770,0,6,1770,0,47.4589,1010
250000.0,1,0.75,940,0,6,940,0,47.7182,1930
780000.0,4,2.25,2260,0,10,2260,0,47.5637,2840
409000.0,2,1.0,890,0,6,890,0,47.5631,1190
420000.0,2,1.0,860,0,6,860,0,47.6862,1230
200000.0,1,0.75,680,0,5,680,0,47.6964,1580
830000.0,2,1.5,2130,0,7,2130,0,47.6638,2670
695000.0,3,2.5,2390,0,9,2390,0,47.6199,2540
815000.0,4,2.75,3488,0,10,3488,0,47.6055,3600
210000.0,3,1.75,1260,0,7,820,440,47.3574,1260
635000.0,3,1.75,2940,2,8,1590,1350,47.7235,2880
562500.0,4,2.5,2440,0,9,2440,0,47.5357,2590
402500.0,4,2.5,2600,0,10,2600,0,47.3053,2820
555000.0,3,2.0,2080,0,7,1040,1040,47.6768,1920
310000.0,3,1.0,1990,0,7,1990,0,47.7116,1320
500000.0,4,2.5,2840,0,9,2840,0,47.7359,2500
430000.0,6,3.0,2630,0,7,1610,1020,47.7166,1220
1600000.0,3,4.25,2820,0,10,2460,360,47.6298,3300
627500.0,4,1.0,1560,0,7,1560,0,47.6711,1890
335000.0,4,2.5,2330,0,8,2330,0,47.5001,1810
962000.0,4,2.25,3320,0,8,1810,1510,47.5566,2450
299000.0,3,1.75,1730,0,7,1730,0,47.5318,1600
399950.0,4,2.5,3110,0,8,3110,0,47.3781,2950
322000.0,3,1.0,1230,0,7,1230,0,47.6829,1380
430000.0,2,1.5,950,0,7,950,0,47.6912,1440
307000.0,3,1.75,1890,0,7,1890,0,47.4156,1500
194000.0,3,1.5,1010,0,6,1010,0,47.4925,980
180000.0,3,1.0,1010,0,6,1010,0,47.3043,1060
465000.0,4,2.25,2340,0,8,1170,1170,47.6211,1810
722500.0,4,2.5,2460,0,9,2460,0,47.6125,2730
470450.0,2,1.0,1010,0,7,1010,0,47.6711,1800
280000.0,3,2.5,1650,0,7,1650,0,47.36,1750
176250.0,4,2.0,1440,0,7,1440,0,47.3056,1030
560000.0,5,1.0,1710,0,7,1320,390,47.5379,1880
830000.0,3,2.5,2760,3,10,2000,760,47.739,2760
276900.0,2,1.0,1350,2,7,1350,0,47.4967,1280
625000.0,3,1.75,1660,0,7,1660,0,47.6296,1660
1015000.0,4,2.5,2960,0,8,2160,800,47.6367,1600
463500.0,1,1.0,1090,0,6,1090,0,47.54,1830
485000.0,3,2.5,3110,0,9,3110,0,47.4369,2650
272000.0,3,2.0,1380,0,7,1380,0,47.3336,1600
305000.0,2,1.0,1290,0,7,1290,0,47.6971,1290
760000.0,3,2.5,1980,0,7,1980,0,47.571,2040
387500.0,2,1.0,870,0,7,870,0,47.7024,1620
352000.0,4,2.5,2470,0,8,2470,0,47.3457,2470
507000.0,3,1.75,2140,0,8,1490,650,47.4296,2220
156000.0,3,1.0,770,0,6,770,0,47.4509,1560
580000.0,3,3.25,1490,0,8,1220,270,47.6357,1550
630000.0,4,2.5,2510,0,8,1610,900,47.5834,2080
275000.0,5,1.5,1950,0,7,1130,820,47.4882,1680
835000.0,5,4.0,3600,2,8,1800,1800,47.7022,3600
340000.0,4,2.5,2380,0,8,2380,0,47.4356,1940
329350.0,2,1.0,720,0,6,720,0,47.7001,840
1480000.0,3,3.5,4070,0,11,4070,0,47.659,3770
475000.0,3,1.0,1250,0,7,1250,0,47.5956,3060
719950.0,3,2.25,2190,0,8,2190,0,47.6758,1510
235000.0,1,1.0,810,0,7,810,0,47.5188,980
875000.0,3,1.5,2440,0,8,1320,1120,47.6991,2160
380000.0,4,1.75,1740,0,7,1740,0,47.4498,1540
325000.0,3,2.25,1480,0,7,1480,0,47.3317,1730
475000.0,4,2.5,2120,0,9,2120,0,47.7611,3320
152900.0,1,1.0,900,0,6,900,0,47.2107,1290
210000.0,2,2.0,1190,0,6,1190,0,47.5113,1190
350000.0,4,1.0,1010,0,6,750,260,47.5518,1450
505000.0,3,2.5,2100,0,8,2100,0,47.4754,2080
464900.0,4,2.25,2020,0,7,1380,640,47.7262,2030
650000.0,3,2.0,2520,0,8,1790,730,47.5767,1590
369950.0,2,2.75,1370,0,8,1080,290,47.7053,1370
250000.0,3,2.5,1530,0,7,1530,0,47.5434,1540
320000.0,3,2.5,1530,0,7,1530,0,47.5434,1540
2532000.0,4,4.25,5040,3,10,3420,1620,47.6702,3960
340000.0,4,2.25,2530,0,7,2530,0,47.3939,2650
440000.0,2,1.5,1010,0,5,1010,0,47.6757,1760
219950.0,3,1.0,1200,0,7,1200,0,47.2021,1300
940000.0,4,3.0,2720,0,9,2720,0,47.5833,2640
399950.0,4,1.5,1850,0,6,1110,740,47.5352,990
1568000.0,3,2.75,2340,0,9,2340,0,47.632,3480
528000.0,4,1.75,1860,0,7,1460,400,47.7097,1900
545000.0,4,1.75,1940,0,8,1560,380,47.7021,2310
575000.0,2,2.0,1680,0,8,1680,0,47.7136,1900
235000.0,4,2.75,1770,0,8,1250,520,47.3074,2070
272000.0,3,2.5,1790,0,8,1790,0,47.3291,1850
380000.0,4,1.75,1720,0,8,1720,0,47.4764,1660
195000.0,3,1.0,1280,0,7,1280,0,47.7512,1280
297000.0,3,2.5,1690,0,7,1690,0,47.3561,1830
349000.0,4,2.5,2190,0,8,2190,0,47.2923,2240
320000.0,2,1.0,710,2,6,710,0,47.5376,1610
319990.0,4,1.5,1890,0,7,1890,0,47.428,1610
439900.0,2,2.0,1410,0,8,1410,0,47.5242,1410
429000.0,3,3.25,2210,0,8,1820,390,47.7031,2010
272500.0,3,2.0,1540,0,7,1540,0,47.3539,2070
400000.0,4,2.0,1350,0,7,1350,0,47.7287,1050
462000.0,5,2.0,1380,0,7,1380,0,47.6647,1830
510000.0,2,1.0,890,0,7,890,0,47.6823,1450
550000.0,3,2.5,1900,0,8,1900,0,47.6075,1880
150000.0,3,1.0,1240,0,6,1240,0,47.3701,870
460000.0,3,2.5,1730,0,7,1210,520,47.7187,1870
632500.0,4,2.5,2090,0,10,2090,0,47.6304,2660
361000.0,3,1.75,1650,0,7,1650,0,47.7567,1340
437000.0,3,2.25,1130,0,8,1030,100,47.6799,1300
370000.0,6,2.75,3240,0,6,2160,1080,47.3054,1230
884250.0,4,2.5,3840,0,10,3840,0,47.5953,3560
225000.0,3,1.0,1200,0,6,1200,0,47.3609,1200
235000.0,2,1.0,870,0,6,870,0,47.5186,820
767500.0,6,3.5,2410,4,9,2220,190,47.54,1980
1200000.0,3,1.75,1560,4,6,1560,0,47.5779,2890
715000.0,3,2.5,2410,0,9,2410,0,47.6789,3370
417000.0,4,2.25,2300,0,7,1380,920,47.7137,2010
199000.0,3,1.0,1390,0,7,1390,0,47.4225,1030
875000.0,5,2.5,2920,0,8,2320,600,47.6265,2970
545000.0,4,1.5,1370,0,7,1370,0,47.6849,2030
192500.0,2,1.0,950,0,6,950,0,47.4909,1820
822500.0,3,2.5,3090,0,10,3090,0,47.6868,3140
800000.0,4,2.5,2390,0,9,1590,800,47.5801,1900
1250000.0,3,2.5,2070,0,9,2070,0,47.6256,3300
3850000.0,4,4.25,5770,4,11,5770,0,47.585,4620
295000.0,3,2.5,1460,0,7,1460,0,47.3673,1830
419000.0,2,1.75,1510,0,8,1510,0,47.7191,1350
1195000.0,5,3.25,5180,0,11,2610,2570,47.555,4050
750000.0,4,2.75,3430,0,11,3430,0,47.5879,3250
502000.0,4,1.5,1700,0,7,1700,0,47.7677,1750
1025000.0,3,1.75,2640,3,9,1320,1320,47.5826,2740
398500.0,3,1.0,1200,0,6,1200,0,47.7163,1120
700000.0,2,1.5,1850,2,7,1850,0,47.5742,1850
248000.0,5,1.5,1510,0,7,1510,0,47.4852,1480
800000.0,4,2.0,2130,0,7,1070,1060,47.6545,1990
383000.0,4,2.5,2640,0,9,2640,0,47.315,1650
688000.0,4,3.0,3000,3,8,1970,1030,47.5744,1900
521000.0,3,2.0,1870,0,7,1060,810,47.7029,1870
365000.0,2,1.0,990,0,7,990,0,47.72,1230
491000.0,3,2.0,2005,0,7,1605,400,47.6039,1750
643000.0,3,2.75,2030,0,8,1400,630,47.626,1780
279000.0,3,2.5,1500,0,7,1060,440,47.3025,1390
583500.0,4,1.0,1530,0,7,1530,0,47.6748,1300
310000.0,3,2.5,1990,0,7,1990,0,47.3841,1790
310000.0,3,1.75,1420,0,7,1100,320,47.4892,1810
280000.0,3,1.0,1400,0,6,1400,0,47.4195,1260
272000.0,4,2.5,1870,0,7,1870,0,47.4334,2390
870000.0,4,3.0,3040,0,9,2680,360,47.6093,3520
307000.0,3,2.0,1790,0,7,1390,400,47.4643,1790
490000.0,2,1.5,1590,0,7,920,670,47.5831,1900
399950.0,3,2.0,2050,0,7,1170,880,47.7447,1680
1635000.0,5,3.5,4220,0,10,2110,2110,47.6003,3450
989000.0,5,4.5,4030,0,11,4030,0,47.5812,3860
264950.0,4,1.75,1770,0,7,1050,720,47.3646,1410
491500.0,4,2.75,2100,0,8,1400,700,47.7267,1900
345000.0,3,2.25,2120,0,7,2120,0,47.4745,2070
339900.0,4,1.75,2600,0,8,2020,580,47.2969,2200
852000.0,3,3.0,2400,0,7,1860,540,47.6288,1750
585000.0,5,3.5,3180,3,7,1690,1490,47.5833,2430
723000.0,4,2.0,2790,0,8,1640,1150,47.5509,2400
594000.0,3,2.25,2080,0,8,2080,0,47.7221,3730
405000.0,2,1.5,1370,0,7,1370,0,47.6943,1380
725500.0,4,2.5,2790,0,9,2790,0,47.6628,2790
800000.0,2,1.0,1740,0,8,1740,0,47.6729,1980
1325000.0,3,3.75,6400,2,10,3810,2590,47.7313,3430
180500.0,3,2.5,1800,0,7,1800,0,47.3643,1770
325000.0,3,2.5,1800,0,7,1800,0,47.3643,1770
235000.0,3,1.75,1190,0,7,1190,0,47.3151,1250
330000.0,2,1.0,860,0,7,860,0,47.5075,1310
678500.0,3,2.0,2460,2,8,1370,1090,47.5215,2150
463000.0,4,2.5,1980,0,7,1980,0,47.7158,1980
250000.0,2,1.0,670,0,6,670,0,47.53,870
655000.0,3,2.0,1410,0,8,1410,0,47.5597,1820
239900.0,4,2.25,1860,0,8,1120,740,47.3127,1990
185000.0,3,1.0,980,0,7,980,0,47.3496,1780
1735000.0,4,2.25,3040,3,9,2080,960,47.6565,2870
251700.0,3,2.25,1810,0,7,1240,570,47.4997,1810
400000.0,4,2.0,1560,0,8,1320,240,47.7565,1870
735000.0,4,1.75,2100,0,8,1340,760,47.6079,2060
1700000.0,5,2.0,2500,4,8,2500,0,47.5883,1880
82500.0,2,1.0,520,0,5,520,0,47.4799,1572
765000.0,4,4.0,3010,0,10,3010,0,47.5833,3490
292500.0,4,1.75,2140,0,7,1420,720,47.3096,2040
270000.0,3,2.25,2390,0,7,1990,400,47.4568,1610
415000.0,2,1.0,1510,0,7,1090,420,47.711,1460
950000.0,4,1.75,2210,0,7,1460,750,47.5927,2640
353000.0,3,2.75,2170,0,7,2170,0,47.3812,2170
670950.0,3,2.5,1790,0,8,1790,0,47.6726,1450
280950.0,3,1.75,1390,3,7,840,550,47.4725,1390
585000.0,3,1.75,1850,0,8,1850,0,47.5608,2220
525000.0,2,1.5,1480,0,8,1480,0,47.5484,1600
605000.0,3,1.75,1850,0,8,1370,480,47.6379,1880
1010000.0,4,3.5,3350,0,9,2550,800,47.6782,1050
245990.0,3,1.0,1040,0,7,1040,0,47.453,1350
535000.0,4,2.25,2810,0,10,2810,0,47.4585,2810
410000.0,1,1.5,1010,0,7,1010,0,47.5411,1230
550000.0,3,2.5,2250,0,8,2250,0,47.7489,2080
665000.0,3,1.75,1800,0,8,1800,0,47.6357,1950
455000.0,3,1.0,2400,0,7,1890,510,47.75,2390
440000.0,4,1.0,1780,0,7,1780,0,47.6624,1750
332000.0,3,2.25,2120,0,9,1720,400,47.3524,2320
280000.0,3,2.5,1860,0,7,1860,0,47.2891,1760
570000.0,3,3.5,1460,0,8,1150,310,47.6169,1460
250000.0,3,1.0,1230,0,7,1230,0,47.428,1510
238000.0,2,1.0,1088,0,6,1088,0,47.2685,1088
265000.0,3,1.0,800,0,6,700,100,47.7505,1060
306000.0,3,1.0,1190,0,7,1190,0,47.7428,1850
345000.0,5,2.75,1940,0,7,1240,700,47.4911,1950
765000.0,4,2.5,3300,0,9,1720,1580,47.7119,2290
346300.0,4,2.5,2590,0,8,2590,0,47.2634,2400
342500.0,3,2.0,2080,0,8,2080,0,47.214,1080
501000.0,4,2.25,2680,0,7,2680,0,47.7534,2460
270000.0,3,2.5,1670,0,7,1300,370,47.369,1490
638000.0,3,1.0,1830,0,8,1720,110,47.6052,1650
460000.0,3,1.75,1400,0,8,700,700,47.6508,1370
760000.0,4,1.75,2770,0,7,1470,1300,47.6255,1910
1085000.0,3,2.5,3630,0,9,2150,1480,47.561,3150
234000.0,3,1.0,1040,0,6,1040,0,47.7425,1520
1650000.0,3,2.75,2690,4,10,2690,0,47.5487,2940
488000.0,5,2.0,2020,0,7,2020,0,47.6949,1510
1550000.0,5,2.5,2450,0,9,2450,0,47.6275,3020
499000.0,4,3.0,2030,0,7,2030,0,47.7689,1990
150000.0,3,1.0,1450,0,7,1450,0,47.5056,1680
333000.0,4,2.5,2400,0,8,2400,0,47.2697,2150
700000.0,4,2.75,2870,1,8,1860,1010,47.7425,2430
275000.0,4,1.0,1340,0,7,1340,0,47.489,1620
330000.0,3,2.5,1680,0,7,1080,600,47.5051,1390
360000.0,4,2.0,1850,0,7,1850,0,47.7406,1310
467000.0,3,1.0,1220,0,7,1220,0,47.7133,1360
568000.0,3,2.5,2320,0,9,1790,530,47.6163,3290
605000.0,5,2.25,3220,0,8,3220,0,47.6474,2260
750000.0,4,2.75,3190,0,9,3190,0,47.5898,3159
760000.0,3,2.75,3530,0,10,3530,0,47.6377,3560
265000.0,3,1.75,2050,0,7,1240,810,47.4257,1770
490000.0,3,1.75,1720,0,7,1720,0,47.5699,1440
360000.0,4,2.5,2850,0,8,2850,0,47.3552,2850
311750.0,4,2.25,2270,0,7,1290,980,47.3287,2030
399000.0,3,2.25,1880,0,8,1420,460,47.7623,2300
347000.0,4,2.5,2770,0,8,2770,0,47.3739,2370
1680000.0,4,3.75,4490,0,12,4490,0,47.6406,4470
585000.0,4,2.5,3110,0,9,3110,0,47.5408,3110
340000.0,4,2.5,2360,0,8,2360,0,47.4052,2280
612000.0,3,2.5,2180,0,8,2180,0,47.5723,2120
230000.0,2,1.75,1910,0,8,1910,0,47.3733,1470
604000.0,4,2.5,2260,0,9,2260,0,47.5752,2690
250000.0,3,1.75,1770,0,7,1770,0,47.3188,1630
258500.0,3,2.0,1460,0,7,1460,0,47.359,1630
783000.0,4,2.75,2080,0,8,1470,610,47.6422,1970
1050000.0,5,2.25,2960,2,8,1550,1410,47.6456,2860
760000.0,4,2.5,3220,0,9,3220,0,47.688,3150
276000.0,3,1.0,1140,0,7,1140,0,47.5535,1140
550000.0,4,2.0,1660,0,8,1660,0,47.6231,1820
398000.0,4,1.0,1430,0,7,1430,0,47.7272,1410
775000.0,3,3.0,1820,0,8,1620,200,47.6711,1440
1027500.0,4,3.0,3540,0,8,2720,820,47.5471,2780
327000.0,4,1.0,1620,0,7,1620,0,47.4763,1310
564500.0,4,2.75,3100,0,8,3100,0,47.7302,2860
782000.0,4,1.75,1500,0,7,1500,0,47.6794,1360
398000.0,4,2.5,2820,0,9,2820,0,47.3477,2820
257000.0,3,1.75,1850,0,6,1850,0,47.7244,1510
235000.0,4,2.0,1570,0,7,1570,0,47.3168,1550
453000.0,4,2.75,2300,3,8,1550,750,47.3714,2130
535000.0,2,1.0,920,0,6,920,0,47.6831,1760
275000.0,3,2.5,1600,0,8,1600,0,47.3534,1700
665000.0,3,2.5,2630,0,9,2630,0,47.5515,2640
670000.0,4,2.75,3020,0,8,1540,1480,47.6299,2230
465000.0,3,1.75,1490,0,7,1060,430,47.72,1490
210000.0,3,1.5,1160,0,7,1160,0,47.364,1170
265000.0,4,2.5,2040,0,8,2040,0,47.3182,2040
426000.0,2,2.5,1550,0,8,1550,0,47.7034,1570
529219.0,4,2.25,1990,0,8,1290,700,47.6236,1820
600000.0,3,2.25,1900,0,7,1440,460,47.7529,2460
875000.0,5,3.5,3840,0,9,3840,0,47.6039,3570
608000.0,4,3.0,2400,0,7,1200,1200,47.6466,2670
220000.0,3,1.0,1660,0,7,1660,0,47.2159,1660
1760000.0,4,5.0,6055,3,12,3555,2500,47.5524,4890
295450.0,3,2.0,2030,2,8,1890,140,47.2953,1870
315000.0,2,1.0,840,0,7,840,0,47.5557,1590
205000.0,4,2.0,1450,0,7,1450,0,47.3933,1570
310000.0,3,1.5,1460,0,7,1460,0,47.4275,1420
1000000.0,5,1.0,2010,0,9,1890,120,47.6501,2330
525000.0,4,2.5,2910,2,9,2910,0,47.3552,3190
284000.0,4,1.75,1880,0,7,1130,750,47.5137,1340
510000.0,3,1.75,2170,0,8,1450,720,47.6147,2090
405000.0,2,1.0,1260,0,7,1260,0,47.6988,1420
509950.0,3,2.5,1970,0,8,1970,0,47.7698,1800
600000.0,4,2.25,2090,0,8,2090,0,47.6876,3420
990000.0,4,3.75,3450,0,10,2570,880,47.692,1880
280005.0,3,1.5,1130,0,7,1130,0,47.5041,1130
700000.0,3,1.75,2600,0,8,1300,1300,47.3402,1980
330000.0,3,1.0,1030,0,7,1030,0,47.5281,1030
340000.0,2,1.0,1700,2,7,1230,470,47.4131,2040
468000.0,2,2.5,1480,0,8,1390,90,47.6658,2130
1339000.0,4,2.5,4250,2,9,3260,990,47.5578,3690
515000.0,3,1.75,1600,0,8,1600,0,47.5632,2640
245000.0,4,2.0,1870,2,7,1870,0,47.1985,1770
265000.0,3,2.5,1440,0,7,1000,440,47.4042,1680
372400.0,3,2.5,2720,0,9,2720,0,47.4185,2590
390000.0,3,1.5,1240,0,6,1240,0,47.753,1630
208000.0,3,1.0,1020,0,7,1020,0,47.278,1370
273000.0,2,0.5,1180,0,6,590,590,47.769,1380
455000.0,5,3.5,3080,0,8,2310,770,47.7454,2980
270000.0,4,2.5,1750,0,7,1750,0,47.3082,1940
618000.0,4,2.25,2530,0,7,1210,1320,47.6049,1720
213550.0,3,2.5,1580,0,7,1580,0,47.3334,1640
210000.0,5,1.75,2340,0,7,2340,0,47.4232,1390
2750000.0,5,4.0,6300,1,12,4360,1940,47.5922,3260
403500.0,4,2.75,2400,0,7,1200,1200,47.7027,1100
235000.0,3,1.5,1300,0,7,1300,0,47.2083,1570
287500.0,3,2.0,1760,0,6,880,880,47.4799,1720
546800.0,4,1.5,1520,0,7,1020,500,47.6904,1710
183000.0,3,1.75,1070,0,6,1070,0,47.2853,1260
560000.0,3,2.0,2560,0,8,2560,0,47.295,2360
299500.0,3,1.0,1280,0,6,1280,0,47.5724,1630
610000.0,4,2.25,1660,0,8,1660,0,47.6263,1790
288350.0,3,1.5,1860,0,7,1200,660,47.4513,1800
500000.0,2,1.0,950,2,7,850,100,47.6562,1670
625000.0,4,2.75,2140,0,7,1190,950,47.6792,2140
418000.0,2,1.5,1480,0,7,1240,240,47.5439,1550
660000.0,3,3.0,2260,0,8,1660,600,47.6108,2260
775000.0,4,2.5,2300,0,9,2300,0,47.6943,2170
429500.0,3,2.75,1650,0,7,1230,420,47.7232,1770
569000.0,3,2.0,1990,0,7,1230,760,47.6272,1600
250000.0,4,2.0,1960,0,7,1160,800,47.4081,1950
225000.0,3,1.5,1310,0,7,1310,0,47.3682,1430
530000.0,4,2.75,2450,0,9,2450,0,47.4268,2650
306000.0,3,1.0,910,0,7,910,0,47.7586,1170
517100.0,3,1.75,1580,0,7,1580,0,47.5396,1760
354950.0,3,1.75,1780,0,7,1130,650,47.7628,1660
348000.0,3,1.5,1040,0,6,1040,0,47.6793,1010
522250.0,4,2.5,2340,0,8,1640,700,47.7466,2340
275000.0,3,2.5,1720,0,8,1000,720,47.3186,1720
390000.0,3,1.5,1600,0,7,1600,0,47.7109,1600
260000.0,3,1.5,1320,0,7,1320,0,47.4267,1530
585000.0,5,2.75,2350,0,8,1520,830,47.6388,1920
605000.0,5,2.75,2740,0,7,1670,1070,47.6866,1600
342000.0,4,2.5,2300,0,8,2300,0,47.3813,1860
900000.0,5,3.0,4350,0,10,2950,1400,47.6518,3280
252000.0,3,1.75,1430,0,7,980,450,47.3993,1430
357000.0,3,1.75,2400,0,9,2400,0,47.3371,2800
370000.0,3,1.0,940,0,6,940,0,47.6181,1000
322500.0,3,1.0,1020,0,7,1020,0,47.5121,1110
210000.0,2,2.0,1680,0,7,1680,0,47.3065,1340
290000.0,2,1.0,1340,0,7,1340,0,47.7202,1610
860000.0,4,3.25,3960,0,10,3960,0,47.5854,3680
302000.0,6,2.0,2650,0,8,2650,0,47.5543,1640
369160.0,4,2.25,2120,2,8,2120,0,47.3367,2360
1185000.0,4,2.75,2850,0,9,2530,320,47.6406,2083
993000.0,4,2.0,2850,0,8,2490,360,47.5892,2430
380000.0,6,2.0,1870,0,7,1870,0,47.5342,1500
635000.0,4,2.0,2660,0,7,1380,1280,47.7229,1660
260000.0,3,1.0,1190,0,6,1190,0,47.5687,1230
243000.0,2,1.0,1770,0,7,960,810,47.4974,1830
1400000.0,4,2.5,2770,0,9,2770,0,47.5831,2770
665000.0,4,2.5,2080,2,8,1220,860,47.7228,2090
898000.0,5,2.25,2700,0,9,2700,0,47.6599,2630
583000.0,4,2.75,2200,0,8,1100,1100,47.5744,1390
429000.0,4,1.75,2160,0,8,2160,0,47.6976,2080
471000.0,3,2.5,2010,0,8,2010,0,47.7317,2010
1810000.0,3,3.5,3780,0,9,2430,1350,47.6394,3780
739500.0,3,3.25,4460,0,9,4460,0,47.3648,2670
450000.0,3,1.5,1770,0,8,1160,610,47.5659,2450
552500.0,3,1.0,1430,0,7,1430,0,47.6895,1210
437000.0,4,1.75,1700,0,7,850,850,47.5674,1610
270000.0,4,2.0,1830,0,7,1830,0,47.5331,1760
226740.0,3,1.5,1410,0,7,1410,0,47.2927,2180
446500.0,4,2.5,3060,0,8,1810,1250,47.7675,2690
283000.0,3,2.0,1820,2,7,1520,300,47.2103,1490
445000.0,4,1.75,2430,0,7,2430,0,47.5245,1330
250000.0,2,1.0,740,0,6,740,0,47.5172,740
307000.0,3,1.0,770,0,6,670,100,47.5133,920
315000.0,4,2.75,2200,0,8,1860,340,47.295,2290
555000.0,3,3.0,2920,2,7,1540,1380,47.5159,2270
264900.0,4,2.5,2040,0,7,1250,790,47.4056,1900
510000.0,3,2.0,1600,0,7,990,610,47.6939,1580
328000.0,4,2.5,1990,0,7,1990,0,47.4445,1990
358000.0,4,2.5,1830,0,7,1830,0,47.3565,1830
325000.0,3,2.5,2540,0,7,2540,0,47.3989,2190
1365000.0,2,3.25,2700,3,9,2700,0,47.5684,2710
230000.0,4,2.0,1440,0,7,1440,0,47.3417,1190
545000.0,3,2.0,1550,0,7,940,610,47.6379,1880
705380.0,3,2.5,2490,0,9,2490,0,47.5493,2130
459000.0,5,2.5,2650,0,7,1350,1300,47.7482,2160
815000.0,4,2.25,2000,0,8,2000,0,47.6852,1610
495000.0,6,5.0,3440,0,8,3280,160,47.4871,1400
520000.0,3,2.5,2280,3,9,2280,0,47.3053,2240
430000.0,2,1.5,1320,0,7,1320,0,47.6704,1320
255000.0,4,2.5,2070,0,8,2070,0,47.3487,1950
588000.0,3,2.0,1860,0,7,1860,0,47.6892,1580
350000.0,3,1.0,940,0,6,940,0,47.6195,1180
625000.0,4,2.75,2290,2,7,2290,0,47.5515,2540
172500.0,2,2.0,1510,0,6,1250,260,47.481,1490
554000.0,3,2.0,1830,0,7,1290,540,47.573,1530
775000.0,4,2.5,3090,0,9,3090,0,47.705,3050
1187500.0,4,3.5,4340,0,11,4340,0,47.6471,3430
618000.0,3,2.75,3200,1,9,3200,0,47.7443,2880
305000.0,4,1.0,1560,0,6,1560,0,47.4552,1380
232000.0,3,2.0,1280,0,7,1280,0,47.3715,1590
262000.0,4,2.5,2020,0,7,2020,0,47.2796,1940
234000.0,3,1.0,1040,0,7,1040,0,47.3731,1470
500000.0,4,2.75,2260,3,7,1330,930,47.7088,1790
278000.0,3,1.0,860,0,6,860,0,47.4623,890
230000.0,5,1.0,1920,0,7,1160,760,47.4756,1920
500000.0,4,1.75,2290,0,8,1270,1020,47.5328,2290
366500.0,4,2.75,2070,0,7,1120,950,47.7416,1010
665000.0,6,3.0,4250,0,7,3020,1230,47.5584,1520
1101000.0,3,1.5,2220,3,9,1790,430,47.5825,1670
575000.0,2,1.75,1840,0,8,1140,700,47.6875,1540
674750.0,4,2.5,2590,0,10,2590,0,47.5848,2800
719000.0,5,2.0,3110,0,7,1560,1550,47.5615,1720
482000.0,3,1.75,2600,0,7,1300,1300,47.4464,1941
254000.0,2,1.0,1060,0,6,1060,0,47.7508,1260
443725.0,3,1.75,1250,0,7,750,500,47.6869,1240
575000.0,4,2.5,2520,0,8,2520,0,47.652,2230
469000.0,3,2.25,2070,0,8,1440,630,47.7766,2070
175000.0,2,1.0,1300,0,6,1300,0,47.327,1470
437000.0,5,2.0,2190,0,7,1390,800,47.5488,2010
550000.0,4,3.0,2760,0,8,1760,1000,47.7669,1900
172040.0,3,2.25,1710,0,7,1130,580,47.3911,1790
363000.0,3,2.0,1750,0,8,1750,0,47.3693,1840
282000.0,3,2.25,1552,0,7,1552,0,47.3198,1677
400000.0,6,2.0,2350,1,8,2000,350,47.5115,1560
650000.0,5,3.5,5110,0,10,3850,1260,47.7261,1790
365000.0,3,2.5,1720,0,7,1720,0,47.3391,1340
269950.0,4,2.5,1960,0,8,1960,0,47.2855,1850
260000.0,2,1.0,1270,0,6,1270,0,47.3375,1270
193000.0,3,1.5,1180,0,7,1180,0,47.2959,1630
340000.0,4,2.25,2230,0,8,2230,0,47.3769,2420
900000.0,4,3.25,4700,0,10,3420,1280,47.6445,3640
371000.0,3,2.5,2150,0,8,2150,0,47.4627,2150
592000.0,3,2.5,2400,0,8,2400,0,47.5028,1370
300000.0,3,2.5,1830,0,7,1830,0,47.5003,1610
449950.0,4,3.0,2800,0,8,2800,0,47.3542,2800
299500.0,3,2.5,2090,0,8,2090,0,47.2735,2320
995000.0,4,2.25,2340,0,9,2340,0,47.5377,2340
335000.0,4,1.75,1670,0,7,1100,570,47.5299,1080
280000.0,4,2.25,1990,0,8,1180,810,47.3258,2030
446000.0,4,2.25,2270,0,7,1290,980,47.7278,1480
1544500.0,4,2.75,4910,0,10,2560,2350,47.6444,3980
325000.0,3,1.0,950,0,6,950,0,47.5273,1140
450000.0,3,1.75,1610,0,7,1610,0,47.6641,1610
322500.0,4,2.5,1940,0,7,1940,0,47.3843,1850
453000.0,3,1.0,1210,0,7,1210,0,47.5637,1700
655000.0,4,2.5,2570,0,9,2570,0,47.7076,2460
603000.0,3,2.25,1700,0,7,1150,550,47.6819,1500
235000.0,4,1.0,1610,0,6,1610,0,47.2751,1270
968933.0,4,3.5,4120,0,11,3070,1050,47.681,2470
1015000.0,3,3.5,2880,0,8,1690,1190,47.6113,2530
435000.0,4,2.25,1990,0,8,1990,0,47.667,2320
242000.0,3,2.0,1260,0,7,1260,0,47.3635,1950
487000.0,6,3.25,4750,0,8,4750,0,47.1879,2230
810000.0,4,2.75,3010,0,9,3010,0,47.6979,3010
625000.0,3,2.5,2410,0,8,1820,590,47.7457,2980
165000.0,3,1.5,1280,0,7,1280,0,47.3323,1566
335000.0,3,1.0,2320,0,7,1160,1160,47.5327,1230
286700.0,3,1.0,1220,0,6,1220,0,47.5297,1100
699000.0,2,1.5,1400,0,8,1400,0,47.6768,1900
280000.0,3,1.75,1590,0,7,1140,450,47.4288,1590
580000.0,4,2.5,2220,0,8,2220,0,47.5716,2220
754800.0,2,2.5,2770,0,8,2770,0,47.7072,1870
525000.0,4,2.5,2303,0,8,2303,0,47.7266,2080
562000.0,3,1.75,1600,2,8,1600,0,47.7437,2590
575000.0,4,1.75,1280,0,7,860,420,47.6805,1490
808900.0,5,2.5,2900,0,9,2900,0,47.5396,3200
992000.0,3,2.25,2950,0,10,2070,880,47.5571,2950
335000.0,3,2.5,1700,0,7,1700,0,47.3826,2190
473000.0,3,2.75,1050,0,7,1050,0,47.7163,1860
350000.0,4,2.75,2990,1,8,1880,1110,47.3357,2790
1600000.0,5,2.5,3100,0,9,3100,0,47.6154,2180
305500.0,3,1.0,1240,0,7,1240,0,47.7542,1550
306000.0,2,1.0,780,0,7,780,0,47.7383,2200
233000.0,2,2.25,850,0,8,850,0,47.7064,850
490000.0,3,1.75,1540,0,8,1540,0,47.7152,1710
445000.0,4,2.5,2280,0,8,2280,0,47.3424,2280
355000.0,3,2.25,2550,0,7,1850,700,47.4856,2240
360000.0,2,2.0,1770,0,8,1770,0,47.4287,2090
737500.0,3,1.75,2320,0,7,2320,0,47.6877,1610
985000.0,3,3.5,2600,0,8,2600,0,47.582,2430
349950.0,2,3.25,1570,0,8,1310,260,47.548,1570
520000.0,4,2.5,3060,0,8,2860,200,47.5383,2950
355950.0,4,2.5,1960,0,7,1220,740,47.7654,1910
485000.0,5,2.5,3270,0,9,3270,0,47.4461,2980
143000.0,3,1.0,1090,0,6,1090,0,47.3159,960
3278000.0,2,1.75,6840,4,11,4350,2490,47.6042,3120
355000.0,3,1.0,940,0,7,940,0,47.7002,1060
1126000.0,5,3.5,3880,3,9,2540,1340,47.5696,3690
200000.0,5,1.75,1770,0,7,1770,0,47.5025,1370
913000.0,4,2.5,3640,0,11,3640,0,47.5899,3370
1600000.0,3,2.5,3160,2,9,1820,1340,47.6151,3390
409900.0,2,2.5,1590,0,9,1590,0,47.6897,2320
265000.0,4,1.0,1290,0,6,1050,240,47.5223,1060
740000.0,5,3.0,3655,0,8,2174,1481,47.6434,2530
306000.0,4,2.5,2490,0,7,2490,0,47.3347,2760
381000.0,3,2.5,1470,0,7,1470,0,47.5328,1960
1220000.0,3,3.25,3960,3,10,2600,1360,47.6396,2730
1050000.0,3,3.5,3190,3,8,2630,560,47.458,2600
408000.0,2,1.0,810,0,6,810,0,47.7346,830
739900.0,5,2.5,2980,0,9,2980,0,47.7074,3150
674250.0,4,2.5,2780,0,9,2780,0,47.7386,2740
438400.0,2,1.0,1340,0,7,1340,0,47.7218,1700
1700000.0,5,5.0,4930,3,11,4160,770,47.5829,3030
703000.0,3,2.0,1360,0,8,1360,0,47.5852,1520
262000.0,3,1.75,1320,0,7,1320,0,47.2871,1620
353000.0,3,2.0,1210,0,7,1210,0,47.4705,1570
500000.0,4,2.5,1940,0,8,1940,0,47.685,2250
1280000.0,4,2.5,3160,4,9,2020,1140,47.5875,2790
332000.0,4,2.5,1980,0,8,1980,0,47.3809,2590
824000.0,4,2.5,2320,0,9,1620,700,47.6269,2810
290000.0,4,2.0,1660,0,7,1660,0,47.5878,1150
700000.0,3,2.5,1660,2,9,1400,260,47.6268,1820
550000.0,2,1.0,1080,0,7,780,300,47.6715,1380
549000.0,2,1.0,1510,0,7,1510,0,47.7212,2210
1865000.0,4,2.5,2950,2,9,2550,400,47.5988,3260
858000.0,4,2.25,3070,0,9,3070,0,47.6133,3010
345000.0,2,1.0,970,0,7,970,0,47.7252,1200
340000.0,4,1.75,2140,0,8,2140,0,47.196,2030
1215000.0,4,2.25,2570,0,9,2570,0,47.5791,2570
275000.0,3,2.25,1260,0,7,1260,0,47.7071,1190
405000.0,3,1.0,1220,0,7,1220,0,47.6326,1420
432500.0,3,2.0,1720,0,7,1720,0,47.7393,1400
236500.0,4,1.0,2140,0,6,1320,820,47.5484,1720
679000.0,4,1.5,1420,0,8,1420,0,47.6901,1470
543000.0,4,2.5,2060,0,8,2060,0,47.7168,2060
294000.0,3,1.0,1320,0,7,990,330,47.4857,1460
340500.0,3,1.75,1810,0,7,1810,0,47.4581,1620
1012000.0,4,2.5,2980,0,9,2980,0,47.5457,2730
335000.0,2,2.0,1350,0,8,1350,0,47.6344,1790
425000.0,3,2.0,1540,0,7,1540,0,47.7342,1630
353000.0,3,2.5,2510,0,8,2510,0,47.1896,2690
540000.0,3,2.5,1670,0,8,1670,0,47.5707,1940
640000.0,5,3.5,3690,0,9,2540,1150,47.6108,2640
339950.0,3,1.0,1320,0,8,1320,0,47.7738,1900
195000.0,3,1.75,1510,0,7,980,530,47.4476,1500
322000.0,3,1.75,1510,0,7,980,530,47.4476,1500
660000.0,4,1.75,1870,0,8,1620,250,47.5938,2060
280000.0,6,3.0,2400,0,7,2400,0,47.3262,2060
300000.0,6,3.0,2400,0,7,2400,0,47.3262,2060
207500.0,3,1.0,1170,0,6,1170,0,47.3059,1200
195000.0,3,1.5,1190,0,7,1190,0,47.4887,1390
700000.0,3,2.0,2080,0,7,1160,920,47.686,1330
560000.0,4,1.75,2150,2,7,1460,690,47.5344,1480
260000.0,3,1.75,1580,0,7,1580,0,47.5256,1580
575000.0,3,1.75,1580,0,7,1580,0,47.5256,1580
475000.0,3,2.5,2370,0,8,1950,420,47.7515,2520
285000.0,3,1.75,1840,0,7,920,920,47.5359,1390
753888.0,4,2.5,2660,2,9,2660,0,47.5439,3620
650000.0,3,2.5,2190,0,9,2190,0,47.5506,2300
620000.0,3,2.25,1660,0,7,1100,560,47.6773,1610
526000.0,3,1.75,1780,0,7,1300,480,47.5858,2380
155000.0,2,1.0,700,0,6,700,0,47.4924,1030
342000.0,4,2.0,1570,0,7,1120,450,47.7573,1570
390000.0,3,1.75,1220,0,7,1220,0,47.7224,1540
685000.0,3,2.75,3150,0,9,3000,150,47.553,3180
608000.0,4,2.5,2690,0,7,2690,0,47.6869,2690
179900.0,2,1.0,680,0,6,680,0,47.5136,1240
1245000.0,6,3.25,3750,2,9,2750,1000,47.6999,2140
166000.0,3,1.0,1010,0,7,1010,0,47.4849,1370
462000.0,3,1.5,1710,0,8,1410,300,47.5366,1860
545000.0,4,2.5,2090,0,8,2090,0,47.5713,2090
415000.0,3,1.0,1560,0,7,1560,0,47.6118,1660
269000.0,3,2.5,1560,0,7,1560,0,47.3838,1560
356500.0,4,2.5,2570,0,8,2570,0,47.2809,2430
225000.0,3,1.0,1010,0,6,1010,0,47.3781,1190
175000.0,2,1.0,1020,0,6,1020,0,47.301,1200
549000.0,5,2.5,1710,0,8,1710,0,47.5903,2270
535000.0,3,2.75,2300,0,8,2300,0,47.4369,1710
627000.0,4,2.25,1990,0,8,1210,780,47.5688,1720
565000.0,3,2.0,2730,3,9,2730,0,47.4612,2040
392450.0,4,2.0,2195,0,7,1060,1135,47.6965,1710
509000.0,2,2.0,1560,0,8,1560,0,47.7086,1870
340000.0,3,2.5,1400,0,7,1200,200,47.6865,1440
537000.0,3,2.5,1400,0,7,1200,200,47.6865,1440
865000.0,4,3.0,3690,0,10,3690,0,47.5937,3430
358000.0,2,1.0,1140,0,7,1140,0,47.7448,1030
595000.0,4,2.25,1920,0,7,1300,620,47.5848,1960
661000.0,4,2.5,2496,0,9,2496,0,47.6791,2496
419950.0,3,2.25,2280,0,7,1680,600,47.7211,1890
490000.0,4,3.5,3200,0,9,3200,0,47.3545,3200
525000.0,2,1.0,880,0,7,880,0,47.6847,1310
350000.0,3,2.0,1320,0,7,1320,0,47.6959,1380
552500.0,3,2.5,2450,0,9,2450,0,47.7749,2490
210000.0,3,1.0,1040,0,6,1040,0,47.3283,1040
390000.0,3,2.5,2480,0,9,2480,0,47.3323,2510
336800.0,5,1.75,1830,0,7,1610,220,47.7734,1790
465000.0,3,2.5,1440,0,7,1440,0,47.6825,1650
299900.0,4,2.5,1580,0,7,1580,0,47.3672,1950
715000.0,3,3.25,3230,0,9,3230,0,47.5558,2670
235000.0,4,2.5,1810,0,7,1230,580,47.3472,1810
276000.0,3,2.5,2495,0,8,2495,0,47.2877,2434
265000.0,4,1.5,1740,0,7,1180,560,47.2808,1830
425000.0,3,1.75,1680,2,6,840,840,47.686,1540
313000.0,4,2.5,2460,0,8,2460,0,47.2599,2210
715000.0,3,2.5,3050,3,8,1720,1330,47.7701,2340
265000.0,3,2.25,1630,0,7,1630,0,47.3305,1410
646000.0,3,2.75,2460,0,9,2460,0,47.7497,2440
175000.0,3,1.0,1030,0,7,1030,0,47.4941,1220
649000.0,3,2.5,3410,3,10,2450,960,47.3424,3410
785000.0,3,2.75,2310,0,7,1520,790,47.6357,2310
890000.0,4,2.75,2610,0,8,1260,1350,47.6158,1770
612000.0,3,3.0,2330,0,9,2330,0,47.7239,2200
330000.0,4,2.5,2980,0,8,2980,0,47.277,2610
493000.0,3,2.25,1790,0,8,1790,0,47.6297,2290
1600000.0,4,2.25,2940,0,9,1470,1470,47.6381,2230
1620000.0,4,3.0,3900,4,10,2520,1380,47.5605,3410
1650000.0,4,3.0,3900,4,10,2520,1380,47.5605,3410
499000.0,3,2.5,1750,0,7,1230,520,47.6037,1410
603500.0,6,2.75,2660,0,8,1550,1110,47.549,2280
530000.0,2,1.5,1580,2,8,1280,300,47.5762,1730
895000.0,5,2.5,2350,0,8,1220,1130,47.6005,2470
267345.0,4,2.25,2510,0,7,1610,900,47.3092,1940
275000.0,3,2.5,1480,0,8,1480,0,47.4723,1480
439950.0,3,1.75,1720,0,7,1240,480,47.7329,2530
455000.0,3,2.25,1470,0,7,1470,0,47.5667,1560
630000.0,3,1.75,1540,0,7,1250,290,47.6782,1760
690000.0,3,2.5,2820,0,9,2820,0,47.5533,2660
212000.0,4,1.75,1250,0,7,1250,0,47.302,1390
231500.0,4,2.25,2080,0,7,1280,800,47.3762,1200
1237500.0,4,3.25,5180,0,10,5180,0,47.6676,4240
378500.0,3,2.5,2860,0,9,2860,0,47.3163,2370
482000.0,4,2.5,2710,0,9,2710,0,47.375,2780
695000.0,2,1.0,1140,0,7,1140,0,47.6554,1800
965000.0,4,2.5,4070,0,10,4070,0,47.6908,3890
675000.0,3,1.75,1710,0,8,1120,590,47.6481,2920
387000.0,3,1.5,1340,0,7,1340,0,47.7168,1620
347500.0,4,2.75,2290,0,8,2290,0,47.4442,2000
385000.0,3,2.0,1860,0,8,930,930,47.4598,1640
265000.0,3,1.0,1080,0,6,1080,0,47.5209,1100
406000.0,3,1.0,960,0,7,960,0,47.6805,1140
134000.0,2,1.5,980,0,7,980,0,47.7076,1040
415000.0,3,1.0,1500,0,7,1300,200,47.6838,1360
375000.0,3,1.75,1440,0,7,1440,0,47.7231,1790
620000.0,4,2.5,2580,0,8,2580,0,47.6319,2350
337500.0,5,2.5,2070,0,7,2070,0,47.3539,2010
565000.0,3,2.5,1880,0,7,1260,620,47.5901,1950
399500.0,3,1.75,2420,0,7,2420,0,47.4943,1210
1065000.0,2,1.75,1890,0,8,1890,0,47.6144,2180
352500.0,3,2.0,1920,0,8,1920,0,47.4983,2080
259000.0,3,2.0,1870,0,7,1270,600,47.3665,1870
320000.0,2,1.0,900,0,7,900,0,47.5268,1520
733000.0,3,2.5,2160,0,9,2160,0,47.6712,3060
381500.0,2,1.0,900,0,7,900,0,47.6859,1320
343000.0,2,1.0,1180,0,7,940,240,47.5492,1700
205500.0,2,1.0,900,0,6,900,0,47.2113,1320
525000.0,3,2.0,1600,0,7,1600,0,47.5821,1850
300000.0,3,1.75,1500,2,6,750,750,47.4883,1500
299000.0,2,1.0,1070,0,6,1070,0,47.7199,1970
561000.0,4,2.5,2570,0,8,2570,0,47.5763,2260
450000.0,3,1.0,1210,0,7,1090,120,47.5934,1210
540000.0,4,2.5,1850,0,8,1850,0,47.6914,1830
379000.0,3,2.5,1740,0,8,1740,0,47.46,1740
230000.0,3,1.0,1300,0,7,1300,0,47.4213,1390
399950.0,3,2.5,2000,0,8,2000,0,47.3442,1930
355000.0,5,2.5,3220,0,8,3220,0,47.3714,2760
580000.0,4,2.25,2160,0,8,2160,0,47.5883,2820
700000.0,3,2.0,2130,0,7,1680,450,47.5779,2040
279900.0,3,1.75,1580,1,7,1100,480,47.3672,1650
210000.0,3,1.0,1200,0,6,1200,0,47.4921,1010
1165000.0,3,3.0,3790,0,10,2810,980,47.6035,2500
290300.0,2,1.0,860,0,6,860,0,47.4836,1400
1599950.0,5,4.5,5130,0,11,5130,0,47.544,4670
490000.0,3,1.0,1600,0,7,1400,200,47.7015,1760
606000.0,4,2.5,2110,0,9,2110,0,47.5497,2520
359950.0,3,1.0,1400,0,6,950,450,47.7041,990
677100.0,3,2.0,2110,0,10,2110,0,47.6496,3130
465000.0,3,2.0,1430,0,7,1430,0,47.6256,1570
4500000.0,5,5.5,6640,4,12,6350,290,47.7493,3030
500000.0,3,2.0,3040,0,8,1520,1520,47.3944,2230
455000.0,2,1.0,980,0,7,980,0,47.7518,1600
705000.0,6,2.0,2570,0,7,1970,600,47.6754,2030
420000.0,3,2.5,2060,0,8,1460,600,47.7575,2150
169575.0,3,1.0,1300,0,7,1300,0,47.3327,1360
250000.0,3,1.0,1300,0,7,1300,0,47.3327,1360
530000.0,3,2.25,1680,0,7,1180,500,47.713,1910
590000.0,5,3.25,4020,0,8,2170,1850,47.4952,2650
257500.0,3,1.75,1530,0,7,1070,460,47.3146,1770
415000.0,3,1.0,1170,0,8,1170,0,47.7122,2410
536000.0,3,1.75,1580,0,7,1280,300,47.672,1560
246500.0,3,1.5,1270,0,7,1270,0,47.4075,1380
395000.0,3,1.75,1480,0,8,1480,0,47.7225,1930
739000.0,3,2.25,2220,0,8,1700,520,47.6383,2500
1272000.0,4,2.75,3200,0,11,3200,0,47.6402,4050
190000.0,3,1.0,910,0,7,910,0,47.2741,1470
305000.0,3,1.5,1480,0,7,1480,0,47.4717,1540
925000.0,4,4.25,3770,0,8,3770,0,47.7517,2200
895000.0,4,3.0,3500,0,10,2360,1140,47.5468,3140
656000.0,3,1.75,1480,0,8,1480,0,47.6732,2120
560000.0,4,1.0,1660,0,7,1260,400,47.6829,1400
610000.0,5,2.25,2520,0,9,2520,0,47.6322,2530
645000.0,4,2.5,2850,0,9,2850,0,47.5852,2980
259000.0,3,2.5,2153,0,8,2153,0,47.2872,2434
980000.0,4,2.5,3780,0,10,3780,0,47.6533,3310
872000.0,4,4.0,3770,0,9,1940,1830,47.7159,2260
1000000.0,6,2.75,3600,2,9,1940,1660,47.5726,2990
900000.0,3,2.75,2980,0,8,1590,1390,47.674,1520
475000.0,4,1.5,2320,0,7,1540,780,47.6944,1670
350000.0,5,2.75,2980,0,8,1730,1250,47.3774,2900
840000.0,4,1.75,2930,3,9,1670,1260,47.6765,2530
500000.0,4,2.5,2040,0,8,1420,620,47.5512,2540
202500.0,3,1.5,1510,0,7,1110,400,47.4303,1420
523000.0,4,2.5,2660,0,8,2660,0,47.4969,2850
225000.0,3,2.5,1740,0,7,1740,0,47.2671,1300
418200.0,3,2.25,2240,1,7,1190,1050,47.3995,2080
356500.0,4,1.75,1570,0,7,1170,400,47.7432,2080
670000.0,4,3.0,2500,0,7,1460,1040,47.6895,1720
456150.0,3,2.25,1750,0,7,1150,600,47.7509,1820
471000.0,4,2.5,3030,0,8,2020,1010,47.485,2050
558000.0,3,2.5,1680,0,8,1680,0,47.5891,1740
1380000.0,6,4.5,5740,2,11,3610,2130,47.5533,4350
161500.0,3,1.0,1220,0,7,1220,0,47.2811,1420
311000.0,3,1.0,1310,0,7,1310,0,47.7284,1310
470000.0,6,1.75,2490,0,8,2490,0,47.7252,1840
569000.0,3,3.25,2220,0,8,1770,450,47.5665,1750
689000.0,4,2.5,2240,0,9,2240,0,47.5652,2200
271900.0,3,1.75,1890,0,7,1230,660,47.4472,1580
278000.0,4,2.5,1850,0,7,1850,0,47.359,1860
820000.0,2,2.5,2210,0,8,1440,770,47.6305,1560
399500.0,3,1.75,1410,0,7,1410,0,47.5375,1560
462000.0,3,2.75,1890,0,9,1890,0,47.6102,1800
347500.0,3,1.0,1830,0,7,1550,280,47.3126,1810
562100.0,2,0.75,1440,0,7,1200,240,47.6707,1440
230000.0,2,1.0,950,0,6,950,0,47.4499,1160
687000.0,4,2.5,2370,0,8,2370,0,47.6715,2370
725786.0,4,2.5,3070,0,10,3070,0,47.5847,3630
315500.0,3,1.0,1300,0,7,1300,0,47.7422,1480
312000.0,4,2.0,1300,0,7,1300,0,47.5071,1560
343000.0,3,3.25,1210,0,8,1000,210,47.7114,1650
385195.0,1,1.0,710,0,6,710,0,47.5756,1440
415000.0,4,2.25,2240,0,8,1730,510,47.4777,2150
461000.0,3,1.75,3600,0,6,2400,1200,47.6893,2290
369990.0,4,2.5,1960,0,7,1960,0,47.4941,1960
349950.0,4,2.5,1820,0,7,1820,0,47.7351,1820
285750.0,3,2.25,1960,0,8,1400,560,47.4436,2060
542500.0,4,2.25,1750,0,8,1320,430,47.5909,2170
830000.0,5,3.5,3700,0,9,2890,810,47.7085,3620
705000.0,4,2.5,2910,0,8,2350,560,47.7085,2020
615000.0,2,1.0,1270,0,8,1090,180,47.6828,1640
184500.0,2,1.0,720,0,6,720,0,47.5056,1440
412000.0,2,1.0,1040,0,7,1040,0,47.6048,1250
250000.0,3,1.5,2210,0,7,2210,0,47.492,1250
580000.0,5,2.0,2060,0,7,2060,0,47.6685,1770
220000.0,2,1.0,780,0,6,780,0,47.4759,1080
675000.0,4,2.75,2240,0,8,1460,780,47.6495,2360
373500.0,2,1.0,800,0,7,800,0,47.6566,1300
662700.0,2,1.5,2440,0,7,1590,850,47.5568,1770
239950.0,5,1.0,1460,0,6,1460,0,47.487,1060
383000.0,3,1.0,1150,0,7,1150,0,47.6788,1410
485000.0,3,2.75,2650,0,7,1470,1180,47.7669,1950
610000.0,4,2.75,2600,0,8,1580,1020,47.593,2300
545000.0,6,1.75,1820,0,7,1130,690,47.579,1820
780000.0,2,2.5,2560,0,8,1690,870,47.6233,1890
305000.0,3,2.5,1714,0,8,1714,0,47.4288,1714
405000.0,3,1.0,1330,0,7,900,430,47.6355,1330
1110000.0,5,3.5,7350,4,11,4750,2600,47.5373,5380
273000.0,3,1.75,2050,0,6,2050,0,47.4572,1200
326500.0,3,1.0,1810,0,7,1810,0,47.7427,1420
365000.0,3,1.75,1380,0,7,880,500,47.5087,1400
1000750.0,3,2.75,3070,0,10,2440,630,47.6444,3490
422500.0,2,1.0,800,0,7,800,0,47.6895,1400
354450.0,4,2.75,2140,0,8,2140,0,47.3529,2130
320000.0,3,1.0,1330,0,7,1330,0,47.758,1250
223000.0,3,1.0,1030,0,7,1030,0,47.3607,1470
410000.0,3,2.5,1740,0,7,1740,0,47.6966,1290
438000.0,3,1.0,1200,0,6,1200,0,47.5881,1390
390000.0,3,3.0,1490,0,7,960,530,47.6506,1590
298500.0,4,2.5,1890,0,7,1890,0,47.3293,2030
749999.0,5,2.25,3060,0,10,3060,0,47.5585,3430
779000.0,6,2.5,3250,1,8,1800,1450,47.6935,3490
570000.0,3,2.75,2730,2,8,1530,1200,47.6987,2810
385000.0,3,1.0,810,0,6,810,0,47.5712,1520
649000.0,4,2.0,2240,0,8,1120,1120,47.693,1790
283000.0,3,1.0,1740,0,7,1270,470,47.5049,1070
699900.0,4,2.25,2380,0,7,1540,840,47.6126,2230
278500.0,4,1.0,1540,0,7,770,770,47.4278,1520
700000.0,4,1.75,2340,0,8,1610,730,47.6401,2470
535000.0,4,2.75,2710,0,9,2710,0,47.4745,2710
234500.0,3,1.75,1310,0,7,870,440,47.5035,1840
374150.0,3,1.75,1390,0,7,1390,0,47.752,1240
397000.0,4,2.5,2201,0,8,2201,0,47.4002,1990
613000.0,3,2.25,1960,0,8,1960,0,47.5736,2800
1150000.0,3,2.5,2850,0,8,1730,1120,47.6218,2820
595000.0,4,1.75,1880,0,7,940,940,47.6754,1410
340000.0,5,2.75,2440,0,8,2440,0,47.3655,2300
388000.0,4,2.5,2560,0,9,2560,0,47.3474,3040
404000.0,3,1.75,1410,0,7,1410,0,47.4181,1970
810000.0,3,2.0,2870,1,8,1790,1080,47.6813,2310
405000.0,4,2.5,2620,0,9,2620,0,47.438,2580
726000.0,5,3.0,2970,0,9,2970,0,47.598,2970
266000.0,3,2.5,1780,0,7,1400,380,47.3667,1520
722500.0,5,2.25,3700,1,8,1850,1850,47.7736,2340
352000.0,4,2.5,1252,0,8,992,260,47.3216,1860
265000.0,4,1.5,1240,0,7,1110,130,47.3716,1520
856000.0,3,2.5,2160,0,9,2160,0,47.5762,1500
346950.0,3,2.5,2040,0,8,2040,0,47.3517,2380
866059.0,5,3.5,3130,0,9,2570,560,47.5664,3440
410000.0,3,2.5,2350,0,7,2350,0,47.5314,2350
370000.0,3,1.75,1570,0,7,1570,0,47.4716,1600
230000.0,3,1.0,1530,0,7,1530,0,47.1776,1768
400000.0,2,2.0,1520,0,7,1520,0,47.6948,1110
172000.0,3,1.0,1350,0,7,820,530,47.3274,1320
615000.0,3,1.75,1950,0,8,1250,700,47.5893,1740
860000.0,4,3.5,3950,0,10,3950,0,47.5945,3110
555000.0,3,1.75,2040,0,7,1120,920,47.5688,1530
579000.0,3,2.5,1990,0,8,1390,600,47.6867,1180
385000.0,3,1.75,1300,0,7,1300,0,47.721,1450
420000.0,4,2.25,2030,0,7,2030,0,47.7699,2190
645000.0,3,1.75,2340,0,7,1620,720,47.6956,1410
549950.0,3,2.5,2160,0,8,2160,0,47.7655,1830
678000.0,3,2.75,2770,1,8,1640,1130,47.7011,2450
199000.0,4,2.0,2030,0,7,2030,0,47.4994,1520
604000.0,3,1.0,1440,0,7,1440,0,47.5872,2540
268000.0,5,1.75,1730,0,7,1010,720,47.5008,1730
960000.0,5,3.5,4510,0,10,2820,1690,47.6346,4330
509250.0,3,2.5,2100,0,7,1450,650,47.6968,2010
416000.0,3,2.5,1800,0,8,1800,0,47.7188,1650
190000.0,3,1.0,1090,0,7,1090,0,47.3364,1190
212000.0,3,1.5,1010,0,7,1010,0,47.2881,2420
325900.0,3,2.5,2040,0,8,2040,0,47.309,2350
560000.0,3,3.5,2270,0,8,1880,390,47.5356,1760
275000.0,3,2.5,1730,0,7,1730,0,47.3499,1710
665000.0,4,2.5,2480,2,8,2480,0,47.5379,2940
1505000.0,4,3.5,3480,0,9,2580,900,47.5859,2380
375000.0,4,2.0,1720,0,7,970,750,47.5252,1160
359950.0,3,1.75,1570,0,7,1040,530,47.5137,1280
340000.0,4,2.75,3527,0,7,3527,0,47.3823,2490
401000.0,2,1.0,840,0,7,840,0,47.7019,1100
669000.0,2,1.75,1950,3,6,1160,790,47.4504,1780
638500.0,4,2.5,1980,0,8,1980,0,47.704,2310
545000.0,2,1.5,1620,0,7,1170,450,47.6012,2130
524000.0,4,1.0,1980,0,7,1260,720,47.7204,1570
1610000.0,5,3.75,3530,0,10,3530,0,47.5761,3340
280000.0,2,1.0,1260,0,6,1100,160,47.5196,1260
828000.0,4,2.5,2120,0,8,1500,620,47.556,3130
223000.0,3,1.75,1360,0,7,1360,0,47.2983,1580
1289000.0,4,3.5,3100,2,9,2250,850,47.6512,2660
750000.0,2,2.0,2370,0,7,2370,0,47.7388,1860
430000.0,2,1.0,1460,0,7,1210,250,47.7195,1500
711000.0,4,1.75,1980,0,6,990,990,47.5768,2180
310000.0,4,2.5,1930,0,8,1930,0,47.3921,1990
415000.0,5,1.75,3700,0,8,1850,1850,47.5086,2190
274900.0,4,2.5,1970,0,7,1970,0,47.3491,1970
525000.0,3,3.0,2470,0,8,2470,0,47.4661,2310
179500.0,3,1.0,1180,0,7,1180,0,47.3313,2300
478000.0,3,1.0,1280,0,8,1280,0,47.6727,1410
195000.0,3,1.75,1380,0,7,990,390,47.369,1660
385000.0,4,3.0,2740,0,8,1670,1070,47.4538,2330
401000.0,3,2.75,2020,0,7,1260,760,47.7399,2080
522000.0,4,2.5,2835,0,8,2835,0,47.3878,2770
330000.0,4,1.75,1520,0,7,1520,0,47.526,1600
503000.0,3,2.5,2190,0,9,2190,0,47.7641,2190
175000.0,5,1.75,1680,0,7,1680,0,47.3035,1800
963990.0,4,3.5,3915,0,9,3915,0,47.6844,3830
845000.0,5,2.0,1720,0,8,1720,0,47.6368,2700
157500.0,2,1.0,670,0,5,670,0,47.5271,1210
450000.0,2,3.0,1790,0,7,1400,390,47.5926,1460
925000.0,4,1.75,2440,4,8,1420,1020,47.6807,2500
600000.0,2,1.0,920,0,7,920,0,47.6726,1230
709000.0,4,1.0,1680,0,7,1680,0,47.6667,1740
1385000.0,5,3.75,3290,0,10,2190,1100,47.653,2010
248000.0,3,2.5,2120,0,7,1220,900,47.278,1820
245000.0,3,1.0,910,0,6,910,0,47.6947,950
332000.0,2,1.0,1000,0,6,1000,0,47.5619,1500
459950.0,3,2.5,2340,0,7,2340,0,47.5362,2400
425000.0,3,2.0,1180,2,8,1180,0,47.6168,1500
460000.0,3,2.25,2080,0,8,1590,490,47.7506,2270
838300.0,6,2.5,3760,0,9,2360,1400,47.6976,2300
256000.0,3,2.5,1480,0,7,1480,0,47.3126,1350
864000.0,3,2.75,3060,0,10,3060,0,47.5609,3060
900000.0,4,3.5,3070,0,9,2030,1040,47.5732,1780
145600.0,3,1.0,1170,0,6,1170,0,47.4514,1170
865000.0,5,3.0,2900,0,8,1830,1070,47.6784,2370
250250.0,3,2.25,2210,0,8,2210,0,47.3085,1990
162000.0,4,2.0,1440,0,5,1440,0,47.508,1440
450000.0,4,1.75,1980,0,7,1430,550,47.7088,1870
675500.0,4,2.75,2060,0,8,1460,600,47.5934,2060
697000.0,3,2.25,2420,0,7,1640,780,47.6765,1560
1324050.0,3,3.25,3440,0,9,2560,880,47.6644,3110
490000.0,3,1.75,1600,0,8,1600,0,47.6601,1510
590000.0,3,2.25,2210,0,8,1460,750,47.6891,1900
280000.0,4,1.75,2250,0,8,1450,800,47.3303,1930
515000.0,2,1.0,1680,0,7,1140,540,47.55,1610
576000.0,3,1.0,1140,0,7,1010,130,47.6782,1700
375000.0,3,1.75,1430,0,7,1430,0,47.7668,1900
478000.0,3,1.0,1440,0,7,1000,440,47.6968,1540
282000.0,3,1.0,1670,0,7,1030,640,47.3659,1620
1400000.0,4,4.5,3080,3,8,1940,1140,47.5806,2780
593500.0,5,3.25,4300,0,8,3220,1080,47.4615,2680
724950.0,4,3.5,3010,0,9,3010,0,47.4775,2720
306000.0,3,1.75,1560,0,8,1560,0,47.489,1600
341000.0,4,1.75,1920,0,8,1500,420,47.4476,2100
399950.0,3,2.5,1400,0,7,1400,0,47.553,1060
534000.0,5,2.0,2280,0,7,2280,0,47.6056,1740
635000.0,6,2.5,3880,0,7,3880,0,47.6816,2620
350000.0,2,1.0,1350,0,6,950,400,47.6842,1670
856000.0,3,1.5,1480,0,7,1480,0,47.623,1970
582000.0,4,3.0,1670,0,8,1427,243,47.6182,1700
799000.0,4,2.5,3400,0,9,3400,0,47.7067,2970
423700.0,3,2.5,2070,0,8,2070,0,47.5348,2090
1835000.0,4,3.5,4870,0,12,4870,0,47.5447,5000
322000.0,3,2.0,1760,0,7,1160,600,47.3565,1760
929000.0,4,3.25,4030,0,9,4030,0,47.6617,3470
443000.0,2,1.0,1130,0,7,880,250,47.6971,1250
441500.0,3,1.75,1510,0,7,1510,0,47.7283,1440
875000.0,4,3.5,3110,2,8,3110,0,47.592,2340
3600000.0,3,3.25,5020,4,10,3420,1600,47.5925,3680
450000.0,2,1.0,740,0,7,740,0,47.6787,920
425000.0,3,2.25,1630,0,7,1100,530,47.7176,1640
660000.0,4,1.75,2780,0,10,2780,0,47.6348,2600
763101.0,3,1.75,1990,0,7,1100,890,47.664,1460
499000.0,4,2.75,2250,0,9,2250,0,47.7353,2450
521000.0,3,1.75,1720,0,8,1350,370,47.6608,2740
302000.0,2,1.0,900,2,6,900,0,47.228,1810
293000.0,4,2.25,2360,0,7,2360,0,47.3882,2144
335000.0,3,2.25,1530,0,7,1530,0,47.7342,2110
499000.0,2,1.0,1450,0,7,1450,0,47.6853,1450
600000.0,3,1.75,2040,0,7,1780,260,47.6756,1690
720000.0,4,1.75,2620,0,9,2620,0,47.5975,2230
195000.0,2,2.0,1180,0,6,1180,0,47.3501,1310
249000.0,3,1.0,1110,0,7,1110,0,47.4718,1140
334000.0,3,2.25,1840,0,7,1840,0,47.7347,1490
599950.0,4,1.75,2720,0,8,1510,1210,47.6788,2120
149900.0,2,1.75,1090,0,8,1090,0,47.3782,1360
700000.0,4,1.75,1730,0,7,1250,480,47.6982,1910
525000.0,4,1.5,1170,0,6,1170,0,47.5495,2380
1049000.0,4,3.75,4740,0,10,4740,0,47.4449,3060
402000.0,3,2.5,1960,0,7,1290,670,47.7249,1960
450000.0,3,2.0,1430,0,7,980,450,47.6874,1450
520000.0,3,2.25,2510,0,8,2510,0,47.4545,2470
205000.0,3,1.75,1420,0,7,820,600,47.2873,1470
635000.0,3,2.25,2680,0,9,2680,0,47.4487,3170
210500.0,3,1.0,1220,0,7,1220,0,47.2622,1310
406650.0,2,1.0,1070,0,6,1070,0,47.5698,1770
350000.0,3,1.75,1580,0,7,1580,0,47.3299,1860
425000.0,4,1.75,1820,0,7,930,890,47.6872,1590
798000.0,3,3.5,3590,0,10,3590,0,47.6336,3230
180000.0,3,1.0,1960,0,5,1960,0,47.505,1850
1250000.0,5,3.25,3160,0,8,3160,0,47.5373,2360
435000.0,4,2.0,2030,0,7,1630,400,47.7056,1350
355000.0,3,1.5,1240,0,7,1240,0,47.7167,1570
3000000.0,5,3.25,5370,0,10,3850,1520,47.6499,2410
685000.0,5,2.5,2670,0,9,2670,0,47.7565,1810
311000.0,3,1.0,1640,0,7,1640,0,47.4941,1680
305000.0,4,2.25,2130,0,7,2130,0,47.4119,1710
675000.0,3,2.5,2550,0,7,1850,700,47.5758,1700
769000.0,4,2.75,3630,2,8,1850,1780,47.566,3380
430000.0,3,1.5,1690,0,7,1690,0,47.5732,1570
516250.0,6,2.0,2390,0,7,2390,0,47.7589,2250
760000.0,3,3.5,2350,2,7,1340,1010,47.7288,2580
579950.0,3,3.5,1420,0,8,1180,240,47.6827,1494
476000.0,3,2.25,1570,0,8,1170,400,47.7604,1660
510000.0,3,1.75,1600,0,7,1600,0,47.7202,2010
205000.0,2,1.0,720,0,6,720,0,47.5267,1357
240000.0,3,1.0,1470,0,7,1470,0,47.3616,1720
738000.0,5,3.5,2790,2,10,1970,820,47.4384,2980
420000.0,3,1.75,1720,0,6,860,860,47.7336,1440
455000.0,3,1.75,1300,0,7,1300,0,47.6388,2070
765000.0,4,1.0,2520,0,8,1820,700,47.5785,2350
372000.0,4,1.5,1780,0,7,1780,0,47.5142,1350
160000.0,3,1.0,1200,0,6,1200,0,47.5414,1570
772000.0,4,2.5,2990,0,9,2990,0,47.6292,2990
1125000.0,5,1.75,1910,0,9,1910,0,47.6249,2050
479000.0,3,1.0,1370,0,7,1370,0,47.6619,1510
570000.0,3,2.5,1910,0,8,1910,0,47.5989,1910
350000.0,4,1.0,1170,0,6,1170,0,47.7281,1260
353000.0,3,2.5,1250,0,8,1250,0,47.6978,1330
699000.0,5,2.5,3340,0,10,3340,0,47.4565,3420
265000.0,3,2.0,1380,0,7,1380,0,47.4374,1260
167000.0,1,1.0,780,0,6,780,0,47.713,930
500000.0,4,2.25,2080,0,8,1390,690,47.6264,1800
700000.0,3,1.0,1410,0,6,1410,0,47.5924,1640
295000.0,1,1.0,520,0,6,520,0,47.5579,1030
1010000.0,4,3.5,3500,2,9,2590,910,47.6834,2430
209000.0,2,1.0,840,0,6,840,0,47.3644,920
276000.0,3,1.75,2240,0,7,1440,800,47.2635,1740
380000.0,4,2.5,2100,0,8,2100,0,47.4956,2090
315000.0,3,1.5,1750,0,7,1150,600,47.5666,1680
685530.0,4,2.5,3130,0,9,3130,0,47.6618,2780
254600.0,3,2.0,1470,0,7,1470,0,47.2973,1390
230000.0,3,2.0,1440,0,6,720,720,47.4947,1120
335000.0,3,3.0,1430,0,8,1430,0,47.6971,1020
550000.0,4,2.5,2170,0,7,1460,710,47.6789,1940
123300.0,3,1.0,1150,0,7,1150,0,47.374,1360
275436.0,4,2.75,2170,0,7,2170,0,47.3741,1490
325000.0,4,3.5,2630,3,7,1640,990,47.4355,1920
635000.0,4,2.5,2490,0,9,2490,0,47.6507,3170
513000.0,3,1.75,1710,0,7,1110,600,47.6689,920
580000.0,4,2.5,2130,0,8,1490,640,47.5748,3030
225000.0,3,1.0,940,0,7,940,0,47.4353,1270
265000.0,3,1.0,1400,0,7,1060,340,47.5119,1570
313000.0,4,1.75,1630,0,7,930,700,47.5961,1630
296000.0,2,1.0,1370,0,7,1370,0,47.7344,1330
655500.0,4,2.75,2380,0,8,1680,700,47.5929,1950
250750.0,5,1.75,2140,0,8,2140,0,47.3167,1640
438000.0,4,2.5,1970,0,8,1970,0,47.4893,2590
590000.0,3,2.75,2550,0,8,1980,570,47.7596,2180
329500.0,3,1.0,1080,0,7,1080,0,47.7309,1100
1195000.0,3,2.25,3070,0,10,2110,960,47.5522,3130
415000.0,2,1.0,1470,0,6,900,570,47.6527,1670
900000.0,4,2.5,3620,0,10,3620,0,47.7204,2950
378000.0,3,1.5,1050,0,7,1050,0,47.5602,1460
474000.0,2,1.0,1050,3,6,1050,0,47.2221,1760
464000.0,3,1.0,1320,0,7,1320,0,47.6049,1660
310000.0,3,1.0,1210,0,7,1210,0,47.7693,1210
580000.0,3,1.5,1860,1,7,1860,0,47.7716,1670
999000.0,3,2.75,2830,3,8,1830,1000,47.3782,2120
510000.0,2,1.0,810,0,6,810,0,47.6493,1920
650000.0,3,1.5,1630,1,7,1160,470,47.6725,2320
196000.0,3,1.0,880,0,7,880,0,47.2707,880
220000.0,4,1.75,1660,0,6,1010,650,47.4943,1670
855000.0,3,2.25,3440,2,10,3440,0,47.5647,3170
483000.0,3,1.75,2110,0,8,1440,670,47.7344,1990
400000.0,3,1.0,1060,0,7,1060,0,47.7703,1550
435000.0,3,2.5,1900,0,8,1900,0,47.7433,2650
219500.0,1,1.0,820,0,8,760,60,47.5473,1770
2950000.0,4,3.5,4860,0,12,4860,0,47.6172,3580
427000.0,3,2.5,2050,0,7,2050,0,47.7612,2050
430000.0,2,1.5,1090,0,7,1090,0,47.6652,1390
685000.0,2,1.5,1090,0,7,1090,0,47.6652,1390
495000.0,2,1.5,1920,0,7,1060,860,47.6497,2070
299950.0,3,2.5,1870,0,7,1870,0,47.342,1870
390000.0,4,1.75,2690,0,7,2690,0,47.4951,1920
385000.0,3,1.75,2160,0,7,1260,900,47.5729,1590
740000.0,4,2.5,3000,0,9,3000,0,47.535,3140
991700.0,4,3.0,2290,1,9,1610,680,47.574,1610
765000.0,3,2.75,2250,0,9,1830,420,47.6033,2060
802000.0,4,2.25,2130,2,8,2130,0,47.5672,2550
950000.0,4,2.75,2500,0,8,1700,800,47.5901,2650
392000.0,4,2.5,2300,0,7,2300,0,47.3412,2300
590000.0,3,2.5,3360,0,8,3360,0,47.6601,2650
425000.0,4,2.5,1920,0,7,1920,0,47.5153,1530
765000.0,5,1.75,2440,4,8,1740,700,47.4948,2390
313500.0,3,2.25,1440,0,7,1440,0,47.7257,1390
320000.0,3,1.0,1780,0,6,1780,0,47.727,1410
604000.0,4,1.75,1490,0,8,1350,140,47.6388,1380
570000.0,3,2.0,1400,0,8,1060,340,47.6196,1540
639000.0,4,2.5,2150,0,8,2150,0,47.7224,1800
335000.0,4,2.0,1910,0,7,1910,0,47.4804,1820
896000.0,4,1.75,2660,0,8,2080,580,47.6743,2100
259500.0,3,1.75,1650,0,7,1650,0,47.442,1470
637000.0,3,2.0,1980,0,7,1380,600,47.6921,1260
307450.0,4,2.75,2690,0,8,1370,1320,47.3078,1990
535000.0,3,1.75,1380,0,7,860,520,47.6822,1820
669500.0,4,2.25,2500,0,7,1520,980,47.6882,1410
259000.0,3,1.75,1590,0,7,1590,0,47.4713,1150
441000.0,4,1.5,1100,0,7,1100,0,47.6033,2020
228800.0,4,2.5,1470,0,7,980,490,47.5275,1460
530000.0,2,2.0,1680,0,8,1680,0,47.7194,1570
524000.0,2,2.0,1450,0,6,750,700,47.633,2170
430000.0,4,2.25,2020,0,8,1200,820,47.5576,1410
1325000.0,4,3.25,2470,0,9,1890,580,47.6331,2470
210000.0,3,1.0,1230,0,7,1230,0,47.3285,1230
449000.0,4,2.5,1850,0,7,1230,620,47.5386,1010
945000.0,2,2.5,2540,0,9,2540,0,47.5747,1330
200450.0,3,1.0,970,0,6,970,0,47.4369,1000
219950.0,3,1.5,1070,0,6,1070,0,47.3115,1030
659500.0,4,3.0,2620,0,8,1870,750,47.5646,2630
746000.0,4,2.75,2110,0,8,2110,0,47.6269,2420
540000.0,3,1.75,2110,0,8,1280,830,47.7219,1810
485000.0,5,2.0,1910,0,7,1020,890,47.7074,1030
202000.0,2,1.0,670,0,6,670,0,47.5165,740
2525000.0,4,5.5,6930,0,11,4310,2620,47.5547,2560
502000.0,3,2.75,2010,0,8,1360,650,47.7728,2200
279000.0,2,2.75,1770,0,8,1210,560,47.2773,1600
409500.0,3,1.0,1340,0,7,1040,300,47.6916,1270
453000.0,3,2.0,1660,0,7,1260,400,47.7203,1660
367000.0,4,1.0,1820,0,6,1820,0,47.5185,1140
550000.0,3,2.5,2510,0,9,2510,0,47.5204,1840
273500.0,3,1.5,1560,0,7,1560,0,47.4117,1820
505000.0,4,3.0,2280,0,7,1340,940,47.711,1540
770000.0,3,2.5,2650,0,9,2650,0,47.668,2550
565000.0,4,2.25,2470,0,8,2470,0,47.7514,2270
316000.0,3,0.75,1270,0,7,1270,0,47.7567,1300
160000.0,4,1.0,1520,0,7,1520,0,47.3706,1520
170000.0,3,1.0,1310,0,7,1310,0,47.4105,1330
235000.0,3,1.0,1310,0,7,1310,0,47.4105,1330
1799000.0,4,3.5,3930,0,12,3930,0,47.6399,4250
310000.0,3,1.0,990,0,7,990,0,47.7274,1200
285000.0,4,1.75,2080,0,7,1040,1040,47.4866,1780
280000.0,2,1.0,960,0,6,960,0,47.6946,1010
2298000.0,4,4.25,4070,3,10,4070,0,47.59,3430
763776.0,4,2.5,2750,0,9,2750,0,47.5843,2810
530000.0,5,2.75,3230,2,8,1880,1350,47.4393,2910
362000.0,1,1.0,890,0,7,890,0,47.7216,1670
430000.0,2,1.0,990,0,6,990,0,47.6939,990
456500.0,3,1.0,1290,0,7,1290,0,47.6879,1290
445000.0,4,2.5,2170,0,7,2170,0,47.6999,1430
386900.0,3,1.0,1330,0,7,960,370,47.7204,1460
479000.0,3,1.0,1340,0,7,1340,0,47.5771,1430
525000.0,3,2.5,2200,0,8,2200,0,47.5319,2400
272000.0,4,1.75,2520,0,7,1260,1260,47.3224,2090
517000.0,4,1.0,1180,0,7,1180,0,47.7165,1580
615000.0,3,1.75,2660,0,8,1330,1330,47.6993,1950
439000.0,3,1.75,1250,0,7,1250,0,47.6285,1460
716000.0,3,2.5,2270,0,10,2270,0,47.5622,2580
308000.0,2,1.0,1080,2,7,1080,0,47.5128,2100
800000.0,3,2.25,1620,0,8,1620,0,47.643,1210
575000.0,3,2.0,940,0,7,880,60,47.6771,1420
219950.0,3,1.5,1620,0,7,1620,0,47.3665,1610
770000.0,4,2.5,2350,0,8,2350,0,47.5478,2460
424950.0,3,1.75,2090,0,7,2090,0,47.7326,1510
387000.0,3,2.25,1760,0,7,1760,0,47.5124,1910
790000.0,4,1.75,2050,3,8,1450,600,47.7431,2440
156000.0,2,1.0,600,0,5,600,0,47.5065,1290
580000.0,2,1.0,2540,0,8,1320,1220,47.5259,2160
490000.0,4,2.25,2090,0,8,2090,0,47.6715,1800
950000.0,5,3.25,2700,2,9,2070,630,47.5959,1940
400000.0,2,2.5,1410,0,8,1090,320,47.5659,1410
325000.0,2,2.5,1170,0,8,1170,0,47.7041,1350
365000.0,4,2.5,2540,0,9,2540,0,47.3314,2810
255000.0,3,1.75,2190,0,7,2190,0,47.3063,1610
985000.0,5,3.5,3890,1,9,2870,1020,47.7246,3080
595000.0,4,2.5,2030,0,7,1100,930,47.6955,1610
427500.0,3,1.0,1350,0,7,1350,0,47.7318,1350
728000.0,3,1.5,1940,0,8,1310,630,47.6205,1940
549950.0,2,1.0,1260,0,7,1000,260,47.6898,1780
650000.0,3,2.0,2800,0,7,1400,1400,47.7055,2260
1125000.0,5,3.25,3080,2,9,2230,850,47.6651,2810
203000.0,3,1.0,840,0,6,840,0,47.3637,920
311000.0,2,1.0,860,0,6,860,0,47.5496,1380
387500.0,6,2.0,2400,0,6,1200,1200,47.7705,1290
370000.0,4,2.0,1640,0,7,1640,0,47.7471,1500
228000.0,2,1.0,1060,0,6,1060,0,47.7317,1550
740000.0,2,1.75,2080,0,7,1080,1000,47.6896,1310
200000.0,4,2.0,2090,0,7,1070,1020,47.5077,1550
660000.0,3,1.0,1240,0,7,1240,0,47.6835,1650
275000.0,4,2.0,2030,0,7,2030,0,47.4806,1190
708000.0,2,1.0,1120,0,7,950,170,47.6496,1510
280000.0,3,2.5,1270,0,8,1270,0,47.4639,1270
325000.0,4,2.5,2260,0,8,2260,0,47.3488,2450
495000.0,3,2.5,1780,0,7,1780,0,47.4723,1890
691000.0,2,2.0,1780,0,7,980,800,47.6474,1690
2288000.0,4,2.5,4080,2,11,4080,0,47.6344,4080
329500.0,3,2.5,2120,0,7,1360,760,47.341,2330
348000.0,3,2.5,2060,0,9,2060,0,47.3045,2480
425000.0,2,1.0,1670,0,7,1670,0,47.7152,1670
210000.0,3,1.0,1080,0,6,1080,0,47.5515,1380
285000.0,2,1.0,1210,0,6,710,500,47.5202,1100
222000.0,3,1.0,990,0,6,990,0,47.3074,1120
200000.0,4,2.5,1720,0,7,1120,600,47.2917,1520
247500.0,3,2.0,1530,0,7,1530,0,47.2974,1750
1500000.0,4,5.5,6550,0,11,5400,1150,47.4302,4110
190000.0,3,1.75,1100,0,6,1100,0,47.4864,1350
975000.0,4,2.5,3020,0,9,2020,1000,47.6467,2300
1130000.0,4,3.0,3180,0,9,2070,1110,47.6583,2720
283200.0,4,1.75,1830,0,8,1130,700,47.3348,2020
650000.0,3,2.5,2540,0,8,1880,660,47.7176,2110
449500.0,3,2.0,1770,0,7,960,810,47.7703,2010
400000.0,3,1.75,1470,0,7,1470,0,47.7315,1790
89950.0,1,1.0,570,0,5,570,0,47.5098,890
158800.0,3,1.0,960,0,6,960,0,47.5006,1110
870000.0,4,3.0,2940,1,9,2220,720,47.5437,2240
196000.0,3,1.5,1000,0,6,1000,0,47.2976,1610
850000.0,3,1.75,2450,0,8,1340,1110,47.6536,2280
775000.0,4,2.5,3310,0,9,3310,0,47.6649,3010
483500.0,3,2.5,1670,0,8,1670,0,47.5307,1670
387000.0,3,1.5,1620,0,7,1620,0,47.767,1600
900000.0,3,3.0,2990,0,10,2990,0,47.7602,1750
336000.0,3,1.5,1240,2,7,1240,0,47.5659,1050
415000.0,2,1.0,670,0,6,670,0,47.561,1240
380000.0,0,0.0,1470,2,8,1470,0,47.7145,1470
350000.0,3,1.5,1320,0,6,1320,0,47.6231,1350
1320000.0,4,5.25,6110,0,11,6110,0,47.5285,4190
765000.0,3,1.75,2440,3,8,1320,1120,47.6474,2530
527000.0,4,2.5,2900,0,8,2900,0,47.4954,2900
524000.0,4,2.75,2310,0,8,1480,830,47.5502,1100
448000.0,2,1.0,1110,0,6,890,220,47.6925,1300
775000.0,4,3.25,4100,0,9,2500,1600,47.7302,3770
176500.0,3,1.0,930,0,5,930,0,47.3745,930
750000.0,4,2.25,2420,2,8,1620,800,47.4954,2210
1265000.0,4,2.25,2870,0,8,1730,1140,47.6362,2370
250000.0,3,1.0,1480,0,7,1480,0,47.505,1480
759000.0,3,2.75,1960,2,8,1960,0,47.6032,2440
640000.0,3,2.0,1470,0,7,1470,0,47.6398,1700
990000.0,3,3.25,2460,0,8,2100,360,47.6782,2370
395000.0,4,1.75,1960,0,7,980,980,47.7326,1290
275000.0,2,1.5,1160,0,7,890,270,47.7677,1160
390000.0,3,2.5,1910,0,8,1910,0,47.4956,2460
752500.0,5,2.75,2720,0,8,1710,1010,47.6612,1670
450000.0,2,1.0,1020,0,6,1020,0,47.6725,1490
473000.0,2,1.0,900,0,7,900,0,47.6804,1400
178500.0,3,1.75,1120,0,7,1120,0,47.4418,1250
485000.0,3,2.5,2340,0,8,2340,0,47.4052,2700
215000.0,3,1.5,1410,0,7,780,630,47.2914,1440
589000.0,4,1.75,1920,0,7,1060,860,47.5747,1840
325000.0,4,1.75,1370,0,6,1370,0,47.7572,1650
580000.0,3,2.5,1590,0,8,1590,0,47.5903,1620
181100.0,4,1.75,1850,0,7,1850,0,47.4217,1460
345000.0,3,2.0,1430,0,7,830,600,47.6462,1540
781000.0,3,1.75,1940,0,8,1460,480,47.7027,2250
402500.0,4,1.0,1270,0,7,1270,0,47.6135,1420
426000.0,3,1.5,1380,0,7,1080,300,47.5292,1220
389000.0,3,2.5,1720,0,7,1720,0,47.5426,2220
670000.0,6,3.0,4050,0,8,2620,1430,47.4708,3660
1506000.0,4,3.25,3660,0,10,3360,300,47.6283,3240
288400.0,3,2.25,1870,0,7,1870,0,47.4915,1620
700000.0,4,2.0,2230,0,7,1510,720,47.682,1520
830000.0,4,3.0,2020,0,8,1220,800,47.6563,1400
1899000.0,2,2.75,3690,4,12,3690,0,47.4485,2310
350500.0,2,1.0,1450,0,7,1450,0,47.6924,1240
431000.0,3,1.75,1630,0,7,1630,0,47.4521,1600
485000.0,3,2.5,1840,1,8,1340,500,47.7767,1970
780000.0,3,1.5,1620,2,8,1620,0,47.7014,2440
720000.0,2,1.5,1840,2,8,1340,500,47.5281,1880
415000.0,3,1.0,1360,0,7,1360,0,47.7528,2040
480000.0,4,1.0,2080,0,7,1040,1040,47.6838,1280
452250.0,4,2.25,2550,0,7,1560,990,47.77,2440
316000.0,3,2.5,2550,0,8,2550,0,47.311,1840
700000.0,2,1.0,1160,4,6,1160,0,47.5117,1510
285000.0,4,2.0,1760,1,7,780,980,47.5183,1510
575000.0,3,1.75,1720,0,7,860,860,47.6782,1720
590000.0,3,2.25,2300,2,8,1580,720,47.435,2500
587500.0,4,1.75,2500,2,8,1600,900,47.431,2170
364000.0,4,2.25,1750,0,8,1750,0,47.7612,1750
490000.0,3,2.5,1890,0,8,1890,0,47.6478,2080
410000.0,3,2.25,1800,0,8,1360,440,47.4688,2730
520000.0,3,2.5,2160,0,9,2160,0,47.5476,2160
389000.0,3,1.0,1380,0,7,1380,0,47.7164,1610
450000.0,2,1.0,1180,0,7,1180,0,47.6531,1600
325000.0,3,2.5,2550,0,7,2550,0,47.3986,2550
660000.0,2,1.0,1070,0,7,1070,0,47.6631,1400
850000.0,3,2.25,2870,0,10,2250,620,47.5363,1310
285000.0,3,2.5,1940,0,7,1940,0,47.3794,1860
395000.0,2,1.0,870,0,7,870,0,47.6659,1570
440000.0,3,2.0,1550,0,7,1550,0,47.6545,1550
249000.0,3,1.75,1400,0,6,1400,0,47.5133,2320
635000.0,3,1.75,1210,0,8,1210,0,47.6621,2020
515000.0,3,2.5,3430,0,9,3430,0,47.2609,2460
1400000.0,3,3.25,3020,0,9,3020,0,47.6332,3020
200000.0,2,1.0,950,0,6,950,0,47.4572,1620
1135000.0,4,2.75,3370,3,9,1970,1400,47.5232,2120
445000.0,4,1.0,1460,2,6,780,680,47.566,1560
555000.0,3,1.5,1740,0,7,1640,100,47.6782,1660
537000.0,4,2.0,1720,0,7,860,860,47.5734,1280
315000.0,3,1.75,1480,0,7,1480,0,47.4629,1480
805000.0,5,2.5,3320,0,9,3320,0,47.5862,3060
414000.0,4,2.5,3490,0,8,3490,0,47.3198,2540
375000.0,2,1.5,1160,0,7,1160,0,47.5916,1458
401000.0,4,1.75,3010,0,8,1780,1230,47.707,2040
210000.0,3,1.0,1030,0,7,1030,0,47.4231,1730
365000.0,2,1.0,980,0,7,780,200,47.7002,1430
178000.0,5,1.5,1990,0,7,1990,0,47.4938,1860
710000.0,2,1.0,1790,0,7,1040,750,47.6405,1310
255000.0,2,1.0,810,0,6,810,0,47.489,1440
528000.0,5,2.25,2940,0,8,1700,1240,47.7653,2620
537000.0,4,4.25,4883,3,10,3859,1024,47.263,3736
442000.0,4,1.5,1360,0,7,1010,350,47.5755,1520
375000.0,3,1.75,1370,0,7,1370,0,47.7002,1430
637250.0,4,2.5,2120,0,9,2120,0,47.6662,2120
427500.0,3,1.75,1240,0,7,1240,0,47.5142,1640
700000.0,4,2.5,2770,0,8,2770,0,47.6624,2650
680000.0,3,1.75,1660,0,7,1080,580,47.5843,2060
393820.0,2,2.0,1170,0,7,1170,0,47.6873,1360
525000.0,4,2.75,2470,0,7,1350,1120,47.5631,1500
505000.0,2,1.75,1310,0,7,1110,200,47.679,1510
555565.0,3,2.0,1670,1,7,1670,0,47.6602,2210
650000.0,3,1.75,1660,0,7,1240,420,47.7045,3110
632500.0,5,3.25,3500,0,8,2760,740,47.5444,2820
269000.0,3,2.5,1440,0,7,1440,0,47.3606,1890
405000.0,4,2.75,2360,0,7,1390,970,47.7301,2160
845000.0,3,3.5,3460,0,10,3460,0,47.7262,3350
234000.0,3,1.0,1750,0,7,1750,0,47.3608,1400
638000.0,4,1.75,1470,0,7,1470,0,47.6692,1480
290000.0,3,1.75,1710,0,7,1060,650,47.4678,1180
262000.0,1,0.75,520,0,3,520,0,47.2082,1340
270000.0,4,2.5,2350,0,8,2350,0,47.3494,3010
875000.0,4,2.25,2380,0,9,2240,140,47.6822,1780
299000.0,3,2.25,1920,0,8,1920,0,47.3631,2170
551000.0,3,1.0,1580,0,7,1580,0,47.5286,1580
350000.0,3,2.75,3070,1,7,2360,710,47.4486,2570
1901000.0,3,2.5,2660,2,10,2660,0,47.6501,2660
511718.0,2,1.75,1700,0,6,850,850,47.6787,1690
965000.0,4,3.25,5010,0,9,3710,1300,47.5489,3140
475000.0,4,2.25,2680,0,7,2680,0,47.7539,2460
1062000.0,4,2.75,2720,2,8,1840,880,47.6797,1600
252000.0,2,1.0,940,0,6,940,0,47.4408,1370
580000.0,6,2.5,3596,0,8,1798,1798,47.4388,1894
374950.0,2,2.25,1240,0,8,1000,240,47.5877,1260
739000.0,5,4.0,4660,2,9,2600,2060,47.5135,3380
271000.0,4,1.75,1710,0,7,910,800,47.3967,1730
230000.0,2,1.0,930,0,6,930,0,47.4866,1370
210000.0,3,2.25,1430,0,7,1070,360,47.3239,1430
350000.0,3,2.75,1650,0,7,1650,0,47.4563,1320
491500.0,3,2.25,1560,0,7,1110,450,47.7256,2190
325000.0,3,2.5,1870,0,7,1250,620,47.4639,1380
190000.0,3,2.0,1320,0,7,1320,0,47.3635,1420
658600.0,4,2.0,1400,0,7,1400,0,47.6826,1400
299950.0,3,1.5,1940,0,7,1300,640,47.473,2000
464000.0,5,2.0,2000,0,6,1200,800,47.6028,1330
308000.0,3,1.0,1640,0,6,1640,0,47.5027,1500
625000.0,3,1.0,1020,0,6,1020,0,47.6795,1870
240000.0,3,1.75,1630,0,7,1080,550,47.3729,1280
530000.0,4,2.5,2940,0,9,2940,0,47.3401,2890
1000000.0,5,4.5,2120,4,8,2120,0,47.5488,2870
439000.0,1,1.0,790,0,7,790,0,47.6178,1580
575000.0,4,1.75,2020,0,6,1010,1010,47.7013,1440
418000.0,3,1.75,1530,0,7,1530,0,47.7629,1580
1208000.0,4,3.75,3250,0,9,2940,310,47.639,2340
1100000.0,4,3.75,2930,0,9,2130,800,47.643,1900
1900000.0,3,3.75,3150,0,10,3150,0,47.6387,2510
580000.0,3,2.5,2180,0,9,2180,0,47.733,2630
380000.0,2,1.0,1040,0,7,840,200,47.5285,1930
256000.0,3,1.0,880,0,5,880,0,47.4858,980
349950.0,3,1.0,1400,0,8,1400,0,47.7127,1400
691500.0,4,2.5,2600,0,7,2600,0,47.6944,1790
556000.0,3,1.75,1590,0,7,1190,400,47.6668,1420
218000.0,3,2.25,1610,0,8,1280,330,47.3146,2170
425000.0,4,2.0,1390,0,7,1390,0,47.5552,1900
935000.0,3,3.25,3710,0,10,3710,0,47.693,1680
732000.0,4,1.75,2360,0,9,2360,0,47.5728,2290
805500.0,3,1.0,1440,0,7,1440,0,47.6245,2080
507250.0,3,1.75,1400,2,6,1100,300,47.5659,1500
800000.0,4,2.5,4600,0,10,4600,0,47.6417,4600
600000.0,3,2.25,2100,1,8,2100,0,47.6068,2420
627800.0,4,1.75,2010,0,9,2010,0,47.6446,2200
660000.0,2,2.25,2550,0,7,1860,690,47.6739,2010
153503.0,2,2.5,1240,0,7,1240,0,47.3241,1400
456500.0,3,2.25,2090,0,7,1460,630,47.7334,1960
1306000.0,5,2.5,2770,0,9,2770,0,47.6341,2070
843500.0,3,2.5,3560,0,11,3560,0,47.7126,3290
625000.0,3,1.0,1240,0,7,1240,0,47.667,2060
527000.0,2,1.75,1640,0,7,840,800,47.6645,1980
1965000.0,5,3.75,3940,3,9,3940,0,47.6203,2370
1003000.0,5,2.5,3150,0,9,3150,0,47.6387,3600
855000.0,4,3.0,2550,0,8,1720,830,47.6786,1590
725000.0,4,3.25,3940,3,9,3440,500,47.5157,3420
315000.0,1,1.0,580,0,6,580,0,47.5249,1360
180000.0,3,1.75,1330,0,7,1330,0,47.28,1330
700000.0,2,1.0,930,3,7,930,0,47.5333,1760
476500.0,3,1.0,1060,0,7,1060,0,47.6615,2010
193000.0,3,1.5,1180,0,7,1180,0,47.4327,1460
295000.0,4,2.5,1850,0,7,1850,0,47.3618,1850
363000.0,2,1.0,820,0,6,820,0,47.5483,1320
875000.0,4,2.5,3600,0,11,3600,0,47.7121,3410
257200.0,3,2.0,1850,0,7,1150,700,47.3066,1580
555000.0,3,2.0,2240,0,8,2240,0,47.6371,2200
380000.0,3,2.25,1860,0,7,1860,0,47.1559,1110
282000.0,4,2.75,2390,0,7,2390,0,47.3061,1980
545000.0,4,2.5,2040,0,7,2040,0,47.6952,1380
550000.0,3,1.5,1900,0,7,1640,260,47.6779,2090
921500.0,3,1.5,1900,0,7,1640,260,47.6779,2090
885000.0,3,1.5,2200,0,7,1440,760,47.6308,2440
820000.0,4,2.25,2280,2,8,1960,320,47.6503,1720
289000.0,3,1.0,1090,0,6,1090,0,47.494,1090
334000.0,1,1.0,670,0,7,670,0,47.5624,1170
206000.0,3,1.0,1050,0,5,1050,0,47.3106,970
491950.0,3,2.25,2090,0,7,1440,650,47.6971,1740
430000.0,3,2.5,2030,0,8,2030,0,47.5253,1360
208000.0,3,2.0,1250,0,7,1250,0,47.3684,1540
245000.0,4,2.25,2600,0,8,1390,1210,47.3174,2110
426000.0,2,1.0,640,0,6,640,0,47.6776,1460
400000.0,3,2.5,2120,0,7,2120,0,47.4787,2250
553000.0,3,1.0,1330,0,7,900,430,47.6837,1500
296000.0,2,1.0,750,0,5,750,0,47.6919,1450
428000.0,3,2.5,2230,0,8,2230,0,47.3321,2400
325000.0,4,2.5,1890,0,7,980,910,47.551,1590
294000.0,2,1.0,820,0,6,820,0,47.7512,1580
410000.0,3,1.75,1880,0,7,1380,500,47.5116,1970
590000.0,4,4.25,2360,0,8,2360,0,47.2843,2037
445000.0,3,2.25,1850,0,7,1850,0,47.5669,1650
921000.0,4,2.5,2310,4,8,2010,300,47.6044,2530
496000.0,3,1.5,2520,0,8,2520,0,47.4777,1470
95000.0,2,1.0,800,0,7,800,0,47.4075,1490
359000.0,4,1.75,1580,0,6,790,790,47.5378,1180
452500.0,3,2.5,2430,0,7,1570,860,47.4828,1560
555000.0,4,1.75,2350,0,7,1410,940,47.559,1800
549900.0,5,3.0,3800,0,9,3800,0,47.3488,2580
569000.0,5,3.0,3670,0,8,2060,1610,47.7589,2720
318500.0,4,2.0,1780,0,7,900,880,47.4562,1480
487028.0,2,1.5,1295,0,9,1105,190,47.6192,1295
240000.0,3,1.0,1350,0,7,950,400,47.3784,1470
253000.0,3,2.25,1440,0,7,1440,0,47.3857,1590
380000.0,5,1.75,1320,0,7,1120,200,47.3937,2360
250000.0,2,0.75,700,0,6,700,0,47.3009,2010
368500.0,2,1.75,2510,0,9,2510,0,47.3103,2400
340000.0,3,1.0,3180,0,8,1400,1780,47.1986,2180
400000.0,2,1.0,910,0,7,910,0,47.5427,1060
835000.0,3,2.0,1570,0,8,1570,0,47.68,1760
299000.0,3,2.5,2450,0,8,2450,0,47.3061,1960
1675000.0,6,2.25,4910,0,10,3580,1330,47.6458,3280
265000.0,3,2.0,1570,0,7,1570,0,47.3156,1570
437500.0,4,2.5,2680,0,8,2680,0,47.4956,2640
865000.0,3,1.75,2090,0,7,1610,480,47.657,1280
626000.0,3,2.0,2150,0,8,2150,0,47.5709,2510
247300.0,2,2.0,1140,0,7,1040,100,47.596,1140
2075000.0,4,3.5,4230,0,11,4230,0,47.5954,3980
425000.0,3,1.0,1790,0,8,1790,0,47.5448,1060
905000.0,5,3.5,3100,4,9,1660,1440,47.6134,2700
641250.0,3,2.5,2220,2,10,2220,0,47.6963,2200
675000.0,4,2.5,2370,0,8,2370,0,47.5631,2290
845000.0,4,2.75,4070,0,9,4070,0,47.4843,2970
401500.0,4,1.0,1790,0,7,1260,530,47.7627,1470
395000.0,3,2.5,1610,0,7,1610,0,47.6825,1300
1100000.0,5,2.75,2830,0,7,1630,1200,47.5773,2370
145000.0,3,1.0,1010,0,6,1010,0,47.4762,1740
900000.0,3,1.0,1560,0,8,1390,170,47.6803,1700
374500.0,3,1.5,1330,0,7,1330,0,47.7289,1370
850000.0,4,2.25,2330,0,8,2330,0,47.6044,1880
490000.0,3,1.0,960,0,7,960,0,47.5689,1520
304000.0,3,2.5,1710,0,8,1710,0,47.2635,2220
400000.0,4,2.25,2230,0,7,1300,930,47.7648,2010
454000.0,3,2.0,1700,0,8,1700,0,47.7661,1460
160000.0,2,2.0,1040,0,6,850,190,47.5293,1350
542000.0,3,1.75,1070,0,7,1070,0,47.67,1540
403500.0,5,2.5,3600,0,8,2410,1190,47.4468,2620
418000.0,4,2.5,2750,0,7,2750,0,47.3671,2610
406000.0,4,1.5,1920,1,7,1920,0,47.4029,1920
242500.0,3,2.25,1770,0,7,1340,430,47.3814,1270
425000.0,4,2.5,2460,0,9,2460,0,47.448,2460
613000.0,4,2.0,1550,0,7,1550,0,47.667,1680
189000.0,3,2.0,1460,0,7,1170,290,47.4493,1540
700000.0,4,2.25,2440,0,7,2440,0,47.7061,1720
750000.0,3,1.0,1640,0,7,1440,200,47.6693,1770
494000.0,2,1.0,1290,0,7,1290,0,47.6877,1640
700000.0,4,3.0,3150,0,9,3150,0,47.5972,2970
705000.0,2,2.5,2305,0,8,2305,0,47.7203,1440
356000.0,2,1.75,1060,0,7,1060,0,47.7409,1790
625000.0,3,1.75,2060,0,7,1350,710,47.6659,1850
144975.0,2,1.0,900,0,5,900,0,47.4177,1350
970000.0,4,4.5,3890,3,11,3060,830,47.5426,4170
415000.0,3,1.75,1910,0,7,1340,570,47.7399,1550
485000.0,4,3.0,2340,0,8,1340,1000,47.7306,1440
799950.0,3,3.0,2900,0,10,2900,0,47.6993,2900
783350.0,4,2.5,3290,0,10,3290,0,47.7231,4090
430000.0,1,1.0,630,0,7,630,0,47.6342,1090
2544750.0,5,4.75,5410,0,10,5050,360,47.6306,3750
975000.0,4,2.5,4270,0,10,2680,1590,47.6915,3630
950000.0,3,1.5,1700,0,7,1130,570,47.6304,2920
350000.0,2,1.0,1430,0,7,1150,280,47.7256,1820
637000.0,4,2.75,2850,0,8,2850,0,47.7097,1510
895000.0,3,2.0,2160,0,10,2160,0,47.4806,2760
579000.0,2,2.0,1760,0,7,880,880,47.5658,1760
314900.0,4,1.75,2700,0,7,1380,1320,47.2877,2460
122000.0,2,1.0,860,0,6,860,0,47.2109,1300
405000.0,2,1.0,880,0,7,880,0,47.6868,1300
553650.0,2,2.5,1360,0,8,1050,310,47.6254,1430
369900.0,2,2.5,1770,0,8,1770,0,47.5472,1770
225000.0,3,2.0,2030,0,7,1220,810,47.2718,1980
160000.0,2,1.0,1180,0,6,1180,0,47.4889,1780
449500.0,4,2.0,2430,0,8,1310,1120,47.4116,2220
650000.0,3,1.0,1300,0,7,1300,0,47.6337,1300
542126.0,4,2.5,2360,0,8,2360,0,47.7661,2850
309950.0,3,1.5,1200,0,7,1200,0,47.4752,1210
115000.0,2,1.0,1000,0,5,1000,0,47.2841,1350
221700.0,2,1.5,1556,0,7,1556,0,47.3891,2250
726000.0,3,2.5,1890,0,8,1460,430,47.6642,1010
515000.0,3,1.75,1810,0,7,1010,800,47.5709,1260
756000.0,4,2.5,2730,0,9,2730,0,47.5414,3090
1570000.0,4,3.75,3070,0,9,2400,670,47.633,2940
442000.0,4,2.25,2080,0,8,1220,860,47.6259,2110
260000.0,4,2.0,1620,0,7,1620,0,47.395,1710
390000.0,2,1.75,1150,0,7,770,380,47.6357,1440
459500.0,2,1.0,1250,0,7,850,400,47.6805,1370
330000.0,3,1.5,1430,0,7,1430,0,47.772,1410
189000.0,2,1.0,790,0,6,790,0,47.4873,1110
280000.0,3,1.0,1200,0,7,1200,0,47.3749,1540
400000.0,2,1.75,2110,0,7,2110,0,47.7504,1480
368000.0,4,2.0,3160,0,6,2410,750,47.4937,1020
390000.0,4,1.75,2700,0,8,2700,0,47.454,2220
245000.0,2,1.0,820,0,6,820,0,47.7321,1030
375000.0,4,2.5,1800,0,7,1200,600,47.7463,1780
465000.0,5,1.5,1750,0,6,1390,360,47.6995,1560
445000.0,3,2.0,1540,0,7,1540,0,47.5018,1250
250000.0,3,1.0,1130,0,7,1130,0,47.5239,1170
475500.0,3,1.0,1500,0,8,1500,0,47.7135,1440
672324.0,2,1.75,1600,0,8,1600,0,47.6709,2310
420000.0,3,2.0,1200,0,6,880,320,47.6936,1510
515000.0,3,2.0,1690,0,7,1690,0,47.6801,1690
732350.0,4,2.5,2270,0,9,2270,0,47.6612,2450
297500.0,4,2.5,1910,0,7,1910,0,47.3608,2020
475000.0,3,1.5,1640,0,8,1640,0,47.6869,1490
414000.0,4,2.5,2120,0,7,2120,0,47.7241,2230
357250.0,3,1.5,1400,0,6,1400,0,47.7273,1260
289950.0,2,1.0,760,0,6,760,0,47.7168,950
550000.0,3,1.0,1070,0,6,1070,0,47.5683,1290
446000.0,3,1.75,1460,0,7,960,500,47.7434,1460
279000.0,3,1.5,1280,0,5,1280,0,47.3895,1590
370000.0,3,2.25,1650,0,7,1650,0,47.7729,1890
216000.0,3,2.0,1260,0,6,1260,0,47.4401,1300
1100000.0,3,2.5,2200,1,7,1400,800,47.5809,3050
1280600.0,4,2.5,3560,1,8,2060,1500,47.5657,3680
355000.0,2,1.5,1140,1,7,630,510,47.5707,1500
699000.0,4,2.5,2550,0,9,2550,0,47.6441,2330
412000.0,3,2.5,1553,0,8,1553,0,47.7049,1509
276000.0,2,1.0,1140,0,6,1140,0,47.5265,1110
100000.0,2,1.0,790,0,6,790,0,47.4933,1380
955500.0,4,1.75,2130,0,8,2130,0,47.6427,1900
199000.0,3,1.0,1390,0,7,1390,0,47.4454,1560
762000.0,4,3.5,4000,0,9,4000,0,47.5433,3550
425000.0,4,2.0,1520,0,7,1520,0,47.7357,1520
546000.0,2,1.0,1657,0,7,1657,0,47.5699,2050
419600.0,3,1.75,1680,0,7,1180,500,47.7554,1890
735000.0,4,2.25,2270,0,8,1340,930,47.6528,1800
1234570.0,2,2.5,2470,0,11,1910,560,47.6182,2440
445000.0,2,2.0,1240,0,7,1240,0,47.6793,1660
665000.0,3,2.0,1740,0,8,1740,0,47.4914,2630
1290000.0,5,3.5,4090,0,11,2920,1170,47.7161,1880
508500.0,4,2.75,2520,0,8,1720,800,47.6225,2520
345950.0,5,1.0,1340,0,8,1340,0,47.736,1390
207500.0,3,1.0,1640,0,7,1640,0,47.3256,1200
1075000.0,4,2.5,3000,0,8,1550,1450,47.5347,2380
640000.0,3,1.0,1210,0,8,1210,0,47.6317,1560
329500.0,3,1.0,1810,0,7,1360,450,47.4482,1400
460000.0,4,2.75,2200,0,8,1500,700,47.7713,2120
1230000.0,3,1.75,2200,1,8,2200,0,47.6074,2850
805000.0,5,3.0,2350,3,7,1650,700,47.558,1840
200000.0,3,1.5,1090,0,6,1090,0,47.3425,1230
749700.0,3,1.75,2280,0,8,1460,820,47.4804,2460
288000.0,0,1.5,1430,0,7,1430,0,47.7222,1430
535000.0,2,1.0,1520,0,7,830,690,47.6815,1470
330000.0,3,2.25,1620,2,7,1280,340,47.5048,1620
479200.0,3,2.0,1510,0,7,1510,0,47.5737,1500
373000.0,5,2.5,3001,0,8,3001,0,47.3727,2340
355000.0,4,1.5,2020,0,7,1010,1010,47.5019,1710
275000.0,3,2.0,1380,0,7,1380,0,47.3661,1620
380000.0,3,1.5,1520,0,7,1020,500,47.5284,1660
417000.0,2,1.75,1090,0,7,790,300,47.6677,1390
1165000.0,5,3.75,4220,0,11,4220,0,47.5869,4630
598500.0,3,2.25,2520,0,10,2520,0,47.6381,2510
629000.0,3,2.0,1760,0,7,960,800,47.6408,1380
226950.0,2,1.0,930,0,6,930,0,47.4868,1250
1225000.0,4,2.5,2600,0,9,2200,400,47.7076,2840
415000.0,3,2.25,2180,0,8,1700,480,47.5162,2350
595000.0,3,2.5,1910,0,8,1910,0,47.5491,1940
209950.0,3,1.75,1100,0,6,1100,0,47.3625,1050
568000.0,3,1.75,1760,0,7,1760,0,47.6735,2320
119900.0,2,1.0,700,0,6,480,220,47.4976,1760
207000.0,3,1.0,1080,0,7,1080,0,47.3215,1230
195000.0,3,1.0,1070,0,7,1070,0,47.3278,1880
324950.0,3,1.5,1460,0,7,1460,0,47.4561,1400
210000.0,1,1.0,1050,0,6,1050,0,47.7294,1420
1078000.0,4,2.75,3160,0,9,3160,0,47.6367,1890
325088.0,4,1.0,1400,0,7,1000,400,47.5402,1500
790000.0,4,3.0,3120,0,8,3120,0,47.444,1580
150000.0,2,1.0,720,0,5,720,0,47.422,2010
790000.0,3,3.0,2840,0,10,2840,0,47.469,2070
255000.0,2,1.0,1220,0,6,770,450,47.5727,1540
697000.0,4,3.0,2820,0,7,1860,960,47.6813,1570
457500.0,2,1.0,840,0,7,840,0,47.6803,1240
690000.0,3,2.0,1610,0,8,1610,0,47.6825,1740
967000.0,4,3.25,1860,0,9,1860,0,47.6785,1860
980000.0,4,1.75,2260,1,9,2260,0,47.5498,2880
619420.0,4,2.75,2450,0,9,2450,0,47.5261,2330
389000.0,2,1.0,850,0,6,850,0,47.6742,1460
500000.0,3,1.0,1800,0,7,1020,780,47.5616,1740
569000.0,4,1.75,1230,1,7,1090,140,47.5808,2380
425000.0,4,2.25,2060,0,7,1540,520,47.734,1560
635000.0,4,2.25,2750,0,8,1500,1250,47.5691,1740
256500.0,2,1.0,1120,0,6,1120,0,47.3735,1540
695000.0,4,2.5,3010,0,8,3010,0,47.7389,2810
535000.0,4,1.5,1580,0,7,1390,190,47.6735,1580
454200.0,4,2.5,2630,0,8,2630,0,47.4977,2630
418500.0,2,1.0,790,0,6,790,0,47.6973,1460
749950.0,4,2.75,3110,0,9,3110,0,47.7355,2790
338500.0,3,1.75,2130,0,8,1370,760,47.4489,1750
1250000.0,4,3.75,4520,2,10,3270,1250,47.5897,3380
299950.0,3,2.5,1600,0,8,1600,0,47.339,1890
325000.0,4,1.75,1950,0,7,1330,620,47.4999,1760
434000.0,4,3.0,2010,0,8,2010,0,47.7688,2090
328950.0,4,1.75,2550,0,7,1300,1250,47.4286,2220
2095000.0,5,3.75,5340,3,10,3740,1600,47.5795,3910
570000.0,4,2.0,2000,0,8,2000,0,47.5851,2420
802000.0,3,2.25,2170,0,8,2170,0,47.6937,1700
525000.0,3,1.0,1550,0,7,1550,0,47.6572,2370
700000.0,6,3.0,2790,0,8,2790,0,47.627,2590
350000.0,3,1.75,1980,0,6,1040,940,47.4012,2180
277500.0,2,1.5,1190,0,7,1190,0,47.7274,1390
1575000.0,5,2.75,3650,0,10,2360,1290,47.6215,3220
195000.0,3,1.0,1510,0,6,1510,0,47.2052,1210
222000.0,3,2.0,1200,0,7,1200,0,47.325,1430
865000.0,5,3.0,2830,0,8,1500,1330,47.5743,2260
445000.0,4,2.0,1650,0,7,1000,650,47.5834,1540
495800.0,4,1.5,1710,0,7,1710,0,47.6847,1740
548500.0,3,1.0,1740,0,7,1740,0,47.6059,1720
310000.0,3,1.75,1840,0,7,1220,620,47.429,1590
205000.0,3,1.5,1820,0,7,1820,0,47.4479,1740
470000.0,5,3.75,3860,0,7,3860,0,47.3694,3000
430000.0,3,1.5,1810,0,7,1810,0,47.3392,2480
310000.0,2,2.0,1030,0,7,1030,0,47.7263,1439
355000.0,4,1.0,1410,0,7,1410,0,47.7604,1330
621500.0,5,2.5,2140,2,8,1370,770,47.4797,2600
175000.0,6,1.5,1930,0,7,1030,900,47.4869,1780
326000.0,6,1.5,1930,0,7,1030,900,47.4869,1780
690000.0,4,3.5,1930,2,7,1930,0,47.5679,1500
335000.0,4,2.5,2210,0,8,2210,0,47.3554,2270
197000.0,4,1.0,1360,0,7,1360,0,47.4551,1340
312500.0,3,1.75,1830,0,7,930,900,47.4667,1790
436000.0,3,2.25,2120,0,7,1420,700,47.7461,1880
1015000.0,4,2.5,2700,0,8,2700,0,47.6734,2080
805000.0,4,2.5,3160,1,9,2250,910,47.5672,3460
652427.0,4,2.25,2770,0,8,2770,0,47.6268,2400
1008000.0,3,2.5,2240,0,9,2240,0,47.6483,2900
355000.0,4,2.5,2570,0,9,2570,0,47.3324,2520
334550.0,2,1.0,880,0,7,880,0,47.7436,1960
557500.0,3,2.25,1820,0,8,1820,0,47.6382,2160
277500.0,4,2.25,1660,0,7,1110,550,47.4678,1640
300000.0,4,3.0,2200,0,6,2200,0,47.4476,1430
325000.0,4,1.0,1640,0,7,1460,180,47.7017,1230
402500.0,4,2.0,1650,0,7,760,890,47.5803,1480
461000.0,3,1.75,1420,0,7,1420,0,47.6151,2250
540000.0,3,1.0,1270,0,7,1270,0,47.6896,1270
385000.0,3,1.0,1070,0,7,1070,0,47.5529,1090
480000.0,2,1.0,1060,0,7,860,200,47.6725,1470
539950.0,3,2.25,2190,1,8,1240,950,47.5243,3500
529000.0,3,2.25,1940,0,9,1940,0,47.5636,2580
417000.0,3,2.5,1300,0,7,1060,240,47.6591,1320
405000.0,3,1.5,1330,0,7,1330,0,47.5263,2310
299000.0,3,2.25,1940,0,8,1630,310,47.3133,2080
299000.0,3,1.75,2100,0,7,2100,0,47.2924,1330
372220.0,3,1.0,1290,0,7,980,310,47.5266,1680
494400.0,2,1.75,1560,0,6,780,780,47.6347,1850
280000.0,3,1.75,2630,0,7,1330,1300,47.4878,2520
277950.0,3,2.5,2100,0,7,2100,0,47.2917,2091
770000.0,3,2.75,2070,0,8,2070,0,47.4659,2190
760000.0,4,2.5,2960,0,10,2960,0,47.7477,3510
230000.0,2,2.0,1300,0,7,1300,0,47.3623,1510
525000.0,4,2.5,2520,0,9,2520,0,47.7709,2000
307000.0,3,1.0,1150,0,7,1150,0,47.4963,1210
253779.0,4,2.0,2030,0,6,1430,600,47.4459,1820
405000.0,3,1.5,1880,0,8,1480,400,47.7743,1820
360000.0,2,1.0,2320,0,6,2320,0,47.504,1620
521000.0,2,1.0,1050,3,6,1050,0,47.5577,2540
680000.0,4,2.5,3030,0,9,3030,0,47.6313,2940
355000.0,1,0.75,530,2,4,530,0,47.6412,2830
200000.0,3,1.5,1090,0,7,1090,0,47.3639,1240
330000.0,3,2.25,2220,0,7,1330,890,47.5188,1930
221000.0,3,2.25,1430,0,7,1430,0,47.3116,1600
1598890.0,4,4.5,3780,4,11,2770,1010,47.5922,2660
310000.0,2,1.0,1560,0,6,780,780,47.7248,1760
862000.0,4,2.25,2220,0,8,1310,910,47.6418,2020
200000.0,3,1.5,1140,0,7,1140,0,47.4773,1140
630000.0,4,2.5,2540,0,7,2540,0,47.6317,1560
432250.0,3,2.25,1440,0,7,1440,0,47.5658,1740
478000.0,3,2.25,1570,0,7,1070,500,47.6843,2250
249000.0,4,2.25,1860,0,7,1400,460,47.3612,1860
495000.0,5,3.0,2440,0,9,1450,990,47.5485,1420
630000.0,4,2.5,2100,2,7,1240,860,47.6146,2000
550000.0,4,2.5,2150,0,8,2150,0,47.637,2150
350000.0,3,2.5,2440,0,8,2440,0,47.3672,2530
270000.0,5,1.5,1930,0,7,1930,0,47.4503,1480
488250.0,4,2.0,1830,0,7,1830,0,47.695,1970
248000.0,4,3.5,1850,0,7,1130,720,47.3087,1280
889000.0,4,3.5,3210,0,9,3210,0,47.5203,1360
375000.0,1,1.0,1090,0,6,980,110,47.6999,2160
933000.0,3,1.5,1870,2,7,1870,0,47.6221,1820
625000.0,3,2.25,1920,2,8,1460,460,47.5578,2490
328000.0,2,1.0,700,0,6,700,0,47.5577,1620
470000.0,4,2.25,3380,2,8,1690,1690,47.4438,2390
502500.0,5,2.5,2430,0,8,2430,0,47.5237,2150
484000.0,3,1.75,1950,0,7,1210,740,47.7424,1900
252500.0,2,1.0,900,0,6,900,0,47.6481,1190
610000.0,3,2.5,2060,0,8,2060,0,47.5615,2650
419000.0,4,2.0,2180,0,8,1280,900,47.7675,2190
322500.0,4,2.25,2140,0,8,2140,0,47.2649,2030
563000.0,6,1.0,1730,0,7,1250,480,47.6342,1630
464000.0,4,2.5,3140,0,9,3140,0,47.3826,2650
870000.0,4,4.25,3010,3,10,1940,1070,47.6933,2540
280000.0,2,1.5,800,0,8,800,0,47.6972,1020
850000.0,3,2.5,3300,0,9,3300,0,47.5599,3280
458950.0,2,1.0,1530,0,7,1130,400,47.6888,1580
122000.0,2,1.0,760,0,6,760,0,47.483,1710
525000.0,5,3.0,2450,0,7,2450,0,47.6828,1060
286300.0,2,1.0,1000,0,7,1000,0,47.4789,1490
218450.0,2,1.0,840,0,6,840,0,47.4749,1300
525000.0,3,1.5,1380,0,7,1080,300,47.674,1510
650000.0,3,1.5,1380,0,7,1080,300,47.674,1510
356000.0,4,2.0,2020,0,7,2020,0,47.4646,1610
436500.0,2,1.0,1260,0,7,1040,220,47.6782,1510
410000.0,3,1.75,1440,0,7,1180,260,47.7304,1570
512500.0,4,1.75,1540,0,7,1540,0,47.7046,1890
510000.0,4,1.0,1060,1,6,880,180,47.5591,1910
566000.0,4,1.75,1900,0,8,1900,0,47.5944,2220
525000.0,3,1.75,2870,1,8,2870,0,47.4485,2420
435000.0,3,1.0,1050,0,6,930,120,47.5402,1410
406500.0,3,2.75,1840,2,8,1340,500,47.6802,2060
550000.0,5,2.75,3000,0,8,1500,1500,47.6567,2050
251000.0,3,2.0,1200,0,6,1200,0,47.206,1280
830000.0,3,1.5,1840,0,8,1220,620,47.5607,2320
803000.0,4,2.5,2790,0,9,2790,0,47.6692,2740
206000.0,3,1.0,970,0,5,970,0,47.2808,1050
200000.0,4,1.0,1070,0,7,1070,0,47.4942,1160
219000.0,2,1.0,900,0,6,900,0,47.525,900
777000.0,4,4.0,2680,0,7,1380,1300,47.6557,1930
593700.0,3,2.5,2000,0,8,2000,0,47.59,2180
712500.0,3,1.5,1660,0,7,1660,0,47.5892,2350
600000.0,4,1.5,1770,0,7,1240,530,47.5773,1740
554663.0,3,2.0,1230,0,7,1230,0,47.6712,1850
267000.0,3,1.0,1740,0,7,1020,720,47.4682,1470
390000.0,3,2.0,1710,0,7,1710,0,47.7719,1430
335000.0,6,2.0,2020,0,7,1010,1010,47.5329,2020
938000.0,4,2.5,2410,0,8,1990,420,47.5351,2530
370000.0,4,2.75,2310,0,7,1410,900,47.377,2060
335000.0,5,2.5,2400,0,7,2400,0,47.371,2200
695000.0,5,2.0,3160,0,7,1870,1290,47.654,1780
387500.0,3,1.0,1560,0,7,1560,0,47.432,1640
245000.0,3,2.5,1770,0,7,1770,0,47.4034,1650
308550.0,3,2.0,1600,0,7,1600,0,47.4656,1360
225000.0,3,1.75,1330,0,7,1330,0,47.3172,1270
715000.0,4,2.5,2970,0,9,2970,0,47.6717,3100
335000.0,3,1.0,1020,0,7,1020,0,47.7503,1170
634000.0,3,2.5,2490,0,9,2490,0,47.5451,2370
337500.0,5,2.0,1700,0,7,1000,700,47.549,2000
440000.0,1,1.0,850,0,6,850,0,47.327,2160
350000.0,3,1.75,1250,2,7,1250,0,47.4981,1260
400000.0,2,1.0,610,0,5,610,0,47.5498,930
1288000.0,4,3.5,3700,0,11,3700,0,47.5471,3880
435000.0,3,1.0,950,0,7,950,0,47.572,1060
681000.0,4,2.5,3860,0,8,2930,930,47.5387,3130
397000.0,3,3.5,1360,0,8,1240,120,47.5904,1360
775000.0,4,2.5,3890,0,10,3890,0,47.7749,3600
480000.0,3,2.25,1680,0,7,1130,550,47.6068,1960
158000.0,3,2.5,1520,0,7,1520,0,47.3679,1780
590000.0,3,2.0,2420,0,8,2420,0,47.3666,3180
772500.0,5,2.75,3890,0,9,3890,0,47.5407,3450
464500.0,5,1.5,2940,0,8,1470,1470,47.7632,1580
281000.0,3,1.75,1350,0,7,1350,0,47.4378,1600
620000.0,3,2.25,2190,0,8,2190,0,47.7108,2970
475000.0,3,2.25,2280,1,7,1150,1130,47.5641,1500
245000.0,2,2.0,1070,0,6,910,160,47.4896,1280
660000.0,5,2.25,2540,0,7,1510,1030,47.6729,1780
527500.0,4,2.25,2270,0,8,1310,960,47.5448,1910
135000.0,2,1.0,1220,0,6,1220,0,47.3585,1350
275000.0,3,1.75,1890,0,7,1890,0,47.3357,2960
430000.0,4,2.0,1990,0,7,1080,910,47.6112,1560
213500.0,3,1.0,1220,0,7,1220,0,47.3245,1420
535000.0,3,3.0,2640,0,9,2640,0,47.4759,2680
641000.0,3,1.75,1480,0,7,1480,0,47.5915,2660
436300.0,3,2.0,2320,0,7,2320,0,47.5133,2030
1440000.0,4,1.75,2410,0,8,2410,0,47.6369,1280
830000.0,4,2.75,2090,0,8,2090,0,47.573,2130
380000.0,3,1.0,920,0,6,920,0,47.5539,1250
132500.0,3,0.75,850,0,6,600,250,47.503,850
179950.0,3,1.0,1130,0,7,1130,0,47.4362,1320
188200.0,3,1.0,1260,0,7,1260,0,47.2979,940
659000.0,4,2.0,2090,0,7,2090,0,47.5759,2090
317000.0,3,2.0,2020,0,7,1180,840,47.5496,1400
625000.0,3,2.25,1970,0,8,1470,500,47.6703,1980
350000.0,3,1.75,1820,0,7,1230,590,47.7772,1790
750000.0,3,1.5,1840,0,7,1340,500,47.6652,1840
457000.0,4,1.75,2100,0,8,1280,820,47.7478,2080
632500.0,4,2.0,1770,0,7,1770,0,47.6748,1550
223000.0,3,2.0,1110,0,7,1110,0,47.4036,1550
610000.0,4,2.75,2090,0,8,1240,850,47.6872,2340
385000.0,4,1.75,2080,0,7,2080,0,47.737,1550
367500.0,3,3.25,1400,0,7,1160,240,47.5483,1400
385100.0,3,1.0,1060,0,6,1060,0,47.7121,1300
230000.0,2,1.0,720,0,6,720,0,47.5447,1560
286000.0,3,2.75,1100,0,7,780,320,47.5601,1170
201700.0,3,1.0,1010,0,7,1010,0,47.2956,1540
1350000.0,4,4.75,5230,0,11,5230,0,47.4097,4110
525000.0,4,1.75,2420,0,8,1480,940,47.5637,2370
361000.0,3,1.5,1200,0,7,1200,0,47.739,1680
530000.0,3,1.5,1950,0,8,1950,0,47.6904,1590
455000.0,3,2.25,1870,0,7,1870,0,47.7171,1630
421000.0,4,2.25,1310,0,7,1310,0,47.7317,1600
640000.0,4,2.0,1520,0,7,1520,0,47.678,1910
240000.0,3,1.0,1270,0,7,1270,0,47.445,1660
360000.0,2,1.0,840,0,6,840,0,47.6771,1740
157340.0,2,1.0,900,0,7,900,0,47.3576,1460
1240000.0,4,3.0,3010,4,8,2560,450,47.6799,2100
250000.0,3,1.0,1050,0,6,1050,0,47.762,1500
735000.0,6,2.75,3360,0,7,2040,1320,47.715,2190
884900.0,7,4.75,5370,0,8,5370,0,47.538,2310
775000.0,3,3.5,2690,0,8,2690,0,47.7717,2300
463000.0,3,1.75,1710,0,7,1710,0,47.7512,2260
579000.0,3,2.5,1640,0,8,1640,0,47.6197,1590
570000.0,6,3.75,4000,2,10,3080,920,47.453,3180
1060000.0,5,4.5,4140,0,10,4140,0,47.6102,3960
375000.0,4,2.75,3140,0,8,2080,1060,47.3782,2850
422000.0,2,1.75,1320,0,7,920,400,47.6878,1200
866500.0,4,3.5,3080,0,9,2010,1070,47.5662,1220
705000.0,3,2.5,2500,0,10,2500,0,47.6286,2580
470000.0,4,2.5,2520,0,8,2520,0,47.4848,2090
360000.0,3,1.25,2350,0,7,1320,1030,47.5979,2140
795000.0,4,2.5,2570,4,8,1510,1060,47.7429,3470
800000.0,4,2.5,3100,0,9,3100,0,47.7151,3100
2453500.0,4,3.5,4730,0,10,4270,460,47.6319,3710
277284.0,3,1.75,1030,0,6,930,100,47.566,1540
460000.0,2,1.0,1020,0,7,1020,0,47.5828,1780
898888.0,3,2.5,2080,0,9,2080,0,47.6731,2080
211000.0,3,1.0,1410,0,7,1410,0,47.7149,1810
222000.0,2,2.0,1360,0,6,1360,0,47.3489,1310
672000.0,3,2.5,2620,0,7,2620,0,47.6384,2570
778000.0,3,2.25,2260,0,9,1690,570,47.6386,3020
312500.0,3,1.75,1490,0,8,1490,0,47.4514,2440
650000.0,4,2.5,2530,0,8,1720,810,47.6737,2150
740000.0,6,2.25,3140,0,8,1570,1570,47.6116,2320
320000.0,3,2.0,1820,0,7,1820,0,47.4703,2190
455000.0,4,2.5,1770,0,7,1770,0,47.7306,2050
2450000.0,5,4.0,4430,0,10,4430,0,47.6168,2470
500000.0,3,3.25,1490,0,8,1220,270,47.6357,1550
325000.0,3,1.75,1790,0,7,1130,660,47.532,1610
416000.0,3,2.5,1710,0,8,1510,200,47.6963,1610
495000.0,4,2.25,2070,0,7,2070,0,47.774,2190
549000.0,2,1.0,1140,0,7,1140,0,47.6205,1520
589000.0,5,2.0,3930,0,8,3070,860,47.6317,2200
194820.0,3,1.5,1100,0,7,1100,0,47.3186,1616
405000.0,3,2.5,2260,0,7,1280,980,47.681,1790
625000.0,3,2.5,2260,0,7,1280,980,47.681,1790
205000.0,3,1.0,1130,0,7,1130,0,47.4743,1440
345100.0,3,3.75,1950,0,8,1360,590,47.505,1950
200000.0,3,1.0,960,0,6,960,0,47.4966,1250
1905000.0,4,3.5,4210,0,11,4210,0,47.6206,3520
524500.0,3,1.5,3430,2,7,2230,1200,47.4476,1660
598600.0,4,2.75,3470,0,7,2070,1400,47.7066,2370
367777.0,5,3.0,2140,0,7,1280,860,47.5459,1820
750000.0,3,2.75,2520,0,7,1360,1160,47.6452,1800
575000.0,5,2.25,3550,0,8,3550,0,47.7285,2110
84000.0,2,1.0,700,0,6,700,0,47.4752,1490
255000.0,2,1.0,740,0,6,740,0,47.5298,1170
1740000.0,4,3.75,3300,4,10,2600,700,47.6561,3300
415000.0,3,2.25,1640,0,7,1240,400,47.5323,1200
449900.0,3,2.5,2780,1,9,2780,0,47.3509,720
220000.0,5,1.5,1830,0,7,1830,0,47.4218,1440
899000.0,4,2.5,3540,0,10,3540,0,47.7046,3280
430000.0,3,2.5,1440,0,7,1440,0,47.7179,1160
472500.0,4,2.5,2960,0,10,2960,0,47.3646,2770
680000.0,6,2.5,3180,0,8,1590,1590,47.5707,2670
1650000.0,5,4.0,3310,0,10,3310,0,47.6914,3430
810000.0,3,2.0,2390,0,7,2390,0,47.6707,1920
605000.0,3,2.5,2460,0,9,2460,0,47.4572,2090
522000.0,3,1.75,1630,0,7,1630,0,47.68,1830
759000.0,5,2.75,3490,0,10,3490,0,47.5825,3480
411000.0,4,2.75,2500,0,8,2500,0,47.5293,1660
286950.0,4,2.5,2080,0,7,1240,840,47.3338,1890
440000.0,3,1.5,1290,0,7,1290,0,47.6617,1720
149000.0,3,1.0,1700,0,6,1700,0,47.4899,1500
284700.0,3,1.0,1700,0,6,1700,0,47.4899,1500
374950.0,3,2.5,2540,1,8,1290,1250,47.7614,2230
816000.0,3,1.5,1180,0,8,1180,0,47.624,1660
533250.0,4,1.75,1520,0,7,1370,150,47.5265,1840
689800.0,3,2.75,2390,0,8,1390,1000,47.7209,2390
775000.0,4,2.75,2740,3,8,1820,920,47.7084,2430
702000.0,3,2.5,2190,0,8,1760,430,47.6943,2060
160000.0,3,1.0,1350,0,6,1350,0,47.4497,1300
255500.0,3,1.0,1350,0,6,1350,0,47.4497,1300
949000.0,4,2.75,2980,0,9,1860,1120,47.6392,2980
169500.0,2,1.0,790,0,6,790,0,47.4743,800
586000.0,4,2.25,2130,0,8,2130,0,47.5716,2110
680000.0,4,2.5,2700,0,8,1600,1100,47.7258,2290
851500.0,3,2.0,3200,0,8,2000,1200,47.6034,1670
582500.0,2,1.5,1159,0,7,1159,0,47.6592,1640
637000.0,4,3.5,3080,0,9,3080,0,47.7721,1830
225000.0,3,1.0,1000,0,7,1000,0,47.484,1320
795000.0,3,3.25,2260,0,8,1880,380,47.6422,1600
304999.0,4,2.25,2270,0,7,1290,980,47.3261,1930
95000.0,1,0.75,760,0,5,760,0,47.3046,970
240000.0,4,1.75,1420,0,5,1040,380,47.4946,1150
772000.0,4,2.5,2500,0,7,1250,1250,47.6073,2140
245000.0,2,1.5,1450,0,8,1450,0,47.3785,1460
430000.0,5,3.0,2500,0,8,1430,1070,47.551,1980
799000.0,3,1.5,2210,0,8,2210,0,47.5892,2700
880000.0,5,2.75,3020,0,9,3020,0,47.6806,2250
750000.0,4,2.5,3290,0,9,3290,0,47.598,3450
2890000.0,4,4.0,5780,0,11,4130,1650,47.6374,3930
532000.0,3,2.5,1820,0,8,1820,0,47.5703,2090
525000.0,4,2.75,2500,0,8,1380,1120,47.7743,2270
239000.0,2,1.0,1210,1,7,1210,0,47.3865,1680
460000.0,2,1.5,1090,0,8,970,120,47.5798,1700
540000.0,4,2.25,1330,0,8,1330,0,47.6078,2270
475000.0,2,1.0,890,0,7,890,0,47.6901,1310
445000.0,3,1.75,1360,0,8,1360,0,47.547,1350
1575000.0,5,3.75,4220,2,11,3420,800,47.5895,3380
549950.0,4,2.5,3780,0,8,3780,0,47.3526,3640
294950.0,4,2.0,2610,0,6,1690,920,47.4672,1630
736000.0,3,2.5,1980,2,8,1980,0,47.6294,1980
214946.0,3,1.75,1290,0,7,1290,0,47.3655,1750
856000.0,5,3.25,3620,2,9,3620,0,47.5442,3260
775000.0,2,2.5,2680,0,9,2680,0,47.717,2315
205000.0,3,1.75,1200,0,7,1200,0,47.3864,1564
429592.0,2,2.75,1992,4,6,1288,704,47.3551,1110
414250.0,4,1.75,1640,0,7,1120,520,47.7423,1470
399950.0,4,2.75,1920,0,6,960,960,47.5532,1040
319990.0,3,2.25,1840,0,7,1370,470,47.3958,2050
524000.0,3,1.5,1310,0,8,1310,0,47.6644,2100
349950.0,2,1.0,1050,0,7,1050,0,47.7364,1600
889000.0,4,2.5,2570,0,8,1580,990,47.6701,2070
300000.0,3,1.0,930,0,6,930,0,47.5256,1060
395000.0,1,1.0,730,0,7,730,0,47.6741,1520
348000.0,2,2.5,1270,0,7,1270,0,47.701,1280
830000.0,2,1.0,1150,1,7,710,440,47.6841,2450
173000.0,2,1.0,820,0,7,820,0,47.4261,1240
585000.0,4,1.75,3000,3,7,1500,1500,47.5265,2500
576750.0,3,2.0,2220,0,7,1110,1110,47.5807,1450
495000.0,5,3.25,2500,3,7,1250,1250,47.5298,2020
216650.0,3,3.5,1540,0,7,1360,180,47.542,1220
615000.0,4,2.75,2750,0,8,1800,950,47.7749,2750
675000.0,4,2.5,3130,0,8,1620,1510,47.569,2740
510000.0,3,2.0,1430,0,8,990,440,47.6952,1830
630000.0,3,2.5,2680,0,8,2680,0,47.3783,2020
359950.0,4,2.5,3010,0,8,3010,0,47.3492,3010
265000.0,3,1.5,1530,0,7,1530,0,47.3639,2080
210000.0,3,1.0,1240,0,6,1240,0,47.5166,1540
367000.0,3,2.5,2260,2,6,2260,0,47.2582,2180
1075000.0,4,2.25,2820,2,9,1800,1020,47.6097,2880
756000.0,3,2.5,3560,2,8,1650,1910,47.6473,2760
203000.0,3,2.25,1630,0,7,1630,0,47.5,1630
535000.0,4,2.5,2880,3,9,2880,0,47.2124,2470
525000.0,3,3.25,2200,0,7,1710,490,47.5409,1260
347500.0,3,1.75,1620,0,7,1220,400,47.4815,1470
620000.0,3,1.75,1480,0,9,1480,0,47.6945,1480
645000.0,4,2.5,2250,0,8,2250,0,47.5715,2340
2200000.0,4,3.0,3540,0,10,3000,540,47.634,3430
280000.0,3,2.0,1790,0,7,1790,0,47.3143,1330
432000.0,3,2.0,1400,0,7,700,700,47.7015,1690
790000.0,3,1.5,2390,1,9,1790,600,47.5826,2610
635000.0,4,1.75,2400,0,8,2400,0,47.6339,1680
442000.0,3,1.5,2050,0,7,1350,700,47.5325,1590
490000.0,4,3.0,2640,0,7,2640,0,47.5298,2640
250000.0,5,1.75,2320,0,7,1290,1030,47.3426,1740
1325000.0,4,2.5,2440,0,8,2440,0,47.6298,2440
120000.0,3,1.0,1260,0,6,1260,0,47.4191,1260
2950000.0,5,4.75,6240,3,11,4610,1630,47.5317,4170
325000.0,4,2.5,1930,0,7,1930,0,47.3645,1670
210000.0,4,1.75,1200,0,7,1200,0,47.3138,1490
215000.0,1,1.0,970,0,5,570,400,47.4655,1360
387000.0,3,1.75,1810,0,8,1210,600,47.5236,1800
408000.0,3,1.0,1380,0,7,1380,0,47.6987,1160
410000.0,3,1.0,1470,0,7,1470,0,47.473,1470
216000.0,3,1.0,1010,0,6,1010,0,47.5249,1520
390000.0,3,1.0,1010,0,6,1010,0,47.5249,1520
357000.0,3,1.5,1340,0,7,1340,0,47.4947,2020
215000.0,3,1.0,970,0,7,970,0,47.4006,1750
265000.0,3,1.0,1122,0,5,1122,0,47.5135,1610
589950.0,3,2.75,1670,0,9,1350,320,47.5763,1520
440000.0,3,1.75,2840,3,8,1600,1240,47.7458,2650
248000.0,2,1.0,770,0,4,770,0,47.5325,1420
730000.0,3,2.25,2040,0,9,2040,0,47.7584,3080
425000.0,4,2.5,3052,0,8,3052,0,47.2598,2767
680000.0,3,2.5,2620,0,8,1830,790,47.6281,2620
341500.0,5,2.25,3120,0,8,3120,0,47.3097,2160
395000.0,2,1.0,1100,0,7,900,200,47.6701,1110
1225000.0,4,2.75,3410,0,10,3410,0,47.6547,3721
695500.0,5,2.75,2510,1,8,1600,910,47.6389,2650
308000.0,3,1.75,1680,0,8,1200,480,47.3662,1990
422500.0,3,2.0,1960,0,7,1000,960,47.3972,1660
418000.0,2,1.0,1040,0,7,1040,0,47.5411,1620
385000.0,5,1.5,1750,0,7,1750,0,47.7755,1750
876650.0,3,3.25,2170,0,9,1650,520,47.5665,2720
450000.0,3,2.5,1639,0,8,1479,160,47.5924,1580
418800.0,4,2.25,2100,0,7,1290,810,47.7365,1930
330000.0,2,1.0,880,0,7,880,0,47.6475,1010
550000.0,3,1.75,1940,0,8,1290,650,47.5586,2400
270000.0,4,2.5,2490,0,7,1390,1100,47.4416,2010
978500.0,3,2.25,2060,0,9,1800,260,47.6455,3070
975000.0,4,2.5,2720,2,10,2500,220,47.5564,3240
455000.0,3,2.25,2180,0,7,1750,430,47.7246,1740
1415000.0,4,3.25,3600,2,11,3310,290,47.7124,2440
220000.0,2,1.0,840,0,6,840,0,47.5033,1350
490000.0,3,2.0,2370,0,7,2370,0,47.6734,1380
420000.0,4,2.25,2270,0,7,2270,0,47.7242,1710
408500.0,4,2.5,2720,0,9,2720,0,47.3315,2640
716000.0,3,1.5,1140,0,7,1140,0,47.6368,1260
965000.0,4,2.5,2460,0,8,1620,840,47.6282,2320
357823.0,3,1.5,1240,0,8,1240,0,47.7562,1690
7062500.0,5,4.5,10040,2,11,7680,2360,47.65,3930
425000.0,3,2.25,1670,0,7,1170,500,47.7253,1470
711777.0,4,1.75,2220,0,7,1110,1110,47.5691,1600
335000.0,3,1.0,980,0,7,980,0,47.7746,1830
825000.0,4,1.5,1890,0,8,1890,0,47.5896,1700
210000.0,2,1.0,1100,0,6,1100,0,47.5275,1280
575000.0,2,1.75,2770,0,8,1780,990,47.7581,2360
1208000.0,4,2.75,4250,0,10,4250,0,47.5297,4650
431500.0,2,2.0,1370,0,8,1370,0,47.704,1365
475000.0,3,1.5,1480,0,7,1480,0,47.5914,2100
1495000.0,4,3.75,3770,0,9,2890,880,47.6157,2800
540000.0,6,3.0,2870,0,7,2330,540,47.401,2380
775000.0,3,2.5,3820,0,9,3820,0,47.6496,3010
635000.0,3,2.5,1530,0,7,1210,320,47.6796,1640
1300000.0,3,2.75,4120,2,12,4120,0,47.5265,4020
405000.0,3,2.25,1590,0,7,1100,490,47.7457,2060
210000.0,3,1.0,1520,0,6,1040,480,47.5134,1320
880000.0,4,2.5,2350,0,9,2150,200,47.6344,2240
239000.0,4,2.0,1370,0,7,1370,0,47.4386,1360
515000.0,3,2.5,1540,0,6,770,770,47.5696,1710
1379900.0,3,3.25,3786,4,9,1934,1852,47.3907,2850
215000.0,4,2.25,1500,0,7,1500,0,47.3378,1500
315000.0,6,2.0,1750,0,5,1750,0,47.5096,1750
442500.0,3,1.5,1800,0,7,1200,600,47.7693,1800
311000.0,2,1.75,1180,0,8,1180,0,47.3329,1480
425000.0,2,1.0,830,0,6,830,0,47.6994,1280
433500.0,3,1.75,1540,0,6,1040,500,47.6985,1200
450000.0,3,2.25,1610,0,8,1610,0,47.7,1610
675000.0,3,2.25,1990,0,8,1990,0,47.6801,1990
535000.0,3,2.5,2070,0,8,2070,0,47.6036,1530
577000.0,3,1.75,1760,0,7,1230,530,47.5906,1950
480000.0,3,1.75,1740,0,7,1290,450,47.7097,1610
400000.0,3,1.5,1950,0,6,1530,420,47.7094,2670
304000.0,3,1.0,1280,0,6,1280,0,47.7467,1120
355000.0,3,1.75,1460,0,7,1460,0,47.5049,1570
998000.0,4,3.25,3770,0,10,3770,0,47.414,2290
550000.0,4,1.75,2410,3,8,2060,350,47.6499,2520
550000.0,4,1.75,2410,3,8,2060,350,47.6499,2520
210000.0,3,1.75,1400,0,6,1400,0,47.4999,1440
317000.0,3,2.5,2100,0,9,2100,0,47.3072,2330
700000.0,4,3.5,5360,0,9,3270,2090,47.6099,2650
265000.0,3,1.0,1000,0,7,1000,0,47.4829,1490
700000.0,4,3.5,3150,0,9,3150,0,47.5966,3150
1020000.0,5,3.5,4180,2,10,3160,1020,47.5618,3260
1145000.0,4,2.25,2840,0,8,2240,600,47.639,2840
460000.0,4,2.5,2110,0,8,1290,820,47.467,2740
410000.0,2,1.5,1660,0,7,1000,660,47.6832,1570
665000.0,4,3.0,2160,0,7,1320,840,47.6163,1430
600000.0,4,2.5,2420,0,9,2420,0,47.534,2820
502000.0,4,1.75,1920,0,7,1170,750,47.7041,1480
364950.0,4,2.5,2310,0,7,2310,0,47.7433,1780
680000.0,3,2.25,2330,2,7,1520,810,47.6732,1870
235500.0,5,2.5,2340,0,8,1670,670,47.3307,2080
576000.0,4,2.5,2590,0,8,2590,0,47.5356,2620
405000.0,2,3.0,1410,0,8,1140,270,47.5221,1410
335000.0,3,2.75,2850,0,8,1540,1310,47.4141,2240
122000.0,2,1.0,730,0,6,730,0,47.4275,1170
432000.0,3,1.75,1470,3,7,1070,400,47.7394,2630
375000.0,4,2.25,2330,0,8,2330,0,47.4495,2640
276000.0,4,2.25,2460,0,8,2460,0,47.3182,1630
450000.0,3,2.25,2080,0,8,1680,400,47.7403,2440
210000.0,2,1.0,990,0,6,990,0,47.5828,2150
279000.0,3,2.5,1450,0,7,1450,0,47.3655,2000
635000.0,3,1.75,1340,0,7,1340,0,47.6711,1470
350000.0,3,2.5,2730,0,9,2730,0,47.2831,2710
218000.0,3,1.0,1140,0,6,1140,0,47.4624,1300
750000.0,4,1.5,1950,1,7,1650,300,47.6819,1760
310597.0,4,1.75,2000,0,7,1150,850,47.32,2420
355000.0,3,1.0,900,0,5,700,200,47.7146,1750
735000.0,5,2.75,3390,0,9,3390,0,47.5977,3210
155000.0,1,1.0,720,0,6,720,0,47.5266,1040
354000.0,3,1.0,940,0,7,940,0,47.6608,2090
415000.0,3,1.75,1770,0,7,1400,370,47.7726,2070
202000.0,1,1.0,590,0,7,590,0,47.6082,780
580000.0,3,2.5,1980,0,7,1470,510,47.6659,1500
1495000.0,4,3.25,3070,0,10,2180,890,47.5862,2500
790000.0,4,2.5,3500,0,9,3500,0,47.6799,3920
499900.0,3,2.5,2100,0,8,2100,0,47.5338,2100
525000.0,4,2.25,2620,0,7,1820,800,47.4662,1728
810000.0,4,2.5,2810,0,9,2810,0,47.5424,2800
425000.0,4,1.5,2290,0,7,1330,960,47.7173,1740
241250.0,3,1.75,1350,0,7,1350,0,47.3123,1470
318700.0,4,2.5,2770,0,8,1600,1170,47.3386,2730
720000.0,4,1.75,2530,2,8,2070,460,47.6624,1950
291000.0,3,1.0,1280,0,5,1280,0,47.566,1410
420000.0,3,1.75,1060,0,7,1060,0,47.7442,1310
210000.0,2,1.75,1000,0,8,1000,0,47.3811,1150
645000.0,3,3.25,3870,2,9,2970,900,47.5545,2970
762000.0,5,2.0,3370,0,7,2140,1230,47.6373,1920
247500.0,4,1.75,2290,0,6,2290,0,47.4997,1240
282500.0,3,2.25,1670,0,7,1670,0,47.3603,1570
395000.0,3,1.75,1460,0,7,1460,0,47.4861,2030
295000.0,3,1.75,1770,0,7,1030,740,47.4323,1560
235000.0,2,1.0,820,0,6,820,0,47.5175,2270
770000.0,3,1.75,1900,2,8,1450,450,47.6675,1530
559950.0,2,2.0,1870,0,8,1870,0,47.7195,1670
639000.0,4,2.0,1840,0,7,920,920,47.6483,1800
314950.0,3,1.0,1590,0,7,1140,450,47.4473,1570
525000.0,3,1.0,1640,0,7,1640,0,47.5682,1540
2400000.0,3,2.25,3000,4,11,3000,0,47.5884,3000
820000.0,3,1.75,2160,0,8,1390,770,47.6777,1290
1385000.0,3,3.0,2490,3,8,1790,700,47.6313,2490
521450.0,3,2.0,1290,0,7,1290,0,47.5713,1160
760750.0,3,2.5,3190,0,9,3190,0,47.6027,3240
759600.0,4,1.0,1540,0,7,1540,0,47.4163,2027
346150.0,3,2.0,2140,0,8,1480,660,47.5084,2070
390000.0,2,1.0,980,0,7,980,0,47.6903,1520
359950.0,5,2.25,2450,0,8,2450,0,47.4519,2310
430000.0,3,2.0,1360,0,6,910,450,47.5587,1440
960000.0,4,3.5,4610,0,10,4610,0,47.6011,3900
800000.0,7,6.75,7480,2,11,5080,2400,47.4643,2810
1010000.0,3,2.5,2860,0,9,2860,0,47.6218,2360
290000.0,3,2.0,1810,0,7,1810,0,47.4648,1360
1350000.0,4,2.0,2240,0,8,2240,0,47.6177,2500
777000.0,3,3.25,3610,0,10,2440,1170,47.5464,3130
526000.0,2,1.0,1450,0,7,1450,0,47.6739,1470
550000.0,3,3.5,1450,0,8,1200,250,47.6475,1490
276000.0,3,1.5,1820,0,7,1200,620,47.4213,1500
2500000.0,5,3.25,5620,0,11,4140,1480,47.5786,4470
325000.0,3,1.75,2080,0,7,1040,1040,47.5135,1230
365000.0,3,2.5,1780,0,8,1780,0,47.548,1780
2150000.0,8,6.0,4340,0,8,4340,0,47.6316,2050
825050.0,4,3.25,2860,0,9,1980,880,47.6752,2010
690000.0,3,1.5,2540,0,8,1500,1040,47.6834,1870
390000.0,4,1.0,1140,0,6,1140,0,47.5433,1140
385000.0,3,2.0,1320,0,7,1320,0,47.6959,1380
619000.0,3,2.5,2040,0,8,2040,0,47.5718,2170
494000.0,4,2.25,1790,0,7,1170,620,47.4819,2060
412450.0,3,2.0,1910,0,8,1910,0,47.7114,2010
580000.0,3,1.75,1460,0,7,1460,0,47.6779,1220
269900.0,3,1.5,1420,0,7,1420,0,47.4193,1540
704300.0,4,1.5,1790,0,7,1790,0,47.5749,1710
267000.0,3,2.0,1390,0,8,1390,0,47.2117,1264
310000.0,4,1.75,1880,0,7,1280,600,47.3272,1980
227064.0,3,1.5,1570,0,7,1570,0,47.54,1530
925000.0,3,2.5,2690,0,7,1840,850,47.6784,1800
245000.0,3,1.75,1670,2,8,1670,0,47.1913,1820
339888.0,3,1.0,1040,0,7,1040,0,47.7137,1520
439000.0,4,2.0,1560,0,7,1560,0,47.7281,1730
400000.0,2,1.0,1470,0,7,1470,0,47.6914,1840
560000.0,3,2.25,2070,0,8,2070,0,47.7635,2070
703011.0,2,1.0,1370,2,8,1130,240,47.6473,2460
363000.0,2,1.0,1120,0,7,770,350,47.5669,1510
650000.0,4,2.75,2640,0,9,2640,0,47.5788,2640
299950.0,3,1.0,1030,0,7,1030,0,47.7218,1470
228950.0,3,1.0,1120,0,6,1120,0,47.4879,1120
465000.0,4,1.75,1730,0,7,880,850,47.6031,1570
725000.0,3,2.5,2090,2,9,2090,0,47.5651,2860
212500.0,3,1.0,920,0,7,920,0,47.2816,1170
526000.0,4,2.25,2970,0,8,2970,0,47.4338,2260
383000.0,3,2.5,1720,0,8,1720,0,47.7688,2280
244000.0,3,1.75,1460,0,7,1460,0,47.472,1600
565000.0,3,1.5,1540,0,7,1490,50,47.6692,1620
373000.0,8,3.0,2850,0,7,2850,0,47.4859,1480
300000.0,3,2.0,1310,0,7,1310,0,47.7296,1310
405000.0,5,2.5,2430,0,9,2430,0,47.4487,2420
979000.0,3,1.5,1700,1,8,1700,0,47.6166,2630
324888.0,4,1.75,2160,0,8,2160,0,47.3212,1790
445000.0,3,1.5,860,0,6,860,0,47.6791,1220
761000.0,3,3.5,2050,0,8,1520,530,47.6235,1230
435000.0,4,2.0,1650,0,7,1130,520,47.7359,1650
252000.0,3,2.25,1570,0,7,1180,390,47.1942,1540
350000.0,3,1.75,1660,0,7,1660,0,47.7512,1640
875000.0,3,1.0,1220,0,7,1220,0,47.6328,1910
940000.0,3,1.0,1220,0,7,1220,0,47.6328,1910
280000.0,3,2.0,1780,0,7,1780,0,47.4617,2140
450000.0,3,2.5,2180,0,8,2180,0,47.7733,2540
905000.0,3,2.5,3520,0,9,3520,0,47.2687,2310
382450.0,3,2.5,2220,0,8,2220,0,47.2864,2420
246700.0,3,2.0,1610,0,7,1610,0,47.3398,1610
220000.0,3,1.5,1070,0,6,1070,0,47.7633,1480
555750.0,3,1.0,1060,0,6,910,150,47.5545,1200
262500.0,3,1.5,1160,0,7,1160,0,47.5362,1160
515000.0,2,1.0,910,0,7,910,0,47.676,1600
499500.0,3,2.5,2970,0,9,2970,0,47.4741,2040
135000.0,1,1.0,790,0,6,790,0,47.4919,1240
462500.0,2,2.0,1540,0,7,1540,0,47.551,1540
937500.0,4,2.5,3130,4,9,2530,600,47.7598,3680
458000.0,3,1.5,1470,0,7,1280,190,47.7032,1390
845000.0,4,2.75,3160,0,8,2100,1060,47.6513,2200
660000.0,3,2.25,2675,0,8,2675,0,47.5916,2300
265000.0,3,2.0,1340,0,7,1340,0,47.3504,1630
599999.0,9,4.5,3830,0,7,2450,1380,47.6927,1460
280000.0,3,2.5,1800,0,8,1800,0,47.3115,1770
1055000.0,3,3.25,2990,0,10,2990,0,47.746,3500
875000.0,4,3.0,3720,0,9,1930,1790,47.5911,3160
125000.0,3,1.0,920,0,6,920,0,47.285,1120
634800.0,4,3.0,3280,0,7,3280,0,47.6802,2600
269950.0,4,1.0,1440,0,7,1440,0,47.3168,1740
359950.0,3,2.25,1940,0,8,1100,840,47.5018,2180
417000.0,3,1.75,1590,0,8,1590,0,47.5049,1970
389000.0,2,2.0,1340,0,8,1340,0,47.7182,1350
1038000.0,4,2.5,3770,2,11,3770,0,47.5646,3710
698000.0,6,2.5,2680,0,7,1340,1340,47.6553,2200
685000.0,4,2.5,2820,0,8,2820,0,47.7494,1560
198500.0,3,1.75,1520,0,5,1520,0,47.4924,1240
350000.0,4,2.5,2560,0,8,2560,0,47.3835,2620
649950.0,3,2.5,3310,0,8,2160,1150,47.4167,2340
441000.0,3,1.5,1540,0,7,1540,0,47.7357,1560
462600.0,3,1.75,1430,0,8,1430,0,47.6686,2040
365070.0,4,2.5,2506,0,7,2506,0,47.3734,2070
550000.0,4,2.0,2250,0,7,1200,1050,47.5877,1440
470000.0,5,1.75,2740,0,7,1370,1370,47.5738,1990
340000.0,3,1.75,1540,0,6,1540,0,47.5651,1090
910000.0,4,2.75,4190,0,9,2040,2150,47.6472,3050
405000.0,4,1.75,1690,0,7,1190,500,47.773,1880
661000.0,4,2.25,1990,2,8,1420,570,47.5638,1810
635000.0,4,2.5,2410,0,9,2410,0,47.7094,2240
282000.0,2,1.0,1150,0,7,950,200,47.7259,1790
235000.0,4,1.75,1720,0,7,1720,0,47.4424,1350
277500.0,3,2.0,1260,0,7,1260,0,47.2772,1430
346500.0,5,2.5,2020,0,8,1430,590,47.4432,1680
480000.0,5,2.25,2240,0,7,1490,750,47.5305,2010
360000.0,4,2.25,1930,0,8,1930,0,47.7458,2170
245000.0,3,2.5,1820,0,7,1420,400,47.3201,1710
625000.0,3,3.5,1560,0,8,1240,320,47.6248,1560
750500.0,5,3.0,2170,0,8,1450,720,47.6724,2070
525000.0,3,1.75,1600,0,8,1180,420,47.7662,1750
740000.0,4,3.5,3760,0,9,2950,810,47.6328,2870
523000.0,3,1.5,1240,0,7,1240,0,47.601,1260
292000.0,3,1.75,1090,0,8,1090,0,47.5157,1640
625000.0,4,2.5,2740,2,8,1820,920,47.7728,2660
700000.0,3,2.5,3110,2,9,3110,0,47.5445,4240
399950.0,3,2.5,1610,0,7,1280,330,47.6,1480
545000.0,4,3.5,1880,0,8,1650,230,47.6053,1740
339999.0,4,2.0,1740,0,6,870,870,47.7461,1560
1210000.0,4,2.25,3270,0,8,2180,1090,47.6101,2880
545000.0,3,2.5,1990,0,8,1990,0,47.5895,2280
260000.0,4,1.75,1960,0,8,1960,0,47.3111,2080
526000.0,3,1.75,1680,0,7,960,720,47.6854,1680
701000.0,4,3.0,2910,0,9,2910,0,47.5223,3040
290000.0,3,2.25,1500,0,7,1210,290,47.4619,1480
330600.0,1,1.0,580,0,7,580,0,47.6829,1260
550500.0,3,1.75,2540,0,7,1270,1270,47.7219,1950
430000.0,2,1.0,950,0,7,950,0,47.5653,1360
4000000.0,4,5.5,7080,0,12,5760,1320,47.6151,3140
260600.0,2,1.0,810,0,7,810,0,47.5425,1490
825000.0,5,3.0,4080,2,8,2720,1360,47.6722,2000
378950.0,4,2.0,1820,0,7,1300,520,47.7615,1700
435000.0,4,2.5,2650,0,7,2650,0,47.7258,2590
631000.0,3,2.25,1670,0,9,1250,420,47.6814,1610
415000.0,3,2.5,2480,0,8,2480,0,47.4381,2300
222000.0,3,1.75,1240,0,8,1070,170,47.333,1650
245000.0,3,2.0,1390,0,7,1390,0,47.3707,1390
720000.0,3,2.5,2880,0,10,2880,0,47.6319,2960
215000.0,3,1.0,1060,0,7,1060,0,47.3801,1620
579100.0,2,1.0,1070,0,7,830,240,47.6755,1760
522500.0,4,1.75,1640,0,7,870,770,47.5334,2460
489000.0,3,2.0,1510,0,7,910,600,47.6804,1620
240000.0,3,1.0,1230,0,6,1230,0,47.5177,1280
420250.0,3,2.0,1510,0,8,1510,0,47.7225,1510
523000.0,4,2.5,3180,0,8,2120,1060,47.7176,2700
628000.0,4,2.0,2260,0,8,1430,830,47.6876,2030
320000.0,4,2.5,1920,0,8,1920,0,47.4058,2300
359950.0,3,2.5,1980,0,8,1980,0,47.4492,1700
232000.0,2,1.0,1200,0,6,1200,0,47.4204,1200
810000.0,4,2.25,2020,2,8,1210,810,47.6821,2660
245000.0,4,1.5,2010,0,7,1890,120,47.311,1420
273000.0,3,2.25,1930,0,7,1470,460,47.2624,1510
1191000.0,5,2.5,2710,0,8,1720,990,47.6411,3180
438000.0,5,1.0,1950,0,7,1450,500,47.5511,1950
400000.0,3,1.75,2110,0,8,2110,0,47.4742,880
340000.0,3,1.0,1250,0,7,1250,0,47.5517,1404
552000.0,2,2.5,1380,0,9,1380,0,47.6654,1430
790000.0,3,1.75,2050,0,8,2050,0,47.6698,1890
360000.0,3,1.5,1800,0,8,1800,0,47.4889,1440
235000.0,3,1.0,1310,0,7,1310,0,47.5008,1530
775000.0,2,1.0,1010,0,7,1010,0,47.6641,1540
489200.0,3,2.75,1850,0,7,1850,0,47.7259,1250
341000.0,3,2.25,1750,0,8,1750,0,47.4451,1680
335000.0,4,2.5,2154,0,8,2154,0,47.3513,2305
393500.0,3,1.75,1230,0,8,1010,220,47.5626,1170
360000.0,3,2.0,1960,3,6,980,980,47.5101,2190
400800.0,4,1.0,1070,0,6,870,200,47.564,1270
585000.0,3,1.0,1450,0,7,1190,260,47.6436,1810
1600000.0,4,2.75,3680,3,9,2480,1200,47.6599,3200
2880500.0,4,2.5,5760,4,12,4390,1370,47.7288,3420
300000.0,3,1.0,1220,0,7,1220,0,47.7608,1510
1045000.0,4,2.75,2950,0,7,1810,1140,47.6525,2000
360000.0,3,1.5,1340,0,7,1040,300,47.698,1220
665900.0,4,2.25,2870,1,8,2220,650,47.5129,1660
470000.0,4,1.0,2590,0,7,2000,590,47.5318,1800
581000.0,4,1.75,2090,0,8,1070,1020,47.6715,1310
527000.0,6,3.5,3000,0,8,1500,1500,47.7226,1400
423000.0,4,1.75,1730,0,7,880,850,47.5995,1550
875000.0,4,3.5,2850,0,7,2040,810,47.6835,1860
410000.0,3,1.0,1020,0,7,1020,0,47.571,1440
606000.0,3,2.5,2200,0,9,2200,0,47.7408,2320
654000.0,3,2.5,3240,0,7,3240,0,47.5192,2570
150000.0,3,0.75,490,0,5,490,0,47.7112,800
373000.0,3,2.5,2990,0,7,1550,1440,47.5237,1800
550000.0,5,2.0,2450,0,7,1240,1210,47.7056,1310
512500.0,3,2.5,1900,0,8,1900,0,47.7002,1980
360000.0,4,2.5,2640,0,7,2640,0,47.3505,2640
369000.0,3,2.0,1340,0,8,1340,0,47.6904,1340
825000.0,4,2.5,3220,0,9,3220,0,47.6878,3220
255000.0,3,2.0,930,0,7,930,0,47.4644,1280
1285000.0,4,2.5,3240,0,10,2260,980,47.6709,3490
270000.0,5,2.5,2630,0,8,2630,0,47.2863,1780
480680.0,3,2.5,1730,0,8,1730,0,47.5672,1610
525000.0,4,1.75,2120,0,8,1220,900,47.6003,2160
291500.0,3,1.0,880,0,6,880,0,47.7494,1170
305000.0,4,2.0,1800,0,7,1800,0,47.4721,1730
285000.0,3,1.75,1600,0,7,1600,0,47.2831,1620
1875000.0,3,2.5,3280,3,11,3280,0,47.6699,3530
329500.0,5,1.75,3290,0,7,1790,1500,47.3733,2380
1570000.0,4,2.25,2890,4,10,2890,0,47.5169,2870
379260.0,3,2.5,1730,0,7,1330,400,47.4099,2100
356000.0,3,2.5,1590,0,7,1590,0,47.5303,1590
571900.0,4,1.75,1710,0,7,1710,0,47.5947,1360
271500.0,3,1.75,1995,0,7,1995,0,47.4129,1980
390000.0,3,1.75,1300,0,7,1300,0,47.7359,1520
550000.0,3,2.5,2720,0,8,2040,680,47.4168,2770
755000.0,2,2.5,1360,0,8,1360,0,47.6423,1920
509500.0,2,2.5,1590,0,8,1300,290,47.6375,1880
486700.0,2,1.0,1200,0,7,1080,120,47.7001,1200
527500.0,2,1.0,1170,0,7,1170,0,47.6697,1530
475000.0,5,2.5,2010,0,6,1510,500,47.6522,1780
268000.0,3,2.75,1880,0,7,1810,70,47.5405,1800
562000.0,3,2.0,3250,0,8,3250,0,47.5849,2370
780000.0,4,2.5,2270,0,9,1310,960,47.5416,2810
700000.0,9,3.0,3680,0,7,2830,850,47.6374,1960
710000.0,3,2.0,1880,0,8,1040,840,47.6418,1790
445000.0,3,1.0,1050,0,7,910,140,47.6897,1500
729000.0,3,3.25,2250,0,9,2250,0,47.4246,2760
384400.0,3,3.25,1689,0,8,1689,0,47.7174,1459
815000.0,6,3.0,2860,0,8,1430,1430,47.546,1920
865000.0,4,2.5,2710,0,10,2710,0,47.604,1810
514000.0,3,2.0,1770,0,7,1770,0,47.6642,2250
615000.0,4,2.75,2820,0,8,1860,960,47.5579,2580
865000.0,4,3.25,3400,0,8,2000,1400,47.7293,3460
755000.0,4,2.5,3110,0,9,3110,0,47.7011,3090
425000.0,4,1.0,1480,0,7,1080,400,47.7629,1580
375000.0,2,1.0,940,0,6,940,0,47.5379,1330
750000.0,4,2.5,2680,0,8,2680,0,47.7073,2750
722000.0,4,2.75,3190,0,9,3190,0,47.5903,3160
1011000.0,3,2.5,1920,1,9,1920,0,47.6472,1790
725000.0,3,2.5,2610,0,9,2610,0,47.6648,2610
170000.0,3,0.75,1040,0,6,1040,0,47.4518,1270
845000.0,4,3.25,2880,0,11,2270,610,47.6587,1910
271900.0,3,2.0,1450,0,7,1450,0,47.1947,1450
1300000.0,6,4.5,3902,4,9,2782,1120,47.5837,1100
261500.0,4,2.5,2460,0,8,1500,960,47.3081,2210
619500.0,3,2.5,2170,0,9,2170,0,47.5458,2170
435000.0,5,2.25,1970,0,7,1450,520,47.5669,1300
210000.0,3,1.0,1000,0,7,1000,0,47.7339,1320
489950.0,3,2.0,1580,0,7,790,790,47.6769,1350
260000.0,4,1.5,2130,0,7,1100,1030,47.383,1480
300000.0,4,1.0,1370,0,7,1370,0,47.736,1370
530000.0,4,2.0,2150,2,8,1330,820,47.3376,2310
235000.0,3,1.75,1370,0,8,1370,0,47.2969,2100
593500.0,3,1.0,1370,0,8,1370,0,47.6711,1370
562000.0,3,3.0,3290,2,8,2330,960,47.504,1830
585000.0,3,2.0,3190,0,9,3190,0,47.2737,2930
2400000.0,4,3.25,4140,1,10,3300,840,47.6344,4020
199500.0,3,1.75,1690,0,7,1690,0,47.3546,1690
544500.0,5,1.0,1690,0,7,1690,0,47.6746,1230
394900.0,3,1.0,1430,0,7,1430,0,47.7317,1670
912000.0,4,3.75,1980,0,9,1980,0,47.6901,1480
260000.0,3,2.5,1490,0,7,1490,0,47.3712,1640
858000.0,5,3.0,3620,2,8,1900,1720,47.5512,2930
1275000.0,4,2.5,2720,1,9,1870,850,47.5489,3560
242150.0,4,1.75,1490,0,7,1490,0,47.3894,1180
220000.0,3,1.75,1230,0,7,1230,0,47.2881,1540
235000.0,3,2.0,1900,0,7,1340,560,47.305,1690
370000.0,3,1.75,1530,0,7,1530,0,47.7767,1940
450000.0,3,1.75,2290,0,8,1390,900,47.7398,2410
534950.0,5,1.5,2240,0,8,1280,960,47.7046,1870
730000.0,4,2.5,3470,0,9,3470,0,47.5423,3450
465000.0,4,2.5,3050,0,8,1550,1500,47.3626,2350
178000.0,3,1.0,1100,0,7,1100,0,47.3632,1770
215000.0,3,1.0,1610,0,7,1080,530,47.3943,1800
300000.0,3,2.75,1910,0,8,1210,700,47.3128,2450
430000.0,3,2.0,1510,2,7,1230,280,47.7053,1950
183000.0,3,1.5,1280,0,6,1280,0,47.335,1280
585000.0,3,2.5,1910,0,8,1530,380,47.6441,1760
192950.0,3,1.0,1170,0,6,1170,0,47.3155,1090
599000.0,2,1.0,1550,0,7,1550,0,47.7005,1340
326500.0,3,1.0,1060,0,7,1060,0,47.5649,1060
358803.0,2,1.0,1040,0,7,1040,0,47.7024,1040
537000.0,3,2.5,1550,0,7,1550,0,47.6973,2610
1155000.0,3,2.5,2490,4,9,1580,910,47.488,2800
156000.0,2,1.0,920,0,6,920,0,47.3012,1210
219000.0,3,1.0,1250,0,6,1250,0,47.2092,1250
1190000.0,3,1.5,2540,0,8,1630,910,47.637,2520
248000.0,5,1.75,2190,2,8,1380,810,47.3764,1920
340000.0,3,1.75,1340,0,7,1340,0,47.2931,2250
899100.0,5,2.5,2410,0,8,1400,1010,47.5416,2440
346950.0,3,1.75,1830,0,7,1830,0,47.7554,1850
330000.0,3,1.0,1850,0,6,1740,110,47.5446,1520
325000.0,3,1.0,1410,0,7,1410,0,47.7621,1580
315000.0,3,1.75,1460,0,8,1460,0,47.4457,2050
649950.0,3,2.5,1500,0,9,1200,300,47.6451,1680
316000.0,3,1.0,1130,0,6,1130,0,47.7298,1350
386000.0,2,2.5,1620,0,8,1620,0,47.5167,1750
535000.0,2,1.75,2330,0,7,1450,880,47.4282,1830
600000.0,3,3.0,1520,0,7,1520,0,47.6822,1520
339000.0,4,2.5,2840,0,8,2840,0,47.19,2630
167000.0,3,2.0,1520,0,7,1520,0,47.4745,1740
430000.0,3,1.0,1740,0,8,1740,0,47.5596,1600
688000.0,4,4.0,4000,0,9,4000,0,47.5421,3920
834500.0,3,2.25,2780,3,9,1670,1110,47.6442,2780
1075000.0,4,4.25,3500,4,9,2140,1360,47.7222,3110
250000.0,3,1.0,1060,0,7,1060,0,47.36,1900
402500.0,3,1.0,1290,0,7,1290,0,47.5462,1160
432500.0,3,2.5,2390,0,8,1600,790,47.726,2020
485000.0,5,1.75,2460,0,7,1380,1080,47.7452,2028
560000.0,4,2.75,2930,3,9,1580,1350,47.3227,2930
410000.0,4,2.25,2200,0,7,2200,0,47.7456,1090
455000.0,3,2.5,1870,0,8,1470,400,47.7265,1930
459500.0,4,2.5,2060,0,7,1190,870,47.7686,1350
371000.0,4,1.75,1610,0,7,1610,0,47.727,1870
289500.0,3,2.25,2120,0,7,2120,0,47.3364,2420
395000.0,3,3.5,1450,0,8,1160,290,47.6508,1390
496752.0,2,1.0,1980,0,7,1090,890,47.586,1720
227000.0,2,1.0,860,0,6,860,0,47.7274,1220
330000.0,3,1.75,1460,0,7,1460,0,47.5155,1550
480000.0,5,2.0,2590,0,7,1340,1250,47.6112,1750
290000.0,2,1.0,1120,0,6,1120,0,47.7378,1480
281000.0,3,1.0,1340,0,5,1340,0,47.4023,1340
705000.0,4,1.5,1780,3,8,1780,0,47.5589,1710
1400000.0,4,2.5,2920,0,8,1910,1010,47.6578,2470
485000.0,4,3.25,2820,0,7,1410,1410,47.7473,2320
622000.0,3,2.25,1550,0,8,1550,0,47.6729,1550
380000.0,3,2.25,1600,3,8,1600,0,47.1991,1600
2125000.0,4,2.75,3190,4,10,3190,0,47.6991,2750
561500.0,3,1.75,1960,0,7,980,980,47.6975,1480
242000.0,3,1.0,970,0,7,970,0,47.4451,1110
348500.0,3,1.5,1360,0,7,1360,0,47.4948,1650
370000.0,3,1.5,1360,0,7,1360,0,47.4948,1650
752000.0,6,3.75,3810,0,8,3810,0,47.6938,1610
230000.0,3,1.75,1340,0,7,1100,240,47.3668,1540
715000.0,3,2.25,1990,0,9,1990,0,47.5404,1280
240415.0,3,1.75,1120,0,7,1120,0,47.3694,1900
562000.0,4,1.75,2060,0,7,1460,600,47.6698,1620
360000.0,3,1.5,1170,0,6,1170,0,47.5338,920
659950.0,3,2.5,1610,1,9,1080,530,47.6423,1610
458500.0,3,2.0,1890,0,9,1430,460,47.5438,1780
259950.0,2,2.0,1070,0,9,720,350,47.5213,1070
366000.0,3,1.75,1680,0,8,1680,0,47.4501,2220
978000.0,4,2.75,2890,0,9,2890,0,47.554,2890
525000.0,2,1.0,1360,0,7,1060,300,47.6841,1800
926300.0,3,1.5,1660,0,8,1660,0,47.6352,1690
750000.0,2,1.0,1620,0,7,1620,0,47.6731,1650
660000.0,2,1.0,960,1,6,960,0,47.6646,1460
305000.0,4,1.75,1000,0,6,1000,0,47.742,1280
800000.0,2,2.5,2395,0,8,2395,0,47.7114,2170
600000.0,4,1.75,3050,0,8,1800,1250,47.7228,2020
435000.0,2,1.0,1120,0,6,1120,0,47.3205,1640
1135000.0,4,3.25,2960,0,9,2190,770,47.6526,2150
318000.0,3,2.25,1250,0,8,1250,0,47.7099,1250
639000.0,4,2.0,1940,0,7,980,960,47.6719,1940
453000.0,3,2.5,1750,0,8,1750,0,47.6638,1750
800000.0,4,1.75,2150,0,7,2150,0,47.5828,2370
437000.0,2,1.75,1500,0,7,910,590,47.7004,1450
1150000.0,3,2.75,3230,4,7,3230,0,47.3344,2560
490000.0,4,2.5,3000,0,8,3000,0,47.7315,1930
499950.0,4,1.75,1520,0,7,1520,0,47.7356,1520
160134.0,3,1.5,1190,0,7,1190,0,47.385,1190
191000.0,3,1.0,990,0,7,990,0,47.425,1180
221000.0,3,1.0,1250,0,7,1250,0,47.3414,1450
352800.0,4,2.0,2080,0,7,1330,750,47.5392,2080
350000.0,3,2.5,1640,0,7,1640,0,47.7345,1560
458000.0,4,1.5,1550,0,7,1350,200,47.6604,1710
359950.0,3,1.0,1290,0,7,1290,0,47.3356,2370
1050000.0,3,3.0,3250,3,10,3250,0,47.5123,2820
353000.0,3,1.75,1260,0,6,1260,0,47.5501,1270
717550.0,3,3.5,2840,0,10,2840,0,47.7069,3040
450000.0,3,2.25,1960,0,8,1960,0,47.6642,1860
167500.0,3,1.0,760,0,5,760,0,47.5513,1020
550000.0,3,1.75,2240,0,8,2240,0,47.4638,2030
939000.0,4,2.25,2240,0,9,2240,0,47.5489,2440
700000.0,3,1.75,1820,2,8,1820,0,47.5068,2490
480000.0,4,3.5,3370,3,9,3370,0,47.4398,2790
501000.0,3,1.0,1160,0,8,1160,0,47.6718,1810
580000.0,3,2.25,1640,0,8,1320,320,47.6772,1770
527550.0,1,0.75,820,0,5,820,0,47.5316,1590
399000.0,4,2.5,2800,0,9,2800,0,47.3594,2750
240000.0,3,1.75,1780,0,6,1080,700,47.5105,1500
353000.0,4,2.75,2200,0,7,1410,790,47.3224,2240
335000.0,4,2.0,1480,0,6,740,740,47.55,1480
475000.0,3,3.0,2010,0,7,1860,150,47.5525,1370
660000.0,3,2.0,2880,0,7,2080,800,47.6805,1820
551000.0,3,1.0,940,0,6,940,0,47.6733,1700
249950.0,4,1.75,1620,0,7,1620,0,47.3808,1890
1150000.0,4,3.25,4400,0,11,4400,0,47.5927,3240
575000.0,3,1.75,1530,0,7,1410,120,47.5745,2040
1088890.0,4,2.75,3460,4,9,1780,1680,47.568,3200
515000.0,4,2.5,2890,0,7,2890,0,47.5447,2850
235000.0,3,1.5,1980,0,7,1980,0,47.4696,1510
796000.0,3,1.0,1980,0,8,1980,0,47.6429,1380
450000.0,2,1.5,1450,0,7,820,630,47.6911,1450
2050000.0,4,3.0,4280,4,11,2180,2100,47.5811,2490
270000.0,4,2.5,1810,0,7,1810,0,47.3531,1760
1705000.0,3,3.0,2490,4,10,2490,0,47.5596,2580
565000.0,3,1.0,1610,0,7,1610,0,47.5704,1680
680000.0,1,2.5,1820,0,7,1090,730,47.6529,1860
5570000.0,5,5.75,9200,0,13,6200,3000,47.6289,3560
864500.0,4,2.5,3520,0,10,3520,0,47.7437,3210
1150000.0,4,2.25,3740,0,9,1870,1870,47.7027,2610
335000.0,3,2.25,2150,0,7,2150,0,47.4605,2010
911000.0,4,3.25,3526,0,10,3526,0,47.567,3639
425000.0,2,1.0,1070,0,7,830,240,47.5736,1310
299950.0,3,1.0,1410,0,7,1410,0,47.4303,2000
864000.0,4,2.5,3190,0,10,3190,0,47.6216,3040
425000.0,2,1.0,1270,0,7,1270,0,47.6482,1770
374950.0,4,1.5,1970,0,7,1970,0,47.4612,1880
247000.0,3,2.25,1640,0,8,1180,460,47.3739,1930
475000.0,3,1.0,1600,0,8,1600,0,47.5507,1760
275000.0,3,2.5,3020,0,7,3020,0,47.3361,2710
355000.0,2,1.0,1350,0,6,1350,0,47.7617,2330
285000.0,4,1.75,1870,0,7,1070,800,47.3775,2100
1338750.0,3,2.75,2730,4,9,1940,790,47.4857,2630
325000.0,2,1.0,1100,0,7,620,480,47.7728,1790
1670000.0,5,3.5,4320,0,11,4320,0,47.644,4320
402000.0,3,2.5,2700,3,7,1350,1350,47.397,2470
1100000.0,3,3.0,3700,0,10,2170,1530,47.6956,2320
375000.0,4,1.75,2190,0,7,1250,940,47.7396,2190
396000.0,5,2.75,2840,0,7,1420,1420,47.7618,2210
320000.0,4,2.75,2610,0,8,1310,1300,47.4612,1900
610000.0,3,2.5,2630,0,8,2630,0,47.688,2330
249950.0,3,1.5,1090,0,7,1090,0,47.4553,1540
675000.0,4,3.5,3090,0,9,3090,0,47.3087,2400
448000.0,2,2.0,1670,0,6,860,810,47.5461,1300
819000.0,3,1.0,1300,0,7,1300,0,47.6345,2510
1250000.0,3,2.5,3670,4,10,2530,1140,47.7588,2920
225000.0,4,2.5,1700,0,8,1700,0,47.3582,1930
790000.0,2,3.0,2560,0,8,2560,0,47.6955,1620
685000.0,4,2.5,2770,0,8,2400,370,47.5536,2120
812000.0,3,3.25,3240,0,9,3240,0,47.6321,3420
705000.0,2,2.5,2300,0,8,2300,0,47.7196,2300
360000.0,4,3.0,2483,0,8,2483,0,47.3627,1943
344000.0,1,1.5,760,0,8,760,0,47.6715,1290
825000.0,4,1.5,2040,0,9,2040,0,47.6188,3150
476500.0,3,1.0,1200,0,7,950,250,47.6929,1550
379500.0,2,1.0,960,0,7,960,0,47.5314,1760
620000.0,3,1.75,2410,0,8,2410,0,47.7651,2110
477590.0,3,3.25,2260,0,8,1760,500,47.5053,1880
490000.0,3,1.0,1910,0,7,1010,900,47.697,1600
470000.0,3,1.5,1500,0,7,1140,360,47.679,1500
500000.0,3,2.25,1360,0,8,1140,220,47.6198,1620
370000.0,3,1.0,1320,0,7,1320,0,47.7367,1160
790000.0,2,1.5,1940,0,7,970,970,47.6371,1480
725000.0,4,2.5,2650,0,8,2650,0,47.6075,2230
840000.0,4,2.75,3040,0,9,2100,940,47.6245,1260
390000.0,3,1.0,1240,0,7,1240,0,47.4465,2220
507000.0,3,2.25,2210,0,7,1510,700,47.7574,1870
263500.0,3,1.75,1540,0,6,770,770,47.5305,1140
369000.0,3,2.5,1320,0,8,1270,50,47.5357,1320
500000.0,3,2.5,3040,0,9,3040,0,47.4472,3040
570000.0,2,1.0,910,0,7,910,0,47.6814,1810
284000.0,4,3.0,2040,0,8,1490,550,47.3275,1940
415000.0,2,1.0,980,0,7,980,0,47.687,1500
197500.0,3,1.0,980,0,6,980,0,47.5525,980
925000.0,4,3.75,4420,1,9,3420,1000,47.7211,2880
468000.0,3,2.0,1570,0,7,820,750,47.5565,1510
355000.0,3,1.0,1600,0,6,1080,520,47.7232,1340
639000.0,4,1.75,1830,0,7,930,900,47.6536,1540
720000.0,3,2.5,2820,0,11,2820,0,47.6396,2820
381000.0,3,1.75,1800,0,6,900,900,47.7505,1060
1050000.0,3,4.0,4380,0,11,4380,0,47.7167,3630
670000.0,3,3.0,2980,0,9,2980,0,47.5533,2710
400000.0,3,1.0,1690,0,7,1690,0,47.7099,1080
910000.0,4,3.5,4040,0,11,4040,0,47.7196,3770
294000.0,3,1.0,1250,0,6,1250,0,47.7254,1590
315001.0,3,1.75,1500,0,7,1500,0,47.4349,1770
360000.0,3,2.0,1630,0,7,1630,0,47.4898,1450
520000.0,3,2.0,1410,0,7,1410,0,47.6029,1750
474000.0,3,1.0,1140,0,6,770,370,47.6889,1340
702000.0,4,2.5,3280,0,7,3280,0,47.6802,2600
728000.0,4,3.5,3490,0,9,3490,0,47.4028,2400
308000.0,4,2.5,2020,0,8,2020,0,47.4318,2820
2000000.0,5,4.0,4580,4,10,4580,0,47.5682,2710
340000.0,3,2.5,2270,0,8,2270,0,47.2643,2160
306500.0,2,1.75,1310,0,6,1310,0,47.5231,1500
716000.0,3,2.0,1420,0,7,1420,0,47.6367,1250
950000.0,4,3.0,2980,0,10,2640,340,47.7154,2010
673200.0,5,3.0,4180,0,7,4180,0,47.6833,3425
564500.0,4,2.25,1950,0,7,1350,600,47.6909,1980
393000.0,4,1.75,1790,0,8,1790,0,47.5172,2000
425000.0,5,1.75,1400,0,5,1400,0,47.6499,1200
150000.0,3,1.0,1320,0,7,1320,0,47.4771,1120
327000.0,4,2.25,1620,0,8,1200,420,47.3394,1620
444900.0,4,2.5,3120,0,9,3120,0,47.3645,2980
305000.0,4,2.5,2100,0,8,2100,0,47.3045,2370
469000.0,3,3.25,1370,0,8,1370,0,47.6718,1800
525000.0,3,1.75,1520,0,8,1520,0,47.5569,2150
330000.0,3,2.5,2410,0,7,1630,780,47.3741,1530
618000.0,4,1.0,1260,0,7,1260,0,47.6644,1340
295500.0,4,2.5,2830,0,8,1690,1140,47.3088,2350
567035.0,3,2.0,2064,0,7,2064,0,47.4469,1640
518000.0,4,2.25,2640,0,8,1770,870,47.4688,2500
303000.0,2,1.0,1020,0,7,1020,0,47.4461,1520
300000.0,4,2.5,2200,0,7,2200,0,47.4042,2641
413107.0,3,1.5,1420,0,7,1420,0,47.601,2000
400000.0,3,1.0,1350,0,6,1350,0,47.682,1350
535000.0,3,1.0,1290,0,7,1290,0,47.5317,1560
555000.0,4,2.0,1680,0,7,840,840,47.6648,1680
312000.0,3,2.5,2280,0,8,2280,0,47.3861,2550
785200.0,3,2.25,1840,0,8,1540,300,47.6063,1800
749000.0,4,2.0,2040,2,7,1020,1020,47.6891,2040
285000.0,3,1.5,1490,0,7,1010,480,47.4973,1000
425000.0,4,2.5,2440,0,7,2440,0,47.5406,2440
360000.0,3,2.0,1930,0,8,1260,670,47.7675,1900
260000.0,3,1.0,1200,0,7,1200,0,47.5168,1230
369000.0,3,2.0,1550,0,7,1150,400,47.5299,1840
275000.0,4,2.5,2180,0,8,1620,560,47.3187,1950
407000.0,3,2.25,1430,0,8,1430,0,47.6916,1430
575000.0,2,1.75,1230,0,8,990,240,47.6839,1330
1236000.0,3,1.5,1670,3,8,1670,0,47.6411,2320
875000.0,2,2.5,2720,1,8,1700,1020,47.6384,2520
320000.0,4,1.5,2220,0,7,1270,950,47.5059,1800
810000.0,3,1.5,1520,0,7,1520,0,47.6158,3260
274000.0,3,1.75,1590,0,7,1090,500,47.3655,1590
239900.0,4,1.75,1480,0,7,1120,360,47.3732,1590
450000.0,4,1.5,1860,0,7,1080,780,47.7314,1530
263400.0,4,2.0,1360,0,6,960,400,47.2718,1930
265000.0,3,1.0,1360,0,6,1360,0,47.4973,1360
418000.0,4,3.0,2360,2,7,1460,900,47.512,2500
390000.0,3,2.0,2360,0,8,2360,0,47.7633,1600
430000.0,3,2.0,1860,0,7,930,930,47.5662,1000
1442500.0,3,2.25,2630,2,8,2630,0,47.6485,2640
297000.0,2,1.75,1280,0,7,1280,0,47.2631,2180
650000.0,4,2.25,2330,1,8,1600,730,47.7764,2220
195000.0,2,1.0,720,0,6,720,0,47.5054,1250
554000.0,3,3.5,3380,0,9,2700,680,47.4316,2250
550000.0,3,2.0,3650,0,7,3650,0,47.3627,1870
700000.0,3,1.75,1640,0,7,1640,0,47.6846,1760
300000.0,4,1.0,1730,0,5,1730,0,47.5163,1400
315000.0,2,1.0,1030,0,6,1030,0,47.7352,1310
603000.0,3,1.0,1790,0,7,1400,390,47.6627,1790
530000.0,2,1.0,840,2,7,840,0,47.6403,2000
397500.0,3,1.75,1300,0,7,1300,0,47.6991,1740
221000.0,3,1.0,1240,0,6,1240,0,47.4917,1240
466000.0,4,2.25,2170,0,7,1220,950,47.7354,1820
197500.0,3,1.0,1330,0,7,1330,0,47.2053,1710
280000.0,3,3.0,1390,0,7,1140,250,47.5325,1450
412000.0,2,1.5,1240,0,6,860,380,47.5752,1240
454000.0,2,1.0,880,0,7,880,0,47.5694,1240
540000.0,4,2.25,2540,0,8,1450,1090,47.719,1780
250000.0,5,1.5,2520,0,7,1510,1010,47.2058,1620
900000.0,5,2.25,2510,0,9,2510,0,47.6435,3160
245000.0,5,1.75,2020,0,7,1220,800,47.51,2220
290000.0,3,1.75,2060,0,7,1350,710,47.3569,1520
160000.0,2,1.0,930,0,6,930,0,47.507,2240
1260000.0,2,1.5,2700,4,8,1660,1040,47.5892,2970
325000.0,2,1.0,1060,0,7,940,120,47.7028,1540
185000.0,2,1.0,670,0,5,670,0,47.4521,1700
477000.0,3,2.0,1750,0,7,950,800,47.6667,1700
100000.0,2,1.0,930,0,6,930,0,47.467,1300
345000.0,4,2.5,2420,0,8,1370,1050,47.341,2290
530000.0,4,2.25,2410,1,7,1950,460,47.4278,2510
203000.0,3,1.0,1150,0,6,1150,0,47.4864,1210
599000.0,4,2.5,2480,0,7,2480,0,47.6811,2410
370000.0,4,1.0,1310,0,7,1310,0,47.5822,1630
140000.0,3,1.0,1240,0,6,1040,200,47.4204,1240
500000.0,3,1.0,1150,0,8,1150,0,47.5349,1440
527200.0,3,1.75,1460,2,7,730,730,47.5768,1360
549900.0,5,2.75,3060,0,8,1600,1460,47.5052,2190
760000.0,4,2.5,3520,0,9,3520,0,47.7065,2460
319000.0,2,1.0,960,0,7,960,0,47.5269,1520
362300.0,3,2.5,2430,0,8,2430,0,47.3805,2260
421000.0,3,2.5,1930,3,7,1440,490,47.3459,1550
690000.0,3,1.0,1090,0,7,1090,0,47.6846,1520
640000.0,3,2.5,2790,0,8,1650,1140,47.5241,1400
238000.0,4,1.75,1650,0,7,910,740,47.2802,1540
789000.0,3,3.0,3740,2,10,3740,0,47.4036,2930
1050000.0,6,4.0,5310,2,10,3600,1710,47.5696,4190
302500.0,3,2.5,1690,0,7,1690,0,47.3663,2250
259950.0,4,1.75,1400,0,7,1400,0,47.4658,1910
456000.0,3,1.5,1440,0,7,1440,0,47.5829,2080
369950.0,3,2.5,1360,0,7,1360,0,47.6827,1090
363750.0,3,1.75,1726,0,7,1726,0,47.3484,2114
585000.0,3,1.75,2220,2,8,2220,0,47.6624,2900
268000.0,3,2.5,1850,0,7,1850,0,47.3103,1700
1200000.0,5,2.5,2860,0,8,2160,700,47.6225,1340
345000.0,3,1.0,1120,0,6,920,200,47.5235,1350
539000.0,4,2.5,2340,0,9,2340,0,47.7672,1930
851000.0,5,3.25,3760,0,9,2550,1210,47.5654,2960
900000.0,3,2.5,1920,2,10,1780,140,47.5709,2080
850000.0,3,2.5,3230,2,8,2430,800,47.7011,1820
390000.0,3,1.75,1260,0,7,1260,0,47.6224,1500
345000.0,3,1.75,1540,0,7,920,620,47.7451,1130
534500.0,3,2.5,1700,0,8,1700,0,47.5505,1700
643500.0,6,5.25,3600,0,7,2400,1200,47.5656,1450
1206500.0,3,2.75,3150,0,8,2130,1020,47.6345,3160
495000.0,2,1.75,1280,0,7,730,550,47.5798,2250
535000.0,2,1.0,980,0,7,830,150,47.6815,1760
435000.0,4,2.5,2190,0,7,2190,0,47.5305,2190
305000.0,4,2.0,2470,0,7,1970,500,47.4645,1310
799000.0,4,2.5,2590,0,9,2590,0,47.6978,1700
700000.0,4,2.5,2580,0,9,2580,0,47.6895,3030
467000.0,3,2.25,1270,0,8,1040,230,47.6736,1410
263000.0,3,1.0,1250,0,6,1250,0,47.4493,1270
760000.0,4,2.5,4660,0,9,3020,1640,47.5352,3300
293000.0,4,2.5,2019,3,8,2019,0,47.1958,1950
245000.0,3,2.0,1490,0,7,1490,0,47.2875,1650
181000.0,2,1.5,1560,0,7,1560,0,47.4444,1660
240000.0,3,1.0,1030,0,7,1030,0,47.5016,1430
880000.0,4,2.75,2560,2,8,1450,1110,47.6499,2500
285000.0,3,2.0,1460,0,7,1460,0,47.3679,1600
407500.0,2,1.0,770,0,7,770,0,47.7223,1670
325000.0,4,2.5,1960,0,7,1960,0,47.4849,2420
405000.0,3,1.75,1900,0,7,1390,510,47.7748,2000
291700.0,3,2.5,1970,0,6,1230,740,47.5328,1470
370000.0,3,2.5,2490,3,8,2490,0,47.2119,1850
270000.0,3,1.5,1430,0,6,1430,0,47.4759,1560
800000.0,4,2.5,2680,0,8,1380,1300,47.6835,1950
626500.0,3,1.75,1610,0,7,910,700,47.6656,1420
1130000.0,4,3.5,4300,1,11,3580,720,47.5396,2770
399950.0,4,2.5,3200,0,7,3200,0,47.3666,2840
419000.0,3,1.75,2140,0,7,1570,570,47.4181,2170
1160000.0,4,2.5,4240,0,10,4240,0,47.6008,3720
1405000.0,4,3.5,3410,0,10,3410,0,47.6081,2650
710000.0,4,2.75,2090,0,7,2090,0,47.6829,1460
650000.0,3,1.0,1410,2,6,1230,180,47.6646,1410
369900.0,4,2.5,2820,0,9,2820,0,47.7387,2510
641000.0,4,2.5,2770,0,9,2770,0,47.6622,2770
403000.0,3,1.0,1400,0,7,1400,0,47.7508,1950
1015000.0,3,3.25,3620,0,10,2730,890,47.6393,1910
865000.0,4,2.5,2260,0,8,1770,490,47.5436,2630
2485000.0,4,2.5,3440,3,10,2260,1180,47.5636,4230
810000.0,4,1.0,2150,3,8,1850,300,47.5767,1950
316750.0,3,2.5,1256,0,7,1256,0,47.7146,1309
652500.0,4,2.25,2220,0,8,2220,0,47.4989,2680
360000.0,6,2.75,2850,0,7,1850,1000,47.5288,2090
208000.0,2,1.0,700,0,5,700,0,47.4957,970
898000.0,4,2.5,3700,0,10,3700,0,47.7319,3210
295000.0,4,1.75,1400,0,7,1050,350,47.7346,2080
652500.0,4,1.75,3130,0,7,3130,0,47.7402,1850
560000.0,4,3.0,2170,0,8,2170,0,47.5673,2010
280000.0,3,1.0,1020,0,7,1020,0,47.4905,1690
289950.0,3,2.5,1760,0,7,1760,0,47.4612,2160
397500.0,3,2.5,1860,0,7,1860,0,47.4381,1900
380000.0,2,1.0,1140,0,7,1140,0,47.7349,2570
415900.0,3,2.5,1670,0,7,1310,360,47.4708,1510
475000.0,2,1.75,1710,0,7,1510,200,47.7005,1280
125000.0,1,1.0,500,0,5,500,0,47.5252,1350
238000.0,3,1.0,1470,0,7,1020,450,47.3811,2640
296000.0,4,1.5,1370,0,7,1070,300,47.4718,1540
475000.0,6,3.0,3470,0,7,3470,0,47.7663,2120
390000.0,3,2.25,1650,0,7,1650,0,47.5639,2060
425000.0,3,1.0,1180,0,6,1030,150,47.5726,1280
725000.0,6,3.0,3110,0,7,1810,1300,47.6631,1600
605000.0,3,2.25,2080,0,8,1530,550,47.6315,2320
302000.0,3,1.0,1600,0,7,1600,0,47.6028,1310
886000.0,3,2.25,2380,0,9,1650,730,47.6472,2000
540000.0,4,1.75,1630,0,7,980,650,47.6821,1630
435000.0,4,2.25,1910,0,7,1910,0,47.7352,1910
409000.0,4,3.25,3140,0,7,2300,840,47.5022,1300
405000.0,3,1.0,1250,0,7,1250,0,47.6986,1690
560200.0,3,2.5,1990,0,8,1990,0,47.5914,2320
324000.0,4,1.75,2110,0,8,1170,940,47.4464,1820
390000.0,4,2.5,2490,0,9,2490,0,47.3305,2690
414000.0,2,1.0,800,0,6,800,0,47.4914,1220
441500.0,3,2.5,2360,0,7,2360,0,47.537,2420
375000.0,3,2.5,1770,0,7,1770,0,47.5263,1230
668500.0,4,2.5,2710,0,9,2710,0,47.6027,2710
540000.0,5,1.5,1940,0,7,1940,0,47.7213,1900
1035000.0,4,3.25,3450,3,10,2430,1020,47.4556,2412
1345000.0,4,3.25,3440,4,10,2520,920,47.5727,2350
758000.0,4,2.75,2410,0,7,1780,630,47.6503,2090
949880.0,4,2.25,2290,0,9,2290,0,47.5878,2290
570000.0,3,1.0,1030,0,7,1030,0,47.574,1440
736000.0,4,2.5,2290,0,9,2290,0,47.5599,3130
670000.0,3,1.5,1490,0,7,1490,0,47.6113,1560
1130000.0,4,1.75,2370,0,9,1270,1100,47.6716,2370
650000.0,4,2.0,1930,0,8,1930,0,47.6117,1470
690000.0,2,1.75,1600,0,7,850,750,47.6408,1860
610000.0,4,2.25,2240,0,7,2240,0,47.687,3180
413500.0,2,1.0,770,0,5,770,0,47.6959,1420
765000.0,3,2.5,2300,2,8,2300,0,47.5825,2640
828200.0,4,2.75,3400,0,9,3400,0,47.5661,3060
205000.0,2,1.0,900,0,6,900,0,47.4851,1430
465000.0,3,2.5,1450,0,8,1030,420,47.7082,1740
556000.0,4,2.5,2240,0,8,2240,0,47.772,2240
540000.0,4,2.5,1780,0,8,1780,0,47.5695,1830
423000.0,4,2.5,2320,0,8,2320,0,47.48,2330
375000.0,3,1.75,1590,0,8,1590,0,47.5902,2040
173250.0,3,1.0,990,0,7,990,0,47.4776,1260
599900.0,3,1.5,2605,0,8,1355,1250,47.7725,1590
646000.0,5,2.75,2870,0,7,1650,1220,47.675,1890
1075000.0,5,4.75,5180,2,11,4070,1110,47.5405,3960
558000.0,4,2.0,2180,0,7,1020,1160,47.6089,1520
354000.0,2,1.0,850,0,7,850,0,47.5311,1230
1195000.0,4,4.0,4050,0,11,3360,690,47.5769,3330
670000.0,4,2.0,2250,0,7,1650,600,47.6136,1200
1125000.0,6,4.25,3100,2,11,3100,0,47.6381,3270
267500.0,2,1.0,1747,0,6,1747,0,47.3282,1620
299800.0,4,2.5,2410,0,8,2410,0,47.3229,2517
430000.0,4,1.75,2070,0,7,1250,820,47.6045,1650
775000.0,5,1.0,1860,0,7,1530,330,47.6559,1910
333000.0,3,1.0,950,0,7,830,120,47.5362,1490
336000.0,3,2.0,1060,0,6,1060,0,47.7333,1500
323000.0,2,1.0,880,0,7,880,0,47.6475,1360
575000.0,4,2.5,2550,0,9,2550,0,47.4913,1870
328000.0,2,2.25,1550,0,8,1550,0,47.54,1420
572500.0,3,1.0,1590,0,7,1290,300,47.6807,1770
600000.0,3,1.75,1650,0,7,1040,610,47.6873,1540
412000.0,4,3.0,2430,0,8,2430,0,47.3533,2430
827500.0,3,2.5,1810,0,7,1310,500,47.6885,2050
300000.0,4,2.5,2890,0,8,2890,0,47.2822,2330
415000.0,3,2.5,1280,0,7,1280,0,47.5611,1500
750000.0,7,2.75,3410,0,8,2130,1280,47.6454,2510
800000.0,3,2.75,2220,0,8,1700,520,47.617,1800
420000.0,3,1.0,1060,0,8,1060,0,47.5427,1240
266000.0,3,1.5,1120,0,7,1120,0,47.4905,1320
499000.0,4,2.5,2680,0,8,2680,0,47.7377,2330
440000.0,4,1.5,1770,0,7,1770,0,47.5621,970
495000.0,3,2.0,2950,0,7,2310,640,47.4702,2320
630000.0,2,1.75,1260,0,7,840,420,47.6809,1280
424000.0,3,1.75,1430,0,7,1430,0,47.7271,1480
760000.0,4,2.5,2730,0,9,2730,0,47.7036,2710
650000.0,4,3.5,3270,0,9,2110,1160,47.6256,3020
248500.0,4,1.75,1720,0,7,1720,0,47.3614,1220
379600.0,3,1.75,1270,0,7,1270,0,47.5387,1560
538000.0,4,2.5,3260,0,8,1960,1300,47.7203,1802
530000.0,4,2.5,2050,0,8,2050,0,47.5641,2070
545000.0,4,2.25,2050,0,8,2050,0,47.5911,2310
925000.0,4,3.0,3580,0,10,3580,0,47.7577,3540
565000.0,4,2.75,1960,0,9,1960,0,47.7484,1970
405100.0,2,1.0,840,0,6,840,0,47.6575,1390
502000.0,3,1.75,1300,0,8,1300,0,47.6199,1350
425000.0,3,2.25,1260,0,7,1260,0,47.5454,1630
233500.0,3,2.25,1650,0,7,1650,0,47.3916,1510
287000.0,3,2.5,1710,2,7,1710,0,47.3494,1830
190000.0,3,1.0,1180,0,7,1180,0,47.2848,1300
666000.0,3,2.25,2780,0,8,2780,0,47.67,2890
330000.0,2,1.0,950,0,6,950,0,47.551,1230
1490000.0,5,3.5,3620,2,10,2790,830,47.5738,2690
393000.0,3,2.25,2140,0,8,2140,0,47.3751,2040
353000.0,4,2.75,1920,0,8,1010,910,47.5003,1910
260000.0,2,1.0,750,0,6,750,0,47.552,920
680000.0,3,2.5,2060,0,8,1900,160,47.5881,2060
921000.0,3,2.25,2380,0,8,2380,0,47.5873,2010
319000.0,2,1.0,750,0,7,750,0,47.7033,1690
280000.0,3,1.0,1160,0,7,920,240,47.6339,1280
220000.0,3,1.0,1050,0,6,1050,0,47.5128,740
219000.0,3,1.5,1740,0,7,1060,680,47.3657,1540
528000.0,4,2.75,2050,0,8,1540,510,47.6194,1960
405000.0,3,1.75,1980,0,7,1310,670,47.7353,1450
372977.0,3,2.5,1690,0,8,1150,540,47.5518,1690
934550.0,4,3.25,2320,2,9,2320,0,47.597,2320
1465000.0,3,1.5,2480,3,10,2130,350,47.7018,2860
975000.0,4,2.25,2290,0,9,2120,170,47.6428,2910
800866.0,5,2.5,3180,0,10,3180,0,47.652,3180
950000.0,7,3.5,3470,0,9,3470,0,47.6203,3040
624000.0,4,3.0,1540,0,7,1540,0,47.6728,1460
1850000.0,5,2.25,2800,4,9,2800,0,47.5784,3220
310000.0,3,1.0,1050,0,7,1050,0,47.7635,1760
315000.0,3,1.75,1480,0,7,1480,0,47.4633,1500
675000.0,3,2.0,1010,0,6,1010,0,47.6652,1920
490000.0,3,1.75,1660,0,8,1660,0,47.5919,2210
600000.0,5,2.25,2760,0,7,1380,1380,47.5561,2060
154000.0,2,1.0,1040,3,6,1040,0,47.6981,1880
480000.0,4,1.75,2220,3,8,2220,0,47.4519,2430
196900.0,3,1.0,1270,0,6,1270,0,47.4214,1250
735000.0,3,3.25,2960,0,10,2960,0,47.7452,2960
205500.0,3,2.0,1330,0,7,1330,0,47.2619,1510
357186.0,2,1.75,1210,0,8,1210,0,47.5519,1210
275000.0,4,2.5,2120,0,7,2120,0,47.3629,2120
248500.0,3,1.75,2090,0,7,2090,0,47.3095,1700
350000.0,3,2.5,2680,0,8,2680,0,47.3203,2340
390000.0,4,2.75,1790,0,7,1220,570,47.5302,1250
390000.0,3,2.75,1950,0,7,1250,700,47.7401,1880
660000.0,5,2.25,3740,0,9,3740,0,47.6234,2180
310000.0,3,1.75,1140,0,7,1140,0,47.7407,1140
717000.0,3,2.5,2480,0,9,2480,0,47.684,2480
260000.0,5,2.5,2580,0,7,1410,1170,47.397,2240
745000.0,3,2.0,2290,0,7,1490,800,47.6909,1230
470000.0,4,2.5,2320,0,7,1320,1000,47.763,2160
429000.0,3,2.5,2530,0,8,2530,0,47.42,2340
220000.0,4,2.0,1400,0,7,1400,0,47.7719,1610
497000.0,3,3.0,2060,0,8,1400,660,47.6543,1910
716100.0,3,1.0,1640,0,7,1640,0,47.6563,2140
371000.0,4,1.0,1960,0,6,1960,0,47.5418,2430
379000.0,5,2.75,3000,0,7,1500,1500,47.497,2170
937500.0,3,1.0,1320,0,7,1320,0,47.6187,2790
720000.0,4,2.0,1760,0,7,1760,0,47.6711,1740
616000.0,3,3.25,2130,1,7,1420,710,47.5424,1560
259000.0,3,2.0,1390,0,7,1390,0,47.3786,1530
538000.0,3,1.75,1400,0,6,1100,300,47.6793,1720
605000.0,3,2.75,3230,0,8,3230,0,47.7307,2820
369950.0,3,1.0,1110,0,7,1110,0,47.7262,1260
310000.0,3,2.5,1670,0,7,1670,0,47.3834,1670
227500.0,3,1.0,1540,0,7,1540,0,47.3612,1210
274000.0,4,2.25,2090,0,9,1670,420,47.3178,2260
410000.0,3,2.0,1410,0,7,1410,0,47.7303,1770
354800.0,3,2.0,1370,0,7,1370,0,47.3867,1620
650000.0,4,2.25,1910,0,8,1300,610,47.6534,1810
353000.0,3,2.0,1678,0,7,1678,0,47.3744,1550
224975.0,3,1.0,960,0,6,960,0,47.3617,1160
600000.0,2,1.75,2080,1,7,2080,0,47.7435,2440
437500.0,3,2.25,1790,0,7,1340,450,47.7205,1610
567000.0,3,2.5,2540,0,9,2540,0,47.7042,2540
225000.0,5,1.5,1790,0,7,1790,0,47.3961,2040
255000.0,2,1.0,940,0,6,940,0,47.5445,1900
2479000.0,5,3.75,6810,0,13,6110,700,47.6285,2660
370000.0,2,1.0,900,0,6,900,0,47.6918,1060
675000.0,4,1.75,1900,0,8,1140,760,47.6579,2280
285000.0,3,1.0,1440,0,7,1040,400,47.5468,1370
310000.0,3,1.75,2070,0,7,1420,650,47.425,2011
475000.0,4,2.5,2240,0,7,1140,1100,47.7161,1740
410000.0,4,2.5,3320,0,7,3320,0,47.4011,2580
895000.0,4,2.25,1950,0,8,1330,620,47.639,2600
375000.0,3,1.5,1240,0,6,790,450,47.714,1130
349000.0,4,2.5,1830,0,7,1830,0,47.3573,1830
650500.0,3,1.75,1740,0,8,1740,0,47.6115,1740
760000.0,3,1.75,1410,0,7,1410,0,47.5974,1880
480000.0,4,2.75,2050,0,7,1180,870,47.5808,1440
689000.0,4,2.75,3220,0,10,3220,0,47.5786,3200
415000.0,3,1.75,1960,0,6,980,980,47.5576,1790
195000.0,3,1.75,1070,0,7,1070,0,47.3249,1350
318000.0,5,2.5,2820,0,7,1410,1410,47.4715,2700
404000.0,4,3.0,4060,0,9,2030,2030,47.3059,2950
339950.0,2,1.0,800,0,6,800,0,47.5518,1400
215000.0,3,1.0,1260,0,7,1260,0,47.1946,1560
339900.0,3,2.5,2420,0,8,2420,0,47.3199,2260
285000.0,1,1.5,810,0,7,810,0,47.6939,1320
550000.0,3,1.0,1600,0,7,1110,490,47.655,1380
430000.0,4,1.0,1350,0,7,1350,0,47.6953,1940
219000.0,3,1.0,970,0,6,970,0,47.3165,1150
555000.0,2,1.5,1780,0,7,1080,700,47.6859,1690
233000.0,3,2.0,1350,0,7,1350,0,47.3609,1470
248000.0,3,1.75,1840,0,8,1270,570,47.3364,1910
454000.0,5,2.25,2550,0,8,1580,970,47.4673,2090
950000.0,4,2.5,1700,0,8,1700,0,47.6434,2090
359000.0,3,2.5,2430,0,8,1730,700,47.4546,2160
407500.0,5,2.0,2740,0,7,2210,530,47.7352,2130
224000.0,3,1.5,1560,0,7,1040,520,47.3427,1460
210000.0,2,1.0,1040,0,7,1040,0,47.5078,1040
261000.0,4,1.75,1820,0,7,1820,0,47.3833,1410
719000.0,3,3.0,1833,0,9,1833,0,47.6827,1466
440000.0,3,2.5,2160,0,8,2160,0,47.5661,1500
525000.0,3,2.75,2100,0,9,1510,590,47.4347,2240
375000.0,3,1.5,1370,0,7,1370,0,47.7302,1510
428000.0,2,2.5,1414,0,8,1414,0,47.5423,1414
988830.0,5,3.25,4115,0,9,4115,0,47.6847,3950
199950.0,3,1.75,1550,0,7,1550,0,47.3098,1760
840000.0,4,2.25,2100,0,8,1750,350,47.6359,1800
285000.0,3,1.75,1160,0,7,1160,0,47.1937,1670
330000.0,5,2.5,3597,0,7,3597,0,47.3002,3193
147500.0,3,1.5,1230,0,7,1230,0,47.397,1970
320000.0,4,2.5,2190,0,8,2190,0,47.3709,2190
382500.0,3,1.75,1040,0,7,1040,0,47.5253,1750
2048000.0,5,4.0,4690,0,9,3040,1650,47.6321,3300
596000.0,4,2.25,2270,0,8,1720,550,47.5599,2270
220000.0,4,2.25,1950,0,8,1950,0,47.2957,1910
325000.0,3,2.5,1880,0,8,1880,0,47.4206,1970
679950.0,4,2.5,2850,0,9,2850,0,47.5835,2850
175000.0,2,1.0,1160,0,7,1160,0,47.7149,1120
268000.0,3,1.75,1370,1,7,1370,0,47.3338,1720
715000.0,4,3.5,3260,0,10,3260,0,47.6436,3470
600000.0,7,2.25,3170,0,8,3170,0,47.4654,2460
228000.0,0,1.0,390,0,4,390,0,47.526,2170
950000.0,5,2.5,3450,0,11,3450,0,47.7173,3450
475000.0,2,1.75,1490,2,8,1490,0,47.2645,2350
700000.0,3,1.5,1460,0,7,1460,0,47.59,3320
275000.0,3,1.75,1300,0,7,1300,0,47.5587,1930
369500.0,3,1.75,1300,0,7,1300,0,47.5587,1930
215000.0,4,2.0,1540,0,7,1040,500,47.3664,1720
593450.0,4,2.25,2130,0,8,2130,0,47.6271,1910
498800.0,2,1.75,1350,0,8,1350,0,47.7091,1680
849000.0,5,3.25,2450,0,8,1770,680,47.688,1620
1151250.0,4,2.5,1940,0,9,1940,0,47.6427,1790
825000.0,5,2.5,2890,2,9,2890,0,47.5453,3010
265000.0,3,1.75,1680,0,8,1340,340,47.4631,1730
285000.0,4,2.25,1960,0,8,1220,740,47.3199,1650
240000.0,3,1.75,1590,0,7,1190,400,47.3628,1680
261000.0,4,1.0,1390,0,7,1390,0,47.3457,1230
330000.0,4,1.75,2440,0,8,1610,830,47.3743,2180
250000.0,4,2.0,1850,0,7,1540,310,47.3666,1620
350000.0,4,2.5,2800,0,8,2800,0,47.2675,1970
930000.0,3,2.5,3780,0,10,3780,0,47.7499,3450
275000.0,3,2.0,1910,0,7,1000,910,47.37,1780
325000.0,4,2.25,2460,0,7,1230,1230,47.5285,2090
255000.0,1,1.0,810,1,7,590,220,47.5696,1920
562200.0,3,1.5,1900,0,7,1500,400,47.6991,1810
952000.0,2,1.75,3490,3,10,2320,1170,47.5462,3490
365000.0,3,2.5,2200,0,8,1570,630,47.4395,2350
332900.0,3,1.5,1190,0,7,1190,0,47.7561,1190
721000.0,3,2.25,2040,0,8,2040,0,47.6976,2590
487275.0,4,2.5,2400,0,8,2400,0,47.5344,2070
310000.0,3,2.5,1670,0,7,1670,0,47.4424,1610
245000.0,2,1.0,990,0,6,990,0,47.5615,1700
325000.0,3,1.75,2920,0,7,2920,0,47.4429,1560
550000.0,3,1.75,1840,0,8,1840,0,47.5847,2850
350000.0,2,1.0,910,0,7,910,0,47.5633,1270
599000.0,5,2.5,2950,0,8,2950,0,47.4186,1480
259950.0,3,1.5,1240,0,7,1240,0,47.4756,1845
240000.0,4,2.5,1980,0,7,1980,0,47.3678,1600
186000.0,3,1.0,1200,0,7,1200,0,47.3261,1230
395000.0,3,1.5,1280,0,7,1280,0,47.6304,1470
475000.0,4,2.5,3150,0,9,3150,0,47.4568,3100
815000.0,5,3.5,3500,0,10,3500,0,47.5887,3110
572000.0,3,1.5,1680,0,7,1680,0,47.5716,1760
419500.0,3,2.5,1360,0,7,1360,0,47.6831,1090
298700.0,3,2.25,2110,0,8,1530,580,47.3088,2640
549000.0,2,1.0,2034,4,7,1159,875,47.3312,1156
278000.0,3,1.5,1900,0,7,1120,780,47.4729,1900
455000.0,4,2.0,2380,0,6,1470,910,47.5652,1300
925000.0,5,3.5,4050,2,9,2230,1820,47.4384,3210
465000.0,2,1.5,1120,0,8,1120,0,47.6524,1370
620000.0,4,4.0,2850,0,8,2120,730,47.547,2380
499900.0,4,2.25,2360,0,8,1640,720,47.75,2320
620000.0,5,3.0,2540,0,8,1270,1270,47.5459,2090
450000.0,3,1.75,1160,0,7,1040,120,47.6926,1530
690000.0,4,3.5,2710,0,10,2220,490,47.5468,2650
1895000.0,5,2.25,3120,0,9,3120,0,47.6458,3740
1940000.0,5,2.25,3120,0,9,3120,0,47.6458,3740
832500.0,3,2.0,1870,0,7,1870,0,47.5777,1970
245000.0,3,1.0,1010,0,7,1010,0,47.4396,1010
820000.0,3,2.5,2980,0,11,2980,0,47.7133,3670
369000.0,4,2.75,2420,0,8,2420,0,47.3771,2420
1050000.0,4,3.25,3830,0,9,3830,0,47.6906,4080
653000.0,3,3.0,3040,2,10,3040,0,47.5409,1820
220650.0,2,1.75,1460,0,7,1460,0,47.4461,1340
300000.0,5,3.0,1940,0,8,1200,740,47.498,1940
970000.0,4,3.5,3780,2,10,3780,0,47.5491,2150
360000.0,4,2.5,1950,0,7,1950,0,47.4341,2240
672500.0,3,2.5,2450,0,9,2450,0,47.6145,2450
268000.0,4,1.5,1730,0,5,1730,0,47.4939,1110
440000.0,4,1.5,1690,0,8,1690,0,47.5445,1380
1400000.0,3,2.5,2550,2,10,2550,0,47.5996,2030
590000.0,4,2.5,2290,0,9,2290,0,47.6283,2340
359000.0,4,2.25,2710,0,7,1850,860,47.3207,1700
266500.0,4,1.75,1880,0,7,1180,700,47.3068,1840
635000.0,4,2.5,2930,0,8,2930,0,47.5164,2030
559000.0,3,2.5,3110,0,9,3110,0,47.3281,2220
895000.0,4,2.5,3480,0,10,3480,0,47.6895,3630
625000.0,2,1.5,1110,0,7,1110,0,47.7467,2970
650000.0,4,2.25,2440,0,7,1880,560,47.5933,1530
312500.0,4,1.75,2280,0,7,1280,1000,47.4809,2120
225000.0,3,1.0,900,0,6,790,110,47.4807,1240
425000.0,4,1.75,1980,0,7,1330,650,47.6721,1920
329999.0,3,2.75,3360,0,7,1820,1540,47.2604,2580
572000.0,5,2.25,2340,0,8,2340,0,47.6369,2140
386500.0,4,2.5,3110,0,8,3110,0,47.3782,3110
452000.0,2,1.0,980,0,6,980,0,47.6744,1270
278000.0,4,2.0,1480,0,7,1480,0,47.6147,1480
474900.0,3,2.25,1800,0,8,1800,0,47.7757,2480
450000.0,2,1.75,2130,0,8,1500,630,47.6529,2130
611000.0,2,1.0,1270,0,7,1100,170,47.6771,1670
214100.0,2,2.5,1150,0,7,1150,0,47.3516,1880
317000.0,3,2.5,1840,0,8,1840,0,47.3555,2000
1000000.0,4,3.5,3180,1,9,2060,1120,47.7058,2850
1000000.0,5,2.75,1510,1,7,1510,0,47.6653,2190
525000.0,4,2.5,3070,0,8,3070,0,47.4899,2590
436000.0,3,2.25,1800,0,8,1800,0,47.7293,1630
450000.0,3,1.75,1540,0,8,1540,0,47.6207,1990
588500.0,3,1.75,2330,0,8,1970,360,47.6267,2570
340000.0,4,1.75,1400,0,7,1400,0,47.4735,1420
482000.0,4,2.5,2846,0,8,1976,870,47.317,1696
1575000.0,4,3.5,5830,0,11,5830,0,47.5986,5340
749000.0,3,2.5,3380,0,8,3380,0,47.6276,1810
330000.0,3,1.5,1440,0,8,1440,0,47.4561,1800
568000.0,3,2.5,1740,0,8,1740,0,47.5891,1740
239000.0,3,1.75,1470,0,7,1470,0,47.2026,1430
528000.0,3,2.5,2810,0,8,2810,0,47.7739,2470
385000.0,4,3.0,2090,0,7,1350,740,47.5427,2090
825000.0,4,3.25,4110,2,10,2570,1540,47.7382,2760
815000.0,5,3.25,3230,1,9,2350,880,47.5202,1520
625000.0,4,2.5,2601,0,9,2601,0,47.742,2080
690000.0,3,1.75,2070,3,8,1340,730,47.5226,2200
210000.0,3,1.0,1660,0,7,1270,390,47.5242,1540
599000.0,4,1.0,1590,0,7,1590,0,47.667,2230
860000.0,3,1.75,1860,0,8,1310,550,47.637,1630
147200.0,3,1.0,1420,0,6,1420,0,47.4232,1400
476900.0,3,1.0,1240,0,6,960,280,47.5675,1460
450000.0,4,2.5,2500,0,8,1590,910,47.4685,2360
570000.0,4,2.5,2640,0,8,2640,0,47.733,2400
567500.0,3,1.0,1440,0,7,1440,0,47.6769,1440
790000.0,5,3.25,3030,2,9,2130,900,47.6133,2890
875000.0,3,1.5,1820,0,7,1820,0,47.5886,3020
490000.0,3,2.0,2220,0,9,1640,580,47.5304,2300
335000.0,3,1.75,2430,0,7,1410,1020,47.5116,1980
550000.0,3,1.75,1670,0,8,1670,0,47.549,2290
385000.0,3,1.75,1180,0,7,940,240,47.6348,1230
395000.0,3,1.75,1620,0,7,1210,410,47.7349,1700
650000.0,2,1.0,1030,0,8,1030,0,47.5861,1570
637000.0,4,2.75,2900,0,9,2900,0,47.7368,2900
692500.0,3,2.25,3420,0,9,1710,1710,47.7412,2290
322400.0,3,1.75,1710,0,8,1710,0,47.4706,1990
233500.0,3,1.5,1580,0,6,1580,0,47.2903,1400
400000.0,3,2.0,1230,0,7,990,240,47.6321,1570
547000.0,5,2.5,2200,0,7,1420,780,47.6872,1300
519000.0,5,2.25,2570,1,8,1470,1100,47.4487,2570
1025000.0,4,3.5,3320,2,10,2040,1280,47.527,3240
365000.0,3,1.0,1090,0,7,1090,0,47.5334,1340
699000.0,5,2.75,2970,0,8,2970,0,47.7731,2730
525000.0,3,1.75,1970,0,8,1970,0,47.6324,1910
430000.0,4,3.0,3220,0,9,2450,770,47.4208,2810
325000.0,3,1.0,1600,0,7,1600,0,47.7198,2050
279000.0,2,1.0,670,0,6,670,0,47.5161,760
805000.0,4,1.75,2360,0,7,1660,700,47.6729,1810
419950.0,3,3.0,2150,0,7,1540,610,47.7183,1730
425000.0,2,1.0,620,0,6,620,0,47.6877,1180
446000.0,4,1.75,1730,0,7,1730,0,47.7188,1700
455000.0,5,2.0,2500,0,7,1040,1460,47.7212,2060
226550.0,3,1.0,990,0,6,990,0,47.522,990
764000.0,3,2.0,1420,0,8,1420,0,47.6801,1220
439950.0,3,2.25,2170,0,8,2170,0,47.3863,2430
453000.0,4,2.0,1880,0,8,1880,0,47.6872,1610
219950.0,3,1.0,1300,0,7,1300,0,47.282,1420
702500.0,3,1.5,2360,0,7,1930,430,47.6923,1320
285000.0,3,1.5,1780,0,8,1780,0,47.335,2460
798750.0,2,2.25,2160,0,8,2160,0,47.6607,1800
320000.0,2,1.0,950,2,7,950,0,47.57,1620
425000.0,3,1.75,1680,0,8,1680,0,47.5272,1920
540000.0,4,2.5,2290,0,9,2290,0,47.7385,2570
1060000.0,4,5.25,4140,2,11,4140,0,47.5871,4440
1165000.0,4,3.75,3920,0,8,3920,0,47.6805,2040
576000.0,3,1.75,1500,0,7,1500,0,47.5866,2020
525000.0,3,1.75,1720,0,7,1140,580,47.6977,1700
324950.0,4,2.5,2641,0,7,2641,0,47.4038,2641
600000.0,3,2.5,4930,0,9,3930,1000,47.7634,2760
464000.0,3,2.5,2460,0,8,1520,940,47.5231,1745
266000.0,4,2.25,1995,0,8,1995,0,47.2986,1880
775000.0,3,2.5,3010,0,10,3010,0,47.6442,3240
415000.0,3,1.75,1270,0,7,1270,0,47.5362,1220
550000.0,4,2.75,3080,3,9,3080,0,47.4522,3080
235000.0,3,2.25,1670,0,7,1670,0,47.1949,1670
280000.0,3,2.0,1470,0,7,1470,0,47.3878,1530
459000.0,3,1.75,1730,0,7,1260,470,47.7211,1800
195000.0,3,1.0,1070,0,7,1070,0,47.3189,1240
235000.0,3,1.5,1660,0,7,1080,580,47.3117,1500
711800.0,4,2.25,2410,0,8,2410,0,47.5706,2720
440000.0,3,2.5,1040,0,7,1040,0,47.6673,1290
515000.0,2,1.0,970,0,7,970,0,47.6609,1060
1200000.0,5,2.75,2910,0,8,2910,0,47.6552,2940
560000.0,3,1.75,2340,0,8,2340,0,47.5432,1970
340000.0,3,1.75,1880,0,7,1330,550,47.3295,1870
600000.0,2,1.0,1110,0,6,970,140,47.6453,1884
764000.0,4,2.5,2790,0,9,2790,0,47.6223,2780
337000.0,4,2.0,1590,0,8,1590,0,47.7408,2090
1385000.0,6,2.75,5700,4,10,2850,2850,47.5601,3690
249000.0,4,1.0,1200,0,6,1060,140,47.5317,1580
350000.0,3,3.0,3200,0,8,2360,840,47.4121,3090
269950.0,3,2.25,1510,0,7,1150,360,47.3484,1510
735000.0,3,1.75,1880,0,7,1880,0,47.5913,2730
1295000.0,4,2.5,3070,0,8,2070,1000,47.659,2560
475000.0,4,2.25,2110,0,8,2110,0,47.7331,2110
339000.0,3,2.0,2350,0,9,2350,0,47.3043,2430
600000.0,4,3.5,3270,2,8,1660,1610,47.7437,2790
397500.0,4,1.75,2220,0,7,1320,900,47.5215,940
1525000.0,4,3.5,5990,0,11,5990,0,47.667,4690
460000.0,3,2.0,1760,0,7,1760,0,47.6534,2010
370000.0,4,2.75,2200,0,7,1120,1080,47.74,1210
250000.0,4,1.0,1550,0,6,1550,0,47.5184,1370
1100000.0,4,3.75,5070,0,11,5070,0,47.6567,4920
430000.0,2,2.25,1040,0,8,1040,0,47.6037,1560
1085000.0,3,1.5,2560,0,8,1660,900,47.6384,2560
670000.0,3,1.75,1850,0,8,1850,0,47.7241,1600
461550.0,3,1.5,2090,0,7,1790,300,47.5362,2180
479990.0,3,2.5,2010,0,8,1390,620,47.5525,1690
643000.0,4,2.5,2518,0,8,2518,0,47.5894,2280
607000.0,3,2.75,2810,0,8,2040,770,47.6796,1890
625000.0,3,2.5,2600,0,9,2600,0,47.6223,2440
731100.0,3,2.5,2060,0,8,1160,900,47.5245,1990
859000.0,3,2.5,2920,3,8,2920,0,47.3809,3150
435000.0,4,2.5,2130,0,8,2130,0,47.4381,2220
465000.0,3,3.0,2290,0,8,1420,870,47.3558,1890
740000.0,3,1.0,1230,0,7,1230,0,47.6947,1250
740000.0,3,1.75,2020,0,9,2020,0,47.5383,3050
250000.0,3,2.0,1430,0,7,990,440,47.3742,1430
656000.0,2,2.5,2270,0,7,1820,450,47.6757,2180
300000.0,4,2.5,1910,0,8,1910,0,47.3891,1910
643000.0,3,1.5,1780,0,7,1780,0,47.7631,2740
311000.0,4,2.5,2690,0,7,2690,0,47.3343,2300
360000.0,3,1.75,1330,0,7,1330,0,47.7322,1480
475000.0,4,2.5,3060,0,8,1700,1360,47.7387,1630
469950.0,3,3.25,1760,0,8,1760,0,47.7201,1520
240000.0,3,1.75,1570,0,7,1570,0,47.4425,1890
232000.0,2,1.0,960,0,6,810,150,47.494,960
350000.0,3,2.0,1680,0,7,1680,0,47.3248,2480
803000.0,2,1.0,1440,0,7,1440,0,47.7223,1980
355000.0,3,2.25,1960,0,8,1600,360,47.4427,1980
475000.0,4,2.0,1790,2,7,840,950,47.6526,1440
823000.0,3,2.5,2560,0,9,2560,0,47.5497,2710
395000.0,2,1.5,1010,0,7,1010,0,47.6897,1160
499000.0,4,3.75,2560,0,7,1900,660,47.7326,1400
420000.0,2,1.75,1200,0,7,800,400,47.6132,1330
961500.0,3,2.5,3910,0,10,3910,0,47.6374,2280
833000.0,4,1.75,2260,0,9,2260,0,47.5976,2430
479000.0,3,2.25,2110,0,8,2110,0,47.742,1860
1150000.0,4,2.5,3340,0,10,3340,0,47.6515,1770
267000.0,3,1.0,1400,0,6,1400,0,47.7124,1420
555000.0,4,1.75,1760,0,7,1760,0,47.5882,3030
490000.0,3,2.5,2010,0,8,2010,0,47.568,1850
619000.0,4,2.0,2300,0,8,1550,750,47.678,1670
569950.0,5,2.75,2510,0,7,1600,910,47.7719,2910
549000.0,3,2.0,1340,0,7,1340,0,47.6857,1120
422500.0,3,1.75,1560,0,7,1560,0,47.6868,2220
400000.0,4,3.5,3350,1,7,2140,1210,47.3978,2580
692500.0,4,2.75,3710,0,9,3710,0,47.5352,2950
310000.0,4,2.5,2430,0,8,2430,0,47.3779,2890
499900.0,3,1.75,2430,2,8,1630,800,47.4972,2390
492000.0,3,2.25,2100,0,8,2100,0,47.647,2050
460000.0,2,2.5,1880,0,9,1880,0,47.5614,1930
800000.0,3,2.5,1630,0,8,1630,0,47.6452,1630
832600.0,4,1.0,1640,0,7,1640,0,47.6601,1730
470000.0,4,2.75,2310,0,8,1670,640,47.7505,2600
542000.0,2,2.0,1930,0,8,1930,0,47.7104,1670
1309500.0,4,4.5,4750,2,10,3600,1150,47.5332,3600
308130.0,4,2.5,2300,3,7,1650,650,47.4125,2300
310000.0,2,1.0,1050,0,7,1050,0,47.5471,1240
235000.0,2,1.0,1500,0,6,1500,0,47.5027,1130
215000.0,3,1.0,1150,0,6,1150,0,47.4613,1230
210000.0,4,1.5,1920,0,7,1370,550,47.2987,1550
730000.0,4,2.75,3660,0,10,3660,0,47.6813,3090
245000.0,3,1.75,1720,0,7,1140,580,47.3177,1330
540000.0,3,2.25,2100,4,8,1470,630,47.4544,2410
299000.0,4,2.5,2400,0,8,2400,0,47.2606,2406
510000.0,3,2.5,2540,0,10,2540,0,47.6037,3190
198000.0,4,1.75,2080,0,7,1050,1030,47.3385,1500
950000.0,5,3.25,3400,0,10,3400,0,47.6141,2650
300000.0,4,1.75,2200,0,8,2200,0,47.3131,1910
528000.0,5,1.75,2140,0,7,1200,940,47.6625,1600
507000.0,5,3.25,3850,2,9,3030,820,47.3324,2640
770000.0,4,3.25,4270,0,9,3060,1210,47.5362,2850
255000.0,3,1.75,1340,0,7,1340,0,47.4182,1370
220000.0,1,1.5,1100,0,8,1100,0,47.3829,1400
690700.0,5,2.75,2870,0,9,2870,0,47.5405,2800
447000.0,2,1.0,1320,0,7,1320,0,47.705,1290
755000.0,6,2.0,2150,0,7,1270,880,47.6514,1740
700000.0,4,1.5,2470,0,7,1480,990,47.6365,2140
250000.0,4,2.75,1910,0,7,1000,910,47.369,1880
320000.0,3,2.5,2130,0,7,2130,0,47.3655,1670
565000.0,4,2.5,2240,0,9,2240,0,47.5276,2410
754300.0,5,2.75,1800,0,7,1680,120,47.6648,1730
650000.0,3,1.5,2160,2,8,1400,760,47.7241,3010
529888.0,4,2.5,3140,0,8,3140,0,47.4866,3140
432000.0,3,2.5,1920,0,8,1920,0,47.7633,1830
235000.0,3,1.0,1050,0,7,1050,0,47.2046,1220
994900.0,4,3.5,3695,0,9,3695,0,47.683,4160
489000.0,4,2.5,3910,0,9,2710,1200,47.3766,2650
800000.0,4,2.75,3010,0,8,3010,0,47.7068,3000
370000.0,4,1.5,1370,0,7,900,470,47.7237,1510
436000.0,4,2.75,2080,0,8,1240,840,47.7149,1880
395000.0,3,2.5,2250,0,7,2250,0,47.4787,2250
377691.0,5,1.75,2120,0,7,1320,800,47.7621,2120
370000.0,5,3.0,2220,3,7,2220,0,47.543,2340
515000.0,3,2.5,1440,0,8,1440,0,47.5688,1900
169000.0,3,1.0,910,0,7,910,0,47.3405,1020
475000.0,3,1.0,1270,0,7,1270,0,47.6848,1310
420000.0,3,2.5,2480,0,9,2480,0,47.4044,2870
1297000.0,6,2.75,2630,0,9,2510,120,47.6695,1540
822000.0,3,2.0,2410,0,9,1840,570,47.5632,2930
1500000.0,4,2.75,2930,0,9,2310,620,47.6264,3810
485000.0,3,2.25,1570,0,8,1180,390,47.6176,1620
270000.0,4,1.0,1900,0,7,1200,700,47.4406,1440
300000.0,6,2.5,2590,0,8,1390,1200,47.4608,2270
878000.0,4,2.5,3810,0,9,3810,0,47.5925,3290
590000.0,3,2.5,2290,0,9,2290,0,47.5441,2290
611900.0,1,2.25,1220,2,8,1220,0,47.6703,3150
240000.0,3,1.75,1100,0,7,1100,0,47.3124,1430
395000.0,4,2.5,2810,0,8,2810,0,47.3249,1680
169000.0,3,1.0,890,0,6,890,0,47.4971,1100
200500.0,3,2.0,1280,0,7,1280,0,47.4129,1800
308000.0,3,2.5,2320,0,8,2320,0,47.275,2360
290256.0,3,2.25,1720,0,8,1720,0,47.3136,2340
279950.0,3,1.75,1530,0,7,1040,490,47.4483,1530
195000.0,3,1.75,1580,0,7,1580,0,47.1958,1560
630000.0,3,1.0,1360,0,6,1360,0,47.3359,1890
1160000.0,4,3.0,2680,2,8,2680,0,47.6109,4480
478000.0,3,2.25,1640,0,8,1640,0,47.5689,1780
835000.0,3,2.25,2520,2,8,1700,820,47.5705,1990
639000.0,3,2.25,1400,0,9,1400,0,47.695,1500
623000.0,4,2.75,2300,0,9,2300,0,47.6218,2240
220000.0,3,1.75,1900,0,7,1260,640,47.5081,2000
526000.0,3,2.25,2000,0,8,1250,750,47.5443,2060
243500.0,2,1.0,900,0,6,900,0,47.542,1420
750000.0,4,2.5,2980,0,9,2890,90,47.5445,2980
329000.0,4,2.0,1850,0,7,1850,0,47.5009,1730
525000.0,4,1.0,1570,0,7,1570,0,47.6275,1610
190000.0,2,1.0,670,0,6,670,0,47.5546,1660
772650.0,4,2.5,2660,0,7,2660,0,47.5894,2640
355000.0,3,2.5,2110,0,8,2110,0,47.3875,2110
650000.0,3,1.75,1970,0,8,1570,400,47.5936,2460
678500.0,3,2.75,1210,2,7,1210,0,47.6798,1630
669950.0,4,2.5,2670,0,9,2670,0,47.6327,2430
850000.0,3,2.25,3000,0,10,3000,0,47.7274,2980
572000.0,3,2.75,2200,0,8,2200,0,47.6171,2710
492450.0,3,1.75,1540,0,8,1200,340,47.6231,1620
813000.0,3,1.75,2080,0,8,2080,0,47.5872,2240
710000.0,3,2.0,1780,0,8,1780,0,47.5796,1900
792500.0,3,1.5,1960,0,8,1330,630,47.6423,2090
285900.0,5,1.5,1690,0,7,1690,0,47.3859,1690
389000.0,3,2.0,2080,0,7,1250,830,47.3733,1530
675000.0,3,2.25,2070,2,8,1490,580,47.5543,1940
352000.0,2,0.75,760,0,4,760,0,47.4703,1100
1050000.0,4,3.25,4020,0,11,4020,0,47.5217,3190
768500.0,4,1.75,3620,0,8,1820,1800,47.6069,2410
500000.0,4,2.0,2330,0,7,1230,1100,47.7109,1250
685000.0,3,2.5,1460,0,7,1460,0,47.5895,2200
648475.0,4,2.75,2250,0,8,1200,1050,47.6406,1720
655000.0,6,5.0,2850,0,7,2850,0,47.6813,1870
895000.0,4,2.75,2640,0,8,1730,910,47.6727,1530
195000.0,3,1.0,1310,0,7,960,350,47.2949,1310
368000.0,4,2.5,2720,0,9,2720,0,47.3028,2570
997000.0,4,3.5,3430,0,11,3430,0,47.5196,3880
335000.0,3,2.75,1990,0,7,1340,650,47.7434,1750
250000.0,3,2.0,1170,0,7,1170,0,47.3333,1410
278500.0,3,1.75,1390,0,8,1390,0,47.2015,1770
260000.0,4,1.5,1540,0,7,1540,0,47.3317,1580
162500.0,2,1.0,760,0,6,760,0,47.5469,900
239000.0,4,1.0,1280,0,6,1280,0,47.4989,1310
600000.0,4,2.5,2990,0,8,2990,0,47.5773,3140
350000.0,4,2.25,1770,0,7,1770,0,47.4192,1770
852500.0,5,3.75,3830,0,10,3830,0,47.5837,3570
485000.0,3,2.5,2870,0,9,2870,0,47.4471,3040
299000.0,3,1.0,1520,0,6,1520,0,47.7699,1500
227450.0,2,1.0,660,0,5,660,0,47.4938,970
383000.0,3,1.0,1800,0,7,1200,600,47.525,1450
835000.0,2,3.25,3570,0,9,2370,1200,47.5448,3190
760000.0,5,1.5,3050,0,8,1920,1130,47.621,1200
532500.0,2,1.0,820,0,7,820,0,47.6842,1490
635000.0,3,2.5,3610,0,8,1950,1660,47.6306,2620
438500.0,3,2.0,1490,0,7,770,720,47.5772,1320
545500.0,3,2.5,1560,0,7,1360,200,47.5591,1670
675000.0,3,1.75,1660,0,7,1660,0,47.6503,2090
450000.0,3,1.75,1180,0,6,760,420,47.6825,1490
199999.0,3,1.0,960,0,5,960,0,47.3091,1330
375000.0,3,1.5,1630,0,7,1630,0,47.7104,1630
600000.0,4,2.25,2260,0,8,2260,0,47.7713,2470
292600.0,3,1.5,1520,0,7,1520,0,47.4991,1450
1038000.0,5,2.75,3050,0,8,1650,1400,47.5709,2920
610000.0,3,1.0,1000,0,8,1000,0,47.6629,2240
397450.0,4,2.5,2650,0,8,2650,0,47.3693,2510
382000.0,3,2.25,1750,0,8,1270,480,47.7739,2170
370000.0,3,2.25,1770,0,8,1270,500,47.7724,2180
520000.0,3,2.25,1770,0,8,1270,500,47.7724,2180
260000.0,2,1.0,770,0,6,770,0,47.766,990
890000.0,4,2.5,3370,0,8,3370,0,47.7698,1880
344000.0,5,2.0,2130,0,7,1440,690,47.7403,2310
205000.0,3,1.0,1050,0,7,1050,0,47.4038,1340
379000.0,5,2.5,2803,0,8,2803,0,47.3032,1810
424240.0,3,2.0,2080,0,8,2080,0,47.7035,2230
589950.0,3,2.0,2080,0,8,2080,0,47.7035,2230
582000.0,4,1.75,2120,1,7,1190,930,47.6964,2070
349000.0,3,2.5,2550,0,9,2550,0,47.3081,2410
658000.0,3,1.0,1290,0,7,1290,0,47.6835,1930
294000.0,5,2.75,1790,0,7,1060,730,47.5655,1400
690000.0,5,3.5,2720,0,8,1860,860,47.6931,2430
600000.0,3,1.0,1040,2,7,1040,0,47.6754,1440
199990.0,3,1.0,840,0,6,840,0,47.3685,870
220000.0,3,1.75,1650,0,7,1650,0,47.4331,1400
440000.0,4,2.25,2080,0,8,1460,620,47.7225,1960
439990.0,4,2.5,1540,0,8,1540,0,47.5526,1540
815000.0,4,2.5,3880,0,10,3880,0,47.5841,3280
535000.0,4,2.25,1860,0,8,1860,0,47.5699,1860
215000.0,3,1.75,1280,0,7,1280,0,47.2823,1670
605000.0,3,2.5,3200,0,8,2100,1100,47.4651,2690
349900.0,3,2.5,2200,0,8,2200,0,47.4624,2190
495000.0,3,1.0,1570,0,7,1070,500,47.6942,1770
515100.0,3,2.5,2074,0,8,2074,0,47.7327,1840
620000.0,4,2.5,2450,0,9,2450,0,47.6323,2730
657500.0,4,2.25,2520,0,9,2520,0,47.6377,2848
250000.0,5,1.75,2190,2,7,1190,1000,47.4887,2570
385000.0,5,1.75,2190,2,7,1190,1000,47.4887,2570
307000.0,3,1.5,2320,0,7,2320,0,47.7413,1480
288000.0,3,2.5,1370,0,7,1090,280,47.3717,1470
226450.0,3,1.75,1730,0,6,1730,0,47.3774,860
390000.0,3,2.5,1640,0,7,1110,530,47.7255,1860
350000.0,3,1.0,1300,0,6,1300,0,47.5028,1380
368000.0,3,1.5,1560,0,7,1060,500,47.7312,1820
469000.0,2,1.0,1120,0,6,730,390,47.6688,2050
865000.0,3,2.25,2670,0,9,2670,0,47.7601,3080
515000.0,5,2.5,3810,0,8,3810,0,47.4521,2470
410000.0,3,1.75,1440,0,7,1440,0,47.7296,1460
210000.0,4,1.0,1200,0,5,1200,0,47.3375,1400
460000.0,3,1.75,1520,0,7,820,700,47.7226,1420
241500.0,4,2.5,2500,0,8,1830,670,47.3137,2500
322200.0,4,2.25,2010,0,8,2010,0,47.3734,1950
279000.0,4,1.0,1210,2,7,1210,0,47.5026,1470
303000.0,2,1.0,1100,0,6,1100,0,47.4471,1746
420000.0,3,1.5,1050,0,6,800,250,47.6578,1530
249000.0,3,1.75,2120,0,7,1380,740,47.451,2050
294950.0,3,1.0,1240,0,6,1240,0,47.7277,1250
1315000.0,4,3.5,3460,0,10,2560,900,47.6718,1860
335000.0,3,1.75,1270,0,7,1270,0,47.693,1490
1155000.0,4,2.25,2980,2,10,2020,960,47.6426,2760
520000.0,2,1.0,1250,0,7,1250,0,47.685,1430
560000.0,4,1.75,1740,0,8,1740,0,47.6232,2180
243400.0,4,1.5,1730,0,7,1730,0,47.3782,1370
405000.0,3,2.0,1240,0,7,1240,0,47.6614,1350
495000.0,2,1.0,1670,0,7,1670,0,47.7001,1800
350000.0,4,2.5,2140,0,8,2140,0,47.3528,1600
368500.0,5,2.75,2530,0,7,1520,1010,47.4683,2400
99000.0,2,1.0,960,0,6,960,0,47.4698,1260
1070000.0,4,3.75,4130,0,11,4130,0,47.5194,3690
430000.0,4,1.75,1710,0,8,1710,0,47.7721,1940
412500.0,3,1.5,1490,0,7,1490,0,47.6571,1490
1122500.0,4,3.25,4750,0,11,4750,0,47.7149,3300
915000.0,4,2.5,3400,0,11,3400,0,47.7168,2880
535000.0,3,2.5,2210,0,8,2210,0,47.6938,1920
390000.0,3,1.5,1650,0,8,1130,520,47.7471,1400
499000.0,3,1.5,1260,0,7,780,480,47.6693,1540
375000.0,3,1.0,1960,0,7,1260,700,47.7641,1850
349000.0,4,2.5,1800,0,8,1800,0,47.4346,1800
635000.0,3,2.25,1940,0,7,1240,700,47.6004,2340
682000.0,4,2.75,2820,0,9,2820,0,47.6,2820
321027.0,4,2.25,2820,0,8,1920,900,47.3186,2320
150000.0,2,1.0,720,0,5,720,0,47.303,940
410000.0,3,1.75,1640,0,7,1110,530,47.726,1420
449950.0,3,2.0,1560,0,7,1560,0,47.6892,1900
194990.0,6,2.5,1560,0,6,1060,500,47.5335,1300
475000.0,4,1.75,1910,0,7,1210,700,47.7396,2210
530000.0,5,1.75,1570,0,7,1570,0,47.6677,1610
319950.0,4,2.5,2038,0,8,2038,0,47.3296,2634
210000.0,3,2.25,1720,0,7,1220,500,47.2979,1690
485000.0,3,2.75,1670,0,7,1670,0,47.6551,1370
774000.0,4,2.75,2830,0,9,2830,0,47.5903,3490
478000.0,4,2.0,1690,0,7,1210,480,47.6052,1620
385000.0,4,2.5,1620,0,7,1620,0,47.5132,1590
595000.0,4,2.5,2360,0,9,2360,0,47.774,2750
285000.0,3,1.5,1480,0,7,1170,310,47.7766,2230
723000.0,4,2.5,2700,0,9,2700,0,47.5521,2260
279000.0,3,1.5,1780,0,7,1240,540,47.419,1860
195000.0,3,1.5,1430,0,6,1430,0,47.4518,1150
625000.0,2,1.0,2160,0,8,1170,990,47.6364,1150
270000.0,3,1.75,1800,0,8,1800,0,47.7762,2100
559000.0,2,2.0,1930,0,8,1930,0,47.7191,1640
474000.0,4,2.25,1960,0,8,1330,630,47.7434,1540
303500.0,4,2.5,1920,0,8,1920,0,47.3526,1860
350000.0,3,1.75,1470,0,6,1470,0,47.7524,1470
367500.0,5,3.0,2980,0,7,1680,1300,47.7372,1590
595000.0,5,3.0,2980,0,7,1680,1300,47.7372,1590
589000.0,3,2.0,2360,0,8,2360,0,47.5595,2660
585000.0,3,1.75,1790,0,7,1790,0,47.732,3270
482975.0,3,2.25,2130,0,8,1370,760,47.7462,2820
365500.0,4,2.5,2030,0,8,2030,0,47.4511,2030
570000.0,4,2.0,1790,0,8,1790,0,47.6266,2150
335000.0,3,2.5,2260,0,8,2260,0,47.3203,2390
767500.0,4,2.0,2350,0,7,1450,900,47.6681,1640
386591.0,3,2.5,1690,0,8,1150,540,47.5518,1690
279000.0,3,1.0,1320,0,7,1320,0,47.5288,1010
620000.0,4,2.5,2690,0,9,2690,0,47.6612,2840
407000.0,4,2.25,2810,1,7,1710,1100,47.395,1860
364250.0,3,2.5,2280,0,8,2280,0,47.4213,2380
399000.0,4,2.5,2870,0,8,2540,330,47.4522,2590
766950.0,3,2.5,3030,0,10,3030,0,47.743,3360
710000.0,4,2.75,2940,0,9,2940,0,47.5529,2410
320000.0,3,1.0,1190,0,6,1190,0,47.5513,1360
300000.0,3,2.5,1800,0,7,1800,0,47.5401,1800
263000.0,3,1.75,1580,0,8,1180,400,47.3538,1620
445000.0,3,2.5,1730,0,8,1730,0,47.5683,1730
554000.0,3,2.0,1910,0,7,1910,0,47.6037,2040
335000.0,2,1.75,1000,0,6,940,60,47.6787,1900
307000.0,4,2.75,2520,0,7,1260,1260,47.4038,1930
404000.0,3,1.0,1420,0,7,970,450,47.7164,1340
775000.0,4,3.5,3080,0,9,3080,0,47.5992,2980
220000.0,3,1.0,1060,2,7,1060,0,47.201,1300
518000.0,4,2.5,2160,0,8,2160,0,47.7438,2840
1600000.0,4,3.5,4060,0,10,4060,0,47.6634,2410
315000.0,1,2.25,1940,0,7,1100,840,47.7313,1580
572650.0,4,2.5,2250,0,8,2250,0,47.7111,2110
350000.0,2,1.0,1620,0,6,850,770,47.7119,2460
285000.0,2,1.0,920,0,6,920,0,47.5441,1640
231000.0,3,2.5,1370,0,7,1370,0,47.3767,1720
179000.0,3,1.0,920,0,6,920,0,47.3603,920
244000.0,3,1.5,1360,0,7,1360,0,47.3799,1890
185850.0,3,1.5,1630,0,7,1630,0,47.4455,1700
610000.0,6,2.5,3610,0,8,3210,400,47.7692,2210
419000.0,4,2.5,3010,0,9,3010,0,47.3542,3010
779000.0,3,1.75,2320,2,8,1420,900,47.6449,2540
695000.0,5,3.0,3290,0,7,1870,1420,47.6708,1970
319900.0,3,2.5,2040,2,8,2040,0,47.2618,1960
329000.0,3,2.75,1920,0,8,1320,600,47.3213,2040
475226.0,3,2.5,2120,0,8,2120,0,47.75,2000
638000.0,3,2.5,2170,0,9,2170,0,47.5453,2170
440000.0,2,1.5,1330,0,7,900,430,47.6359,1610
214000.0,3,2.0,1580,0,6,800,780,47.4963,1580
600000.0,3,2.75,3580,3,10,2210,1370,47.3244,3990
935000.0,4,2.0,2580,0,9,1850,730,47.6245,2590
630000.0,4,1.75,1930,2,8,1670,260,47.7078,2730
575000.0,3,2.5,2120,0,7,2120,0,47.681,1690
345000.0,3,2.5,1990,0,8,1410,580,47.3259,1660
323000.0,4,1.75,1310,0,7,1310,0,47.7559,2280
425000.0,3,2.5,2670,0,10,2670,0,47.3683,1960
411000.0,2,2.25,1910,0,7,1010,900,47.4206,2050
299800.0,4,1.5,1530,0,6,1530,0,47.6492,1520
823000.0,6,1.75,2920,0,9,2780,140,47.6024,2020
200000.0,3,1.0,1010,0,7,1010,0,47.735,1110
760000.0,4,1.75,2450,2,9,1630,820,47.5564,3150
359950.0,4,2.5,1820,0,7,1820,0,47.735,1820
375000.0,4,2.5,2090,0,7,1470,620,47.4888,1700
295000.0,2,1.75,2200,0,7,1100,1100,47.4633,2590
250000.0,4,3.0,2250,0,8,1570,680,47.3703,1550
497000.0,3,2.25,1450,0,8,1450,0,47.6765,1450
520000.0,4,2.5,2280,0,8,2280,0,47.7471,2180
365000.0,4,3.5,2720,0,8,2100,620,47.4612,2280
459900.0,3,2.25,2250,0,8,1460,790,47.7229,1930
158000.0,3,2.0,1090,0,7,940,150,47.5118,1840
294700.0,3,2.0,1970,0,7,1300,670,47.2824,1710
439950.0,4,2.25,2780,0,7,2780,0,47.477,1650
899000.0,4,2.25,2290,3,8,1550,740,47.616,2790
535000.0,3,1.75,2330,0,7,1390,940,47.7607,1850
530000.0,4,4.5,4060,0,10,4060,0,47.4241,1830
215000.0,4,2.0,1470,0,8,1470,0,47.3742,1640
290000.0,2,1.0,1620,0,6,920,700,47.7069,1540
798000.0,5,2.75,3220,0,9,3220,0,47.7076,3100
785000.0,4,2.5,3270,0,9,3270,0,47.5373,3120
433000.0,3,1.75,2160,0,8,1730,430,47.7664,2910
425000.0,2,1.0,1150,1,7,1010,140,47.5567,1150
654000.0,4,2.5,2240,0,8,1540,700,47.6965,1960
215000.0,3,1.5,1280,0,6,1280,0,47.3343,1070
232000.0,3,1.0,840,0,6,840,0,47.3743,1010
675000.0,3,1.75,1680,0,8,1680,0,47.6098,2250
665000.0,5,2.75,2330,0,7,1550,780,47.6651,1750
835000.0,4,2.5,3030,0,10,3030,0,47.6569,2780
525000.0,6,3.0,2880,0,7,2880,0,47.5959,1470
780000.0,3,2.75,2910,2,7,2010,900,47.7071,2400
844000.0,4,3.25,3090,0,10,3090,0,47.6674,3200
680000.0,4,2.75,2720,0,8,2720,0,47.7181,2580
290000.0,3,1.5,1310,0,7,1310,0,47.7328,1330
560000.0,2,1.0,1790,0,8,1360,430,47.691,1790
605500.0,3,2.5,2830,0,9,2830,0,47.7462,2710
762500.0,4,2.5,3150,0,9,3150,0,47.7082,3150
1740000.0,5,3.25,3930,0,9,2910,1020,47.6802,2040
665000.0,6,2.75,2840,0,8,1420,1420,47.5518,2250
540000.0,5,1.0,2480,0,7,1640,840,47.6046,1940
375000.0,3,2.5,1930,0,7,1330,600,47.7481,1940
342000.0,3,1.0,1260,0,6,720,540,47.731,1300
340000.0,3,1.0,670,0,6,670,0,47.5329,1880
1250000.0,5,3.25,3930,2,10,2540,1390,47.5631,3600
693000.0,4,2.5,3160,0,10,3160,0,47.5996,3350
638500.0,4,1.75,1770,2,8,1770,0,47.4355,2310
805000.0,5,3.0,2240,0,8,2240,0,47.5171,1990
250000.0,3,1.0,990,0,7,990,0,47.4151,1420
325000.0,3,2.5,1580,0,7,1580,0,47.3539,2070
270000.0,4,1.75,1560,0,7,1560,0,47.5292,1250
880000.0,6,2.5,2640,0,8,1760,880,47.5771,1960
300000.0,2,1.75,2120,0,6,1440,680,47.6974,1590
290000.0,2,1.0,1200,0,6,1200,0,47.7548,1100
2850000.0,4,4.0,5040,0,10,2870,2170,47.5701,4050
259950.0,3,1.0,1460,0,5,1260,200,47.4958,1150
1780000.0,4,3.25,4890,0,13,4890,0,47.5303,5790
299950.0,3,1.0,1580,0,7,1580,0,47.4964,1180
483000.0,3,2.25,2100,0,8,1330,770,47.7511,2100
890000.0,3,2.25,2060,0,8,2060,0,47.6534,2030
719000.0,3,2.5,1690,1,8,1690,0,47.5841,2140
785000.0,4,3.0,3370,0,8,1920,1450,47.4319,2440
660000.0,3,2.5,2330,0,9,2330,0,47.5542,2330
264000.0,4,1.75,1820,0,7,1080,740,47.4104,1810
575000.0,3,1.75,1890,0,8,1890,0,47.5697,2720
1215000.0,4,3.75,3820,0,10,3820,0,47.7337,3140
475000.0,3,2.5,2770,0,9,2770,0,47.2568,1830
845800.0,4,3.5,3020,0,10,3020,0,47.6524,3120
352500.0,3,1.75,1170,0,7,1170,0,47.7368,1610
347000.0,3,1.0,1270,0,7,1270,0,47.7604,1390
560000.0,4,2.75,1950,0,8,1950,0,47.5698,2040
323000.0,4,2.75,2230,2,7,1330,900,47.2576,2230
595000.0,3,1.75,2220,0,7,2220,0,47.4693,2010
257500.0,4,2.0,2060,0,7,1170,890,47.2924,1890
450000.0,3,1.0,1100,0,7,1100,0,47.5686,1200
410000.0,4,1.0,1140,0,7,900,240,47.742,1300
810000.0,3,1.75,1980,2,9,1320,660,47.5867,2450
372500.0,5,3.0,2480,0,7,1300,1180,47.4964,2290
325000.0,3,1.0,1050,0,7,1050,0,47.7533,1440
280000.0,3,1.0,1260,0,6,1260,0,47.7476,1990
258000.0,3,2.0,1680,0,6,880,800,47.3924,2150
329950.0,4,1.0,1360,0,7,1360,0,47.7512,1050
836000.0,4,2.5,2450,0,9,2030,420,47.6197,2730
365000.0,5,2.5,2260,0,8,2260,0,47.352,2180
111300.0,2,1.0,1060,0,5,1060,0,47.3066,940
864000.0,4,2.5,3720,0,10,3720,0,47.655,2830
725000.0,3,1.75,1610,0,7,1610,0,47.6527,2010
550000.0,4,2.5,3350,0,8,2670,680,47.7498,2730
130000.0,2,1.0,790,0,7,790,0,47.4007,1560
765000.0,2,1.75,1660,0,7,990,670,47.6394,2070
255000.0,3,1.5,1420,0,7,1420,0,47.4651,1720
439500.0,3,2.5,2050,0,8,1570,480,47.47,2700
268000.0,3,1.75,1250,0,7,1250,0,47.4725,1640
985000.0,3,1.75,1700,0,7,1700,0,47.6276,2100
751305.0,4,2.5,2660,0,10,2660,0,47.5529,2920
280000.0,3,1.0,1350,0,6,1350,0,47.5345,1380
304000.0,4,2.0,1810,0,7,1110,700,47.4307,1810
200000.0,4,2.75,2210,0,8,1730,480,47.3541,1750
325000.0,3,1.5,2120,0,7,1420,700,47.2906,1780
736000.0,3,2.25,2470,2,8,1540,930,47.6569,2850
426500.0,4,2.5,2700,0,9,2700,0,47.4356,2900
640000.0,2,1.75,1760,0,7,880,880,47.65,1330
230000.0,5,2.0,1930,0,6,1930,0,47.5073,1130
366350.0,4,1.0,1680,0,6,1680,0,47.5354,1560
365000.0,2,1.0,1390,0,6,910,480,47.4646,1610
482000.0,4,2.25,2240,0,8,2240,0,47.728,2240
345000.0,4,1.0,1980,0,7,1980,0,47.4604,1730
682000.0,3,1.75,1830,2,8,1830,0,47.6051,2120
657500.0,3,1.75,980,0,6,980,0,47.6643,1150
895000.0,6,2.5,3550,0,8,3550,0,47.5719,3140
425000.0,3,1.5,1660,0,7,920,740,47.5391,1530
532500.0,4,2.5,2490,0,8,2040,450,47.5931,2120
540000.0,4,2.5,2329,0,9,2329,0,47.7366,2660
578000.0,3,2.25,1790,0,8,1790,0,47.5541,2060
1086000.0,3,3.0,2830,3,8,1840,990,47.5694,3420
322500.0,3,1.0,1160,0,7,1160,0,47.7429,1160
140000.0,3,1.0,1000,0,7,1000,0,47.3217,1190
485000.0,3,2.5,2540,0,8,1820,720,47.389,1650
575000.0,2,1.5,1750,0,8,1440,310,47.3351,1950
421000.0,3,2.5,2890,0,8,2890,0,47.4326,2120
355000.0,4,2.0,1870,0,7,1200,670,47.5309,1270
515000.0,4,2.25,2200,0,8,2200,0,47.7355,1970
309000.0,3,1.0,1300,0,7,1300,0,47.5063,1740
815000.0,5,2.25,3410,0,10,2530,880,47.65,3140
285000.0,3,1.0,1160,0,7,1160,0,47.724,1600
700000.0,3,1.75,2100,0,8,2100,0,47.6776,1830
289000.0,3,2.5,1490,0,7,1490,0,47.3643,1640
458000.0,4,3.0,3280,0,7,3280,0,47.7509,3210
230000.0,3,1.75,1450,0,8,1450,0,47.3093,1860
432500.0,3,2.5,1930,0,7,1420,510,47.7715,1600
288000.0,3,1.75,1660,0,7,1040,620,47.4448,1240
354000.0,3,1.75,1260,0,7,1260,0,47.7412,1320
119500.0,3,1.0,1170,0,6,1170,0,47.7346,1590
805000.0,4,3.0,3350,0,9,2020,1330,47.56,2870
435000.0,3,2.5,1420,0,7,1420,0,47.7027,1420
260000.0,3,1.75,2170,0,7,1630,540,47.3087,2049
377000.0,4,1.75,1800,0,6,900,900,47.7744,1770
602000.0,4,2.5,2000,0,8,2000,0,47.5719,1950
530000.0,3,1.75,1660,0,7,960,700,47.5734,1510
525000.0,4,2.0,1540,0,7,770,770,47.6886,1090
250000.0,2,1.5,1160,0,7,890,270,47.768,1160
681000.0,3,1.0,1700,0,7,1700,0,47.5677,2080
625000.0,3,1.75,1580,0,8,1580,0,47.706,2080
448500.0,3,2.5,2080,0,8,2080,0,47.5412,2110
260000.0,3,2.0,1030,0,6,1030,0,47.5113,1380
538000.0,3,1.75,1770,0,7,1020,750,47.5862,2000
385500.0,3,2.0,1540,0,7,1120,420,47.7605,1910
428400.0,4,2.5,2650,0,9,2650,0,47.3768,2630
346290.0,4,2.75,2690,0,8,2690,0,47.1896,2640
587000.0,4,2.75,2210,0,9,2210,0,47.5994,2460
355000.0,4,2.5,2390,0,7,2390,0,47.4811,2560
650000.0,5,2.75,2580,0,8,1480,1100,47.6208,2140
340000.0,4,2.5,2160,0,7,2160,0,47.4799,2160
565000.0,4,2.5,2230,0,8,1430,800,47.6623,1970
630000.0,4,2.0,2000,0,7,2000,0,47.5787,2200
227000.0,3,1.0,1280,0,6,1280,0,47.2094,1260
600000.0,4,2.75,2810,0,8,1640,1170,47.6745,2400
540400.0,4,1.75,1680,0,8,1680,0,47.641,1910
569000.0,3,2.5,2150,0,8,2150,0,47.6952,2150
735000.0,3,2.5,2820,0,9,2820,0,47.5527,2910
434000.0,3,2.25,1750,0,7,1210,540,47.7305,1930
578888.0,2,2.0,1060,0,7,1000,60,47.6626,1310
465425.0,4,2.75,2430,0,7,2430,0,47.775,2580
280500.0,4,2.75,2660,0,8,1590,1070,47.3078,2250
539950.0,2,2.0,1670,0,9,1670,0,47.5545,2330
406430.0,3,2.0,1380,0,7,1380,0,47.5951,1380
1150000.0,4,3.75,4160,0,11,4160,0,47.669,5330
250000.0,3,2.5,1790,0,8,1790,0,47.4102,1790
266000.0,3,2.5,1940,0,7,1460,480,47.3491,1750
258000.0,3,2.0,1390,0,7,1390,0,47.434,1630
472000.0,3,2.0,2200,2,8,1200,1000,47.7584,2600
530000.0,3,2.25,1264,0,8,1264,0,47.6694,1264
302282.0,2,1.0,1095,0,7,1095,0,47.6058,1310
370000.0,2,1.0,850,0,6,750,100,47.5282,1880
625000.0,4,2.0,1760,0,7,1170,590,47.6714,1850
142500.0,1,1.0,690,0,5,690,0,47.3109,1330
334000.0,3,1.75,1400,0,7,1400,0,47.7569,1820
362000.0,5,3.0,1810,0,7,1810,0,47.5622,1670
181000.0,2,1.0,1310,0,7,950,360,47.5798,1310
241500.0,3,1.0,1400,0,7,1400,0,47.2738,1440
245000.0,3,1.75,2350,0,7,1180,1170,47.3594,1680
227500.0,3,1.0,1150,0,7,1150,0,47.3626,1220
158550.0,5,1.5,1710,0,7,1710,0,47.3839,1480
450000.0,3,2.25,1660,0,7,1130,530,47.7262,1680
485000.0,3,1.75,1950,0,7,1950,0,47.7282,2340
353000.0,4,1.75,1780,0,7,1780,0,47.7419,1160
500000.0,4,3.0,2450,0,8,2450,0,47.7721,2460
360000.0,1,2.25,2060,0,7,1560,500,47.3291,2060
357500.0,3,1.5,1540,0,7,1540,0,47.4755,1550
272000.0,3,2.5,1650,0,7,1650,0,47.6553,1650
422000.0,3,1.0,1160,0,7,1160,0,47.7304,1300
365000.0,2,2.0,1440,0,7,1440,0,47.7648,1780
450000.0,3,1.75,2150,0,8,1610,540,47.7591,2150
275053.0,2,1.0,1060,0,6,1060,0,47.7412,1100
1880000.0,3,2.75,2620,1,9,2620,0,47.6144,3400
725000.0,3,1.75,1630,0,7,960,670,47.6023,1880
235000.0,3,1.75,1840,0,7,1500,340,47.3764,1430
510000.0,2,1.0,820,0,5,820,0,47.7076,1810
489950.0,2,1.0,820,0,5,820,0,47.7076,1810
463000.0,3,2.5,2010,0,8,2010,0,47.732,2010
536000.0,4,2.25,1990,0,8,1990,0,47.5712,2150
375000.0,4,2.5,2990,0,8,2990,0,47.2612,2590
630000.0,4,2.5,2540,0,9,2540,0,47.7034,3640
362000.0,3,2.25,1640,0,7,1140,500,47.4476,2020
350000.0,4,2.75,2500,2,9,1490,1010,47.3381,2830
1691000.0,4,3.5,4020,0,11,4020,0,47.6462,3930
255000.0,3,2.0,1500,0,6,1390,110,47.4809,1310
269000.0,4,2.5,1594,0,7,1088,506,47.3262,1536
370000.0,4,3.0,2130,0,7,2130,0,47.4871,1070
270000.0,3,1.0,1130,0,7,1130,0,47.4852,1390
265000.0,3,2.0,1690,0,7,1690,0,47.2132,1850
487000.0,2,1.0,1440,0,7,960,480,47.6901,1400
835000.0,4,3.25,3270,0,10,3270,0,47.6346,3270
850000.0,4,3.25,4350,0,9,2200,2150,47.5435,2180
575000.0,4,2.75,1610,0,7,1020,590,47.7024,1610
335000.0,3,1.0,950,0,7,950,0,47.7193,2270
318000.0,3,1.0,1010,0,6,1010,0,47.7601,1590
510000.0,3,2.0,1420,0,7,1420,0,47.5356,2330
242500.0,3,1.5,1200,0,7,1200,0,47.4225,1380
750000.0,5,2.25,2020,0,7,1010,1010,47.5763,1890
439900.0,5,3.5,3390,2,7,3390,0,47.4792,2580
710000.0,2,1.0,1700,0,8,1460,240,47.6442,1620
2400000.0,5,3.25,3410,3,9,2760,650,47.6285,3540
435000.0,3,1.75,2030,0,8,1630,400,47.7726,2120
874000.0,4,2.75,2860,1,7,1560,1300,47.6723,2290
385000.0,4,1.75,1690,0,7,870,820,47.572,1320
110000.0,2,1.0,760,0,5,760,0,47.4836,1360
477000.0,3,1.75,1780,0,7,1210,570,47.7357,1780
500000.0,3,2.0,1550,0,8,1550,0,47.5222,1440
885000.0,4,2.5,4090,0,10,4090,0,47.581,3510
235000.0,2,1.0,880,0,7,880,0,47.5071,1240
210000.0,3,2.75,1320,0,7,880,440,47.365,1490
320000.0,2,1.0,950,0,6,950,0,47.5728,1480
406000.0,3,1.75,1390,0,7,1390,0,47.4892,1910
350000.0,3,1.75,1900,0,8,1220,680,47.4781,1850
350000.0,2,0.75,1392,0,7,1392,0,47.4491,1640
720000.0,4,2.5,3340,2,10,3340,0,47.535,3160
604700.0,4,2.75,2750,3,9,1720,1030,47.3566,2860
343000.0,3,1.0,1400,0,5,1400,0,47.5271,1250
558000.0,3,2.25,2220,0,8,1280,940,47.6212,2020
364000.0,4,1.0,1210,0,7,1210,0,47.5216,1100
420000.0,3,1.75,2390,0,7,1290,1100,47.7759,2270
450000.0,5,2.0,1870,0,7,1870,0,47.5951,1870
392000.0,2,1.5,940,0,7,810,130,47.5375,940
100000.0,4,1.0,1120,0,5,860,260,47.4904,1120
480000.0,3,2.5,1250,2,8,1250,0,47.6619,1250
212000.0,3,1.5,1060,0,7,1060,0,47.3217,1270
560000.0,5,2.5,2410,0,7,1600,810,47.7372,2410
359950.0,5,2.75,2844,0,8,2844,0,47.3259,2273
535000.0,4,2.5,2200,0,7,1330,870,47.7409,2290
980000.0,5,4.0,3460,0,10,2830,630,47.5201,1890
720000.0,2,1.0,1580,2,8,1580,0,47.6541,2170
619950.0,2,1.0,1520,0,7,920,600,47.6796,1600
489000.0,3,2.5,2260,0,9,2260,0,47.448,2750
415000.0,4,2.0,1800,0,7,1000,800,47.6833,1690
672500.0,4,2.5,2650,0,10,2650,0,47.6304,2650
352500.0,3,1.0,1000,0,7,1000,0,47.6834,1090
258750.0,4,2.0,2300,0,6,1150,1150,47.3282,1230
350000.0,3,1.0,1080,0,6,1080,0,47.7637,1410
152000.0,3,1.0,902,0,7,902,0,47.363,1510
378500.0,2,1.0,730,0,7,730,0,47.6997,1620
1017000.0,4,1.75,2600,0,8,2600,0,47.6634,2750
419000.0,3,1.5,1570,0,7,1570,0,47.6022,1570
895000.0,5,3.0,2876,2,9,1970,906,47.5528,3500
668500.0,4,2.25,2290,0,8,1780,510,47.5617,2360
487000.0,2,2.5,1470,0,8,1470,0,47.6874,1470
538000.0,3,3.5,2620,0,8,1970,650,47.4979,1960
898000.0,5,1.5,2680,0,8,1450,1230,47.6348,2900
315000.0,4,2.0,2020,0,8,2020,0,47.3391,1940
800000.0,3,2.5,2100,4,7,2100,0,47.5865,2100
516130.0,3,1.75,1510,0,8,1510,0,47.6183,1770
1600000.0,3,2.5,2850,4,10,1790,1060,47.5894,2850
1200000.0,4,2.5,4280,0,11,3400,880,47.5588,3520
355425.0,4,2.5,3238,2,8,1678,1560,47.4005,3056
1157400.0,3,2.5,2740,2,10,2740,0,47.6313,2740
689000.0,4,2.5,2020,0,7,2020,0,47.5434,2250
500000.0,3,3.25,1520,0,7,1520,0,47.67,1520
430000.0,5,2.5,3860,3,8,2300,1560,47.3117,2520
299500.0,4,2.25,1600,0,7,1080,520,47.4629,1620
349950.0,4,2.5,2090,0,8,2090,0,47.4289,2080
1419000.0,5,3.25,4020,0,9,3120,900,47.6349,3550
998000.0,4,2.25,2910,0,9,2910,0,47.5465,2780
329000.0,3,1.0,900,0,7,900,0,47.7423,1220
575000.0,3,1.75,1720,0,8,1720,0,47.6875,1620
529900.0,5,2.25,3030,0,8,2600,430,47.7515,2230
1470000.0,4,2.5,3030,0,9,2380,650,47.6367,1940
725000.0,4,1.75,2190,0,7,1450,740,47.6531,1980
286000.0,3,2.5,1680,0,8,1680,0,47.3196,1720
335000.0,3,2.0,1210,0,7,1210,0,47.5731,1690
395300.0,3,1.5,1120,0,7,1120,0,47.5987,1470
510000.0,4,2.75,3180,0,8,3020,160,47.7439,3020
203000.0,3,1.0,920,0,7,920,0,47.3791,1660
248000.0,2,1.0,700,0,6,700,0,47.7712,1250
265000.0,3,2.25,2540,0,8,2540,0,47.2906,2140
1000000.0,4,1.5,2100,0,8,2100,0,47.6497,1930
1000000.0,3,1.0,1540,0,7,1540,0,47.7213,1540
241400.0,3,2.0,1420,0,7,1420,0,47.3287,1550
309950.0,4,1.75,1450,0,7,1450,0,47.4546,1340
294010.0,3,1.75,1550,0,6,830,720,47.5291,1100
345000.0,3,2.25,1920,0,8,1920,0,47.6233,1950
625000.0,3,2.25,1920,0,8,1920,0,47.6233,1950
660000.0,4,2.5,2510,0,8,2510,0,47.5962,2550
559000.0,2,2.0,1660,0,8,1660,0,47.7094,1670
866000.0,4,3.25,3990,0,9,3990,0,47.6784,3920
770000.0,3,2.0,2350,0,8,1810,540,47.639,2170
259950.0,3,1.5,1350,0,7,1350,0,47.3786,1900
352000.0,5,2.75,2980,0,7,1710,1270,47.3807,2240
2466350.0,5,4.75,6390,0,10,4560,1830,47.6312,4010
395000.0,3,2.0,1590,0,7,1590,0,47.7239,1320
276500.0,4,1.75,1400,0,6,1400,0,47.4888,1120
530000.0,3,2.25,1880,0,8,1880,0,47.5342,2520
798000.0,4,3.25,3500,0,10,3500,0,47.5902,3500
380000.0,2,2.0,1370,0,8,1370,0,47.714,1380
350000.0,4,2.5,2810,0,8,2810,0,47.1895,2640
325000.0,3,2.5,2220,0,8,2220,0,47.3972,1980
336000.0,3,2.5,2110,0,8,2110,0,47.3885,2110
286900.0,3,2.25,1720,0,7,1440,280,47.3438,1990
472000.0,5,2.25,1780,0,8,1330,450,47.6946,1780
263000.0,3,1.75,1410,0,7,1410,0,47.3617,1560
565000.0,3,3.0,2110,2,7,1110,1000,47.5696,1730
765000.0,3,2.5,2700,0,10,2700,0,47.5597,2840
1517000.0,3,2.25,2610,4,8,2610,0,47.5789,2970
405000.0,3,2.0,1660,0,7,830,830,47.7103,1610
1098000.0,4,3.5,4570,0,11,4570,0,47.5859,4700
555000.0,3,3.0,3760,0,10,2640,1120,47.308,2820
305000.0,3,2.5,1610,0,8,1610,0,47.4491,1610
289950.0,3,2.25,1740,0,7,1390,350,47.391,1740
487500.0,5,3.5,3530,0,7,2380,1150,47.7309,2110
96500.0,3,1.0,840,0,6,840,0,47.3281,840
185000.0,3,1.0,840,0,6,840,0,47.3281,840
150550.0,4,1.0,1470,0,7,1470,0,47.4819,1230
339000.0,4,2.0,2470,0,6,1970,500,47.5308,1060
675000.0,4,1.75,2220,1,8,1280,940,47.7065,2210
615000.0,3,1.75,1720,0,7,960,760,47.5747,1660
837500.0,4,2.5,2700,0,8,2700,0,47.6861,2120
250000.0,2,1.0,950,0,5,950,0,47.7494,1690
583000.0,3,2.5,1790,0,8,1790,0,47.6169,1800
499000.0,3,2.5,1610,0,8,1610,0,47.6776,1540
550000.0,3,2.5,2290,0,8,2290,0,47.5103,1600
400000.0,4,2.5,2170,0,7,2170,0,47.281,1760
990400.0,3,2.5,2100,0,9,2100,0,47.5983,1820
600000.0,3,2.5,2320,0,8,2320,0,47.587,2200
325000.0,2,1.0,1120,0,6,1120,0,47.763,1340
265000.0,3,2.5,1530,0,7,1530,0,47.3487,1360
1620500.0,3,2.5,3490,3,9,1770,1720,47.6605,3640
347500.0,3,1.5,1180,0,7,1180,0,47.7652,1710
629000.0,5,2.0,2050,0,7,1470,580,47.6864,1560
1087500.0,2,2.0,2360,0,9,2360,0,47.5835,3030
397500.0,4,2.5,2570,0,8,2570,0,47.3736,2150
404500.0,2,1.0,1270,0,7,1270,0,47.5949,1980
225000.0,3,1.5,1250,0,7,1250,0,47.3719,1260
267000.0,3,2.25,2510,0,8,1610,900,47.2988,1940
800000.0,4,3.75,2690,3,9,2120,570,47.6418,2830
339000.0,4,2.5,2900,0,8,2900,0,47.3504,2720
1850000.0,4,2.5,3830,4,11,2370,1460,47.7404,3080
525000.0,5,1.0,1280,0,7,1280,0,47.6605,1420
1150000.0,5,3.5,4350,2,10,3520,830,47.5396,3260
565000.0,1,1.0,1370,0,7,1370,0,47.5571,1450
387000.0,2,2.25,1230,0,8,960,270,47.5942,1130
720000.0,4,2.5,2440,0,9,2440,0,47.6685,2860
1500000.0,4,3.5,4410,2,12,3420,990,47.5518,4090
235000.0,2,1.0,910,0,6,910,0,47.7332,1310
365000.0,2,1.0,910,0,6,910,0,47.7332,1310
368250.0,3,2.5,2150,0,8,2150,0,47.6191,2150
580000.0,3,2.5,2150,0,8,2150,0,47.6191,2150
1100000.0,4,3.25,3190,4,8,2610,580,47.5033,2240
215000.0,4,2.5,2130,0,7,2130,0,47.3041,3220
648000.0,4,2.5,2740,0,9,2740,0,47.5672,2630
705000.0,4,3.0,3150,0,9,3150,0,47.5959,3150
465000.0,3,2.25,1450,0,8,1180,270,47.6685,1450
650000.0,5,2.0,2400,0,8,1900,500,47.6762,1520
335000.0,4,2.25,2280,0,7,1140,1140,47.4182,1660
640000.0,4,2.0,2310,0,8,2310,0,47.7713,2710
638250.0,4,2.5,2460,0,9,2460,0,47.6262,2420
1460000.0,4,3.5,4200,2,12,3640,560,47.5331,3750
375000.0,4,2.0,1620,0,7,1620,0,47.5533,1620
842000.0,4,1.75,2170,0,8,2170,0,47.5685,1910
499950.0,3,2.25,2880,0,8,1710,1170,47.7707,1880
810000.0,4,2.5,3280,3,11,3280,0,47.6398,3280
310000.0,5,2.0,2900,0,7,2900,0,47.741,1260
730000.0,3,2.5,2160,0,9,1540,620,47.6994,930
637800.0,4,1.75,2250,0,7,1420,830,47.6738,1930
225000.0,3,1.0,1340,0,5,1340,0,47.477,1240
417500.0,4,1.0,1390,0,7,1390,0,47.7248,1390
265000.0,4,2.0,1600,0,7,1600,0,47.2015,1540
550000.0,4,2.5,2050,0,8,2050,0,47.62,2010
625700.0,3,2.0,2570,0,7,2570,0,47.5547,2010
595000.0,3,2.5,2660,0,9,2660,0,47.7383,2590
270000.0,3,1.5,1540,0,7,1540,0,47.4766,1550
739375.0,5,3.0,2640,0,7,2140,500,47.6188,1540
357562.0,2,1.75,1210,0,8,1210,0,47.5522,1210
1010000.0,4,2.5,3760,0,11,3760,0,47.7203,3930
455000.0,2,1.75,1350,0,8,1350,0,47.7171,1440
310000.0,5,2.25,2600,2,8,1810,790,47.3257,2070
415000.0,3,2.75,3900,0,6,3460,440,47.5621,2460
452000.0,2,1.0,1340,2,8,1340,0,47.7212,1680
810000.0,3,2.0,1760,0,7,1760,0,47.6363,3430
730001.0,3,2.0,1840,0,7,1010,830,47.6862,1760
825000.0,3,2.25,2980,0,9,2230,750,47.6627,2980
665000.0,3,2.5,1730,0,8,1730,0,47.6532,1730
327500.0,4,1.75,1650,0,8,1650,0,47.4507,1750
699950.0,3,2.5,3370,0,9,3370,0,47.5855,2980
424000.0,3,2.5,2200,0,9,2200,0,47.3139,2560
657000.0,4,2.5,2180,0,7,1420,760,47.6846,1560
445000.0,3,1.75,1490,0,7,1210,280,47.6208,2090
450000.0,3,2.5,1530,0,8,1050,480,47.642,1610
350000.0,3,1.0,1180,0,7,1180,0,47.7276,1450
460000.0,4,2.5,2080,0,9,2080,0,47.4835,2550
385000.0,4,2.5,3200,0,8,1610,1590,47.3931,2030
272000.0,4,2.25,1880,0,7,1880,0,47.3214,1580
535000.0,3,2.5,2510,0,7,2510,0,47.6903,2660
216500.0,2,1.0,1060,0,6,1060,0,47.3688,910
325000.0,3,2.5,2130,0,8,2130,0,47.3406,1910
420200.0,3,1.75,1320,0,7,1320,0,47.7229,1370
258000.0,3,1.75,1040,0,6,1040,0,47.5111,1290
450000.0,3,2.0,1150,0,7,1150,0,47.6985,1230
720168.0,4,2.25,2120,0,7,1420,700,47.6893,1420
652000.0,3,2.0,2130,0,7,1330,800,47.6746,2010
569500.0,4,2.5,2340,0,8,2340,0,47.6314,2140
411000.0,4,1.75,2250,0,7,2250,0,47.3787,1550
524950.0,3,1.75,1890,0,7,1290,600,47.6831,1320
153000.0,2,1.0,1140,0,6,760,380,47.7369,1340
775000.0,3,2.5,2780,2,9,2780,0,47.5791,2630
338500.0,4,2.5,2390,0,8,2390,0,47.3677,2520
570000.0,3,1.75,2390,0,8,1500,890,47.6809,2040
653000.0,3,2.0,2680,0,9,1880,800,47.372,1570
435000.0,2,2.5,1560,0,8,1080,480,47.604,1560
207000.0,2,1.0,1130,0,6,1130,0,47.4997,1060
540000.0,2,1.0,1120,2,7,1120,0,47.619,3040
386000.0,4,2.25,2050,2,8,1770,280,47.3978,2230
265000.0,5,2.25,2600,0,8,2600,0,47.2961,2200
250000.0,3,2.25,1050,0,7,740,310,47.5549,1260
1697000.0,3,2.0,2600,4,10,1930,670,47.6055,2670
455000.0,4,2.5,2811,0,9,2811,0,47.3686,3040
1795000.0,4,3.25,4060,3,11,4060,0,47.581,3220
759000.0,3,2.0,2260,3,7,1130,1130,47.5886,2260
970000.0,4,2.75,4430,0,10,4430,0,47.6392,3820
280000.0,1,0.0,600,0,3,600,0,47.5316,990
690000.0,3,2.25,2430,0,9,1430,1000,47.5534,2550
789900.0,3,2.5,3420,0,10,1750,1670,47.5706,2900
447500.0,2,1.0,1180,0,7,1180,0,47.6947,980
440000.0,4,2.25,2010,0,7,1220,790,47.7328,1820
278000.0,3,2.0,1230,0,7,1230,0,47.3718,1470
980000.0,5,2.5,2750,0,8,1750,1000,47.6729,1520
245000.0,3,2.75,1300,0,7,860,440,47.3652,1550
287000.0,3,1.5,1150,0,7,1150,0,47.4629,1640
435000.0,3,1.75,2220,0,7,1110,1110,47.4853,2130
585000.0,3,2.5,2050,0,9,2050,0,47.5279,2410
616000.0,4,1.75,1700,0,8,1700,0,47.6539,1480
203000.0,3,1.75,1610,0,7,1100,510,47.3187,1610
860000.0,4,2.75,2720,0,8,1790,930,47.6624,1360
833000.0,4,2.5,2190,2,8,1170,1020,47.6627,2630
565000.0,4,2.75,2730,0,8,2730,0,47.7739,2520
572500.0,3,2.5,2490,0,9,2490,0,47.5355,2500
254000.0,4,2.0,1510,0,7,1510,0,47.546,1510
1525000.0,4,4.25,4720,4,11,4720,0,47.7591,3010
900000.0,4,3.0,3810,0,9,3810,0,47.7696,2580
899000.0,3,2.5,1950,0,9,1950,0,47.6731,2080
560000.0,3,2.0,1300,0,7,1300,0,47.5482,1230
512500.0,3,1.75,1610,0,7,1180,430,47.5966,1520
775000.0,4,2.5,2040,0,7,1180,860,47.6786,1540
200000.0,2,1.0,700,0,5,700,0,47.4953,960
172000.0,3,1.0,970,0,6,720,250,47.5285,1560
219900.0,3,1.0,910,0,6,910,0,47.5065,1090
641200.0,3,1.0,1060,0,7,1060,0,47.6218,1620
473000.0,5,3.25,2180,0,7,2180,0,47.7078,1840
540000.0,3,1.75,2050,0,8,1400,650,47.6212,1740
295000.0,2,1.0,750,0,6,750,0,47.607,1540
370000.0,3,1.0,800,0,6,800,0,47.6546,1480
1727000.0,4,2.25,3470,1,9,2360,1110,47.6149,3010
275000.0,3,1.5,1390,0,6,1390,0,47.5603,1440
89000.0,3,1.0,900,0,6,900,0,47.3026,900
175000.0,2,1.75,1050,0,6,1050,0,47.7595,1230
490000.0,3,2.5,2410,2,9,1600,810,47.3384,3090
342400.0,3,2.25,1180,0,7,1180,0,47.7352,2660
345000.0,3,1.0,1140,0,7,1140,0,47.6012,1510
399000.0,2,1.0,700,0,6,700,0,47.6212,1570
550000.0,4,2.5,2060,0,8,1320,740,47.5549,2050
652450.0,3,2.25,2230,0,8,1630,600,47.563,2190
438000.0,2,2.25,1950,0,8,1350,600,47.739,2125
605000.0,3,1.75,2100,2,7,1340,760,47.5743,1640
395000.0,4,2.5,2130,0,7,1330,800,47.512,1800
449950.0,3,2.0,1880,0,7,1880,0,47.6031,1680
651100.0,4,2.5,2310,0,9,2310,0,47.6299,2500
241000.0,3,1.0,880,0,6,880,0,47.4995,1130
3418800.0,5,5.0,5450,0,11,5450,0,47.6209,3160
268500.0,2,1.5,1290,0,8,660,630,47.6118,1860
200000.0,2,1.0,1010,0,6,1010,0,47.4815,1290
400375.0,4,1.75,1690,0,6,890,800,47.5296,1060
429000.0,2,1.75,1350,0,8,1350,0,47.7141,1665
230000.0,3,1.0,680,0,6,680,0,47.5982,1470
1200000.0,4,2.25,2860,0,10,2860,0,47.6451,2890
314200.0,1,1.0,610,0,5,610,0,47.6911,970
513000.0,4,2.5,2660,0,8,1880,780,47.439,1910
535000.0,2,1.0,1390,0,7,960,430,47.5567,1450
420000.0,6,3.0,2290,0,7,2290,0,47.565,1360
345950.0,3,2.5,2110,0,8,2110,0,47.3878,2110
483500.0,3,2.0,1200,1,7,600,600,47.5811,1730
695000.0,4,2.25,2360,3,8,1520,840,47.6771,1810
295000.0,4,2.5,2350,0,7,2350,0,47.4205,2000
434975.0,3,2.25,1590,0,7,1060,530,47.7742,1860
513000.0,3,2.5,1810,0,8,1810,0,47.5764,1810
360000.0,3,1.75,1900,0,8,1900,0,47.7455,1710
234900.0,3,1.0,1250,0,7,1250,0,47.5065,1040
963000.0,4,3.5,3280,0,10,3280,0,47.5642,3280
595000.0,2,1.5,870,0,7,870,0,47.6509,2090
942500.0,4,3.25,3570,2,10,3570,0,47.536,4100
1029000.0,4,3.25,3780,0,11,3780,0,47.521,3720
350000.0,3,1.0,1190,0,6,1190,0,47.5985,1680
416500.0,4,2.0,2280,0,8,2280,0,47.5003,1900
209900.0,3,1.0,1030,0,5,1030,0,47.375,1330
802000.0,3,1.75,2870,0,8,1840,1030,47.5788,2200
230000.0,4,1.5,1520,0,7,1520,0,47.3136,1370
489000.0,3,3.0,3700,0,9,3700,0,47.4286,2130
497000.0,3,1.5,2240,0,8,1620,620,47.7137,3200
250000.0,3,2.25,1920,0,8,1520,400,47.4562,2170
925000.0,3,3.0,2560,0,10,2110,450,47.633,2160
390000.0,4,2.5,1840,0,8,1840,0,47.4683,1840
415000.0,3,2.75,2080,0,7,2080,0,47.7698,2220
785000.0,3,2.0,1600,0,7,1600,0,47.5753,1800
575000.0,3,2.0,2168,0,8,2168,0,47.6561,1770
170000.0,2,1.0,860,0,6,860,0,47.5081,1100
750000.0,4,1.75,2100,0,7,1100,1000,47.6429,1890
230000.0,3,1.0,1140,0,7,1140,0,47.3112,1140
855000.0,4,3.0,3090,0,9,3090,0,47.6359,3120
235000.0,3,1.0,1330,0,6,1330,0,47.436,1490
335000.0,2,1.0,1360,0,5,1360,0,47.5229,1460
1195000.0,5,3.0,3420,0,9,2540,880,47.5333,3750
677000.0,4,2.0,2180,0,8,2060,120,47.5958,1370
575000.0,3,2.0,1800,0,7,1600,200,47.5447,1640
450000.0,2,1.0,1120,0,7,1120,0,47.5663,1120
817250.0,3,2.5,2980,0,8,2980,0,47.6769,2430
440000.0,4,2.25,2600,0,8,1810,790,47.7757,2580
526000.0,2,2.0,1550,0,7,1550,0,47.654,1180
762500.0,3,2.25,3330,0,10,3330,0,47.7262,3360
325000.0,4,2.5,2200,0,8,2200,0,47.3649,2460
840000.0,4,3.5,3840,0,11,3840,0,47.615,2430
377500.0,2,1.0,840,0,6,840,0,47.5441,1300
212500.0,3,1.5,1270,0,6,1270,0,47.422,1270
749400.0,4,2.5,3240,0,10,3240,0,47.719,3010
663000.0,3,2.5,2480,3,8,2480,0,47.4003,2350
1476000.0,3,2.25,4470,2,9,3240,1230,47.574,2930
261000.0,3,1.0,1780,0,7,1060,720,47.4932,1450
515000.0,4,2.5,1850,0,8,1850,0,47.735,2080
410000.0,3,2.25,2200,0,8,2200,0,47.3727,2060
336000.0,3,2.25,2760,0,8,2760,0,47.4504,2760
440000.0,2,1.0,1090,0,7,1090,0,47.696,1090
908950.0,4,2.75,3090,0,9,3090,0,47.5538,2890
554000.0,2,1.0,820,0,7,820,0,47.588,1750
387000.0,3,2.25,1445,0,7,1300,145,47.5348,1410
268643.0,4,2.25,1810,0,7,1810,0,47.4362,1660
514000.0,3,1.75,1620,0,7,920,700,47.681,1610
420000.0,2,1.75,1060,0,7,1060,0,47.6787,1760
199000.0,3,1.75,1050,0,7,1050,0,47.3816,1300
225000.0,3,1.0,1010,0,7,1010,0,47.4518,1260
320000.0,4,2.5,2050,0,8,2050,0,47.196,1970
204995.0,2,1.0,970,0,6,970,0,47.4025,1500
376000.0,3,2.0,1540,0,8,1540,0,47.5479,1560
705000.0,4,2.75,3000,0,9,3000,0,47.5582,3340
725995.0,4,2.5,3190,2,9,3190,0,47.5317,2630
285000.0,4,2.5,1870,0,7,1100,770,47.4521,1590
285000.0,4,2.5,2200,0,8,2200,0,47.3406,2310
731000.0,4,2.5,3070,0,9,3070,0,47.5902,3160
1564350.0,4,3.75,3730,3,10,2820,910,47.5355,3880
510000.0,4,2.5,2440,0,7,2440,0,47.725,1990
620000.0,2,1.0,990,0,7,990,0,47.6528,1920
1110000.0,3,4.0,4160,0,11,4160,0,47.6635,4300
796000.0,4,3.5,3670,0,9,2870,800,47.7022,1520
255000.0,3,1.5,910,0,5,910,0,47.4565,1580
807000.0,3,2.5,1940,0,9,1940,0,47.659,1410
315000.0,4,2.5,1780,0,9,1780,0,47.3774,2650
637000.0,3,2.25,2200,0,8,2200,0,47.7266,2290
2725000.0,4,4.25,6410,2,12,5610,800,47.5703,2270
490000.0,3,2.0,2070,0,8,1220,850,47.6492,2130
253000.0,3,1.75,2040,0,7,1020,1020,47.4681,1740
325900.0,4,2.5,2320,0,8,2320,0,47.3501,2150
425000.0,2,2.0,1440,0,7,870,570,47.5513,2020
215000.0,4,2.5,1700,0,7,1700,0,47.3638,1570
315000.0,4,2.5,1700,0,7,1700,0,47.3638,1570
724800.0,3,2.0,2050,0,8,1180,870,47.6436,1940
295000.0,2,1.0,800,0,6,800,0,47.7621,1220
509007.0,3,1.75,1800,0,8,1350,450,47.7165,1770
306000.0,5,2.0,1460,0,6,1460,0,47.3714,2250
205000.0,3,1.75,1290,0,7,1290,0,47.2889,1350
275000.0,3,1.5,1900,0,7,1200,700,47.4125,1670
685000.0,3,1.75,1480,2,8,1480,0,47.6018,1850
465000.0,4,2.5,2090,0,7,1220,870,47.7266,1740
560000.0,4,2.25,1950,0,8,1330,620,47.666,2170
458500.0,3,1.75,1250,0,7,1250,0,47.6325,1570
354000.0,3,1.0,990,0,6,990,0,47.6228,1100
441000.0,3,2.5,2740,0,9,2740,0,47.4349,2740
194000.0,3,1.75,1260,0,7,1110,150,47.5417,1540
316500.0,4,2.5,2150,0,8,2150,0,47.4053,1910
524950.0,3,1.75,1750,0,7,1230,520,47.6807,1480
1052000.0,3,2.25,2880,4,8,1920,960,47.5878,2880
925000.0,4,2.25,2590,0,9,2590,0,47.6351,2720
780000.0,3,1.75,2430,0,7,1830,600,47.674,1610
241000.0,2,2.0,1470,0,6,1470,0,47.349,1180
519000.0,3,2.75,2020,0,7,1270,750,47.4403,2020
286000.0,2,1.0,610,0,6,610,0,47.5469,870
400000.0,3,2.0,3000,0,8,1500,1500,47.7058,2400
255000.0,2,1.0,920,0,5,920,0,47.5245,1530
152000.0,3,1.75,1070,0,6,1070,0,47.5079,950
599000.0,4,2.0,3410,0,8,3410,0,47.6709,2350
330000.0,4,2.5,1820,0,7,1820,0,47.7346,1820
461000.0,2,1.0,1060,0,7,1060,0,47.7102,1980
620000.0,5,2.5,3070,0,9,3070,0,47.4721,2150
352500.0,4,2.5,2300,0,7,1840,460,47.4044,2120
435000.0,3,2.0,1610,0,7,1260,350,47.7188,1630
725000.0,5,2.75,2830,0,9,2830,0,47.7074,3150
300000.0,3,1.0,970,0,7,970,0,47.7335,2040
252000.0,3,2.5,1680,0,7,1680,0,47.3609,1550
464625.0,4,2.75,2040,0,8,1260,780,47.666,2470
340000.0,3,1.0,1450,0,7,1450,0,47.7443,1500
1325000.0,4,2.25,2870,0,9,1980,890,47.6329,2370
455000.0,5,2.0,1870,0,7,1120,750,47.5243,1860
495000.0,4,3.5,2490,0,8,2490,0,47.4161,1960
925000.0,4,2.5,3350,0,9,2640,710,47.688,1000
587000.0,4,2.75,3190,0,9,3190,0,47.523,3240
524000.0,3,1.75,1560,0,6,780,780,47.6515,1470
1030000.0,4,2.5,2750,0,9,1960,790,47.6709,2400
176000.0,2,1.0,920,0,8,920,0,47.3779,1310
249900.0,2,1.0,1140,0,6,1140,0,47.5187,1110
499500.0,3,2.5,2520,0,7,2520,0,47.743,2020
600000.0,5,3.5,3150,0,9,1620,1530,47.7469,3150
294000.0,4,2.5,2040,0,7,2040,0,47.473,1860
272000.0,4,2.0,1780,0,7,1780,0,47.4414,2210
390000.0,3,2.5,2240,0,8,2240,0,47.7433,1900
700000.0,4,2.5,3270,3,9,2320,950,47.409,2340
635000.0,5,2.75,3110,0,9,3110,0,47.543,3550
920000.0,4,1.5,1850,0,8,1660,190,47.6376,1970
500000.0,3,1.75,1570,0,7,1190,380,47.6881,1530
263500.0,2,1.0,750,0,6,750,0,47.5198,1020
975000.0,4,2.25,2240,0,10,2240,0,47.5516,2600
575000.0,3,2.5,1870,0,8,1870,0,47.5493,1940
822000.0,4,2.5,2683,0,9,2683,0,47.6982,2683
300000.0,3,1.0,1490,0,7,1490,0,47.7276,1280
487600.0,4,2.5,2340,0,8,2340,0,47.7325,2200
500000.0,4,2.0,1700,0,7,850,850,47.5774,1620
680000.0,2,2.0,1450,0,9,1450,0,47.6354,1490
419000.0,3,2.5,3310,2,9,3310,0,47.3049,3310
450000.0,4,1.75,1520,0,6,1520,0,47.6581,1530
650000.0,5,1.75,1260,0,7,1260,0,47.6452,1410
550000.0,3,1.75,1840,0,8,1840,0,47.67,1840
330000.0,4,2.0,1750,1,6,1070,680,47.5677,2090
282510.0,4,1.0,1450,0,6,1450,0,47.3818,1530
2385000.0,4,4.0,6330,2,13,4900,1430,47.6488,2200
230000.0,2,2.0,1260,0,7,1020,240,47.2593,1560
750000.0,4,1.75,2100,0,8,2100,0,47.567,1630
321000.0,4,2.5,2430,0,8,2430,0,47.3352,2100
2196000.0,4,3.25,4250,3,10,3350,900,47.5612,3790
245000.0,4,2.0,1830,0,7,1370,460,47.4878,1830
510000.0,2,1.0,1310,0,6,1310,0,47.6854,1550
751000.0,4,3.25,3090,0,9,2370,720,47.7058,3630
675000.0,4,2.5,2560,0,9,2560,0,47.5851,2790
295000.0,3,1.75,1930,0,8,1930,0,47.3317,2270
312000.0,2,1.0,1460,0,7,1260,200,47.7009,1580
730000.0,3,3.0,3460,0,9,2560,900,47.7315,3460
762500.0,5,3.5,3290,0,9,2670,620,47.7067,3090
150000.0,3,1.0,820,0,6,820,0,47.528,1470
270000.0,3,1.0,1480,0,6,760,720,47.7775,1480
400000.0,4,2.0,1420,0,7,1420,0,47.6325,1530
650000.0,3,2.5,2790,0,8,2790,0,47.5958,2620
530000.0,2,1.5,1390,0,8,970,420,47.5673,1610
248000.0,3,1.0,950,0,7,950,0,47.5746,1260
760000.0,4,3.5,3000,0,7,1780,1220,47.6748,1360
199000.0,4,1.0,1280,0,7,1280,0,47.4215,1540
240000.0,2,1.0,870,0,7,870,0,47.4493,1070
415000.0,3,1.5,1360,0,7,1360,0,47.6471,1580
228000.0,3,1.0,1000,0,7,1000,0,47.4825,1420
525000.0,4,2.5,2740,0,8,1980,760,47.7648,2170
399950.0,3,1.75,1560,0,7,810,750,47.7175,1440
781000.0,4,2.5,2590,0,9,2590,0,47.691,2360
827000.0,3,2.5,1850,0,9,1560,290,47.6831,1810
525000.0,5,2.25,2500,0,7,2500,0,47.7379,1980
671300.0,4,2.5,3280,0,7,3280,0,47.6798,2600
175000.0,2,1.0,670,0,5,670,0,47.5769,700
1100000.0,5,2.75,2890,0,10,2150,740,47.5476,3010
800000.0,5,2.5,3000,0,8,1500,1500,47.6249,2690
329950.0,4,2.5,1920,0,7,1920,0,47.3795,2200
445000.0,4,3.25,1960,0,7,1960,0,47.7291,1980
237000.0,3,1.75,2000,0,7,1140,860,47.3752,1060
1112500.0,6,4.0,3600,0,9,2610,990,47.6531,1430
438900.0,4,2.5,2740,0,9,2740,0,47.3535,3010
1280000.0,9,4.5,3650,0,8,2530,1120,47.6604,2510
600000.0,4,2.5,2310,0,8,2310,0,47.5498,1950
670000.0,4,2.5,2095,0,9,2095,0,47.6603,2095
519000.0,2,2.0,1560,0,8,1560,0,47.7111,1855
320000.0,3,2.25,1880,0,8,1390,490,47.4457,1910
270000.0,2,1.5,840,0,7,840,0,47.6955,840
1000000.0,3,2.5,2730,0,9,2730,0,47.6216,2360
330000.0,1,1.0,860,0,6,860,0,47.6146,1380
657500.0,3,2.0,2320,0,7,1510,810,47.6157,2160
450000.0,3,1.75,1540,0,7,1540,0,47.7663,3790
150000.0,3,1.0,890,0,5,890,0,47.7087,1330
792500.0,4,2.5,4290,0,10,4290,0,47.3585,3370
540000.0,3,2.5,1950,0,9,1950,0,47.7217,2650
229900.0,3,1.0,1010,0,7,1010,0,47.2742,1380
533000.0,4,2.5,2830,0,8,2830,0,47.3888,2830
239000.0,4,1.75,1500,0,7,1000,500,47.2918,1700
713900.0,3,2.5,3370,0,10,3370,0,47.4379,3350
427500.0,4,2.5,3160,0,9,3160,0,47.2582,2500
302000.0,3,1.0,1110,0,7,1110,0,47.754,1800
1150000.0,3,2.5,3830,0,11,3830,0,47.5663,2950
555000.0,3,2.5,3160,0,8,2650,510,47.7453,2720
495000.0,3,2.25,2100,0,7,2100,0,47.595,1650
495000.0,3,1.5,2240,0,7,2240,0,47.6762,2150
340000.0,2,0.75,1060,2,6,560,500,47.4285,750
464950.0,4,2.25,2350,0,9,2350,0,47.3533,2580
320000.0,4,2.5,1940,0,8,1940,0,47.2632,2400
440000.0,1,1.0,1160,0,7,1160,0,47.7433,1580
686000.0,3,1.5,1840,0,8,1840,0,47.7145,2100
555000.0,4,1.75,2260,0,8,1620,640,47.6224,1960
361500.0,2,1.0,840,0,6,840,0,47.6842,1390
1240000.0,5,3.0,2830,0,9,2460,370,47.6579,2900
154950.0,4,1.0,1600,0,6,1600,0,47.277,1410
247200.0,3,1.75,1370,0,7,1370,0,47.3664,1370
250000.0,3,2.25,1960,0,7,1490,470,47.2977,1580
590300.0,3,1.5,1470,0,7,1470,0,47.5602,1530
541125.0,5,2.75,2740,0,8,1370,1370,47.5563,2020
310000.0,2,2.5,1090,0,7,1090,0,47.5347,1410
704111.0,4,2.75,2460,1,8,1680,780,47.7021,2380
277500.0,3,2.25,1820,0,7,1820,0,47.331,1520
325000.0,4,2.75,1960,0,7,980,980,47.451,1480
289200.0,3,2.25,1760,0,7,1760,0,47.7468,1760
185000.0,1,1.0,720,0,6,720,0,47.5289,1170
1445000.0,4,3.5,3470,0,11,2500,970,47.6433,1940
420550.0,4,2.0,1370,0,7,1370,0,47.749,1280
603000.0,4,2.25,2370,0,8,1550,820,47.7684,1890
345000.0,3,1.0,1390,0,7,1230,160,47.6078,1780
650000.0,3,2.0,1840,0,7,920,920,47.6894,1480
589950.0,5,3.0,2790,3,7,1500,1290,47.4088,1620
309950.0,2,2.25,1460,0,8,1460,0,47.5395,1460
775000.0,3,2.5,2620,0,9,2620,0,47.4574,2620
590000.0,4,1.5,2230,0,7,1330,900,47.6996,1630
863500.0,4,3.0,3250,0,8,2420,830,47.6104,1260
517500.0,3,1.0,1190,0,7,1190,0,47.6453,1350
700000.0,3,3.0,2090,0,7,1290,800,47.6891,1570
699000.0,3,2.5,2580,0,10,2090,490,47.7259,1660
350000.0,3,2.5,2100,0,7,1690,410,47.7453,1970
795000.0,4,2.5,3160,0,10,3160,0,47.6365,3160
543000.0,3,2.5,2090,0,7,1360,730,47.7369,2090
325000.0,3,2.5,1570,0,7,1570,0,47.7364,1740
337500.0,3,1.0,1020,0,7,1020,0,47.5254,1240
425000.0,2,1.0,1300,0,7,1300,0,47.7281,1600
780000.0,3,2.5,2110,0,9,2110,0,47.5628,2560
259000.0,2,1.0,1210,0,5,1210,0,47.5044,2140
524400.0,4,1.75,1990,0,8,1850,140,47.5434,2090
260000.0,3,2.0,1630,0,7,1630,0,47.2638,1610
273000.0,2,2.0,1384,0,7,1384,0,47.7525,1078
639900.0,4,2.5,3380,0,10,3380,0,47.3511,3710
420000.0,4,2.5,2480,0,10,2480,0,47.3185,2990
510500.0,3,1.0,1270,0,7,1270,0,47.5874,1470
290000.0,4,1.0,1010,0,6,1010,0,47.742,1360
226000.0,3,1.75,1490,0,6,990,500,47.4917,1490
300000.0,2,1.0,820,0,6,820,0,47.7049,1520
407450.0,3,2.0,1810,0,7,1810,0,47.6393,1420
390000.0,4,2.25,3060,0,7,1530,1530,47.4879,1850
1058800.0,6,2.75,2980,4,8,2130,850,47.7599,2730
610000.0,3,2.5,3440,0,11,3440,0,47.2909,3990
239975.0,3,2.5,1820,0,7,1220,600,47.4318,1350
375000.0,3,2.5,2320,0,7,1480,840,47.504,1660
742500.0,4,2.5,2620,0,9,2620,0,47.5524,2640
450000.0,4,1.75,2190,0,8,2020,170,47.4979,1920
300000.0,3,2.25,1780,0,8,1780,0,47.4539,2080
216600.0,3,1.75,2200,0,7,1240,960,47.4119,1770
525000.0,3,1.75,1600,0,7,1600,0,47.6847,1670
455000.0,4,2.25,2450,2,8,1650,800,47.4559,1820
390000.0,4,2.25,2680,0,8,2680,0,47.4613,2980
450000.0,3,1.75,1850,0,7,880,970,47.7025,1450
382000.0,4,1.0,1740,0,7,1740,0,47.6058,1590
287000.0,3,2.25,1490,0,7,1170,320,47.7378,1590
460000.0,4,2.0,1960,3,8,1960,0,47.5538,2560
435000.0,3,2.25,1380,0,7,1380,0,47.6783,1930
575000.0,2,1.0,1510,0,8,1310,200,47.6371,1700
626700.0,3,1.5,1410,0,7,1410,0,47.6402,1370
352000.0,4,1.5,1440,0,7,1440,0,47.502,1440
650000.0,3,1.0,920,0,7,920,0,47.6322,1460
197000.0,3,1.0,1090,0,7,1090,0,47.288,1300
340000.0,8,2.75,2790,0,7,1470,1320,47.7565,1760
560000.0,3,2.0,1840,0,7,1840,0,47.6916,2300
354000.0,3,1.75,1340,0,7,1340,0,47.7186,1780
670000.0,4,2.5,2570,0,9,2570,0,47.6373,2760
769000.0,4,3.5,3010,0,9,3010,0,47.5533,2520
650000.0,4,2.5,2160,0,7,1080,1080,47.6662,1650
650000.0,3,1.75,2140,0,7,1290,850,47.6234,1960
289950.0,4,1.75,2090,0,7,1050,1040,47.4107,1710
300000.0,3,1.75,1810,0,7,1240,570,47.4674,1850
471000.0,4,1.75,1760,2,7,1070,690,47.5521,1860
639000.0,4,2.5,2500,0,9,2500,0,47.5759,2560
287000.0,2,1.0,930,2,7,930,0,47.506,1910
740000.0,4,2.5,3030,0,10,3030,0,47.578,2850
499922.0,3,2.0,1460,0,7,940,520,47.682,1460
675000.0,4,2.5,2940,0,9,2940,0,47.5627,2670
738515.0,5,2.75,3360,0,9,3360,0,47.7754,3360
445000.0,3,1.75,2110,0,8,1210,900,47.567,1660
1039000.0,4,2.25,2740,2,10,1980,760,47.7117,2790
346000.0,2,1.0,1070,0,7,880,190,47.5726,1160
450000.0,3,2.0,1680,0,7,1180,500,47.5536,1400
350000.0,4,2.5,2260,0,9,2260,0,47.3767,2650
2400000.0,4,3.5,5860,0,10,3690,2170,47.6287,4150
594950.0,4,2.25,2380,0,8,2380,0,47.5834,2250
1695000.0,5,3.0,3320,0,9,3320,0,47.6542,2330
219000.0,2,1.0,1050,0,7,1050,0,47.2887,1550
450000.0,4,2.5,2070,0,7,2070,0,47.531,2340
402000.0,4,2.25,1790,0,7,1790,0,47.5055,1400
275000.0,2,1.0,840,0,6,840,0,47.5531,1100
421500.0,3,1.5,990,0,7,990,0,47.6051,1490
560000.0,3,3.0,4120,2,9,3180,940,47.6804,2770
314000.0,3,1.75,1620,0,7,1620,0,47.4749,1660
287000.0,4,2.0,1340,0,7,1340,0,47.4905,1410
277000.0,4,1.0,1500,0,6,1500,0,47.4768,1330
337500.0,2,1.0,1300,0,7,1300,0,47.5697,1240
792000.0,4,2.75,3100,0,10,3100,0,47.6858,3140
435000.0,3,2.5,3380,0,8,2200,1180,47.7462,2060
313100.0,4,2.5,2660,0,7,1450,1210,47.4558,1870
575000.0,3,2.25,1700,0,7,1100,600,47.6784,1700
510000.0,4,2.5,1840,2,8,1240,600,47.7762,2010
299950.0,2,1.0,890,0,6,890,0,47.5311,950
1028000.0,3,3.0,2800,0,9,1580,1220,47.6493,2580
364000.0,4,1.75,2010,0,7,1340,670,47.7496,1500
335000.0,3,1.0,1380,0,7,1380,0,47.7479,1440
219950.0,3,1.0,1210,0,6,1210,0,47.4211,1430
215000.0,3,2.0,1280,0,7,1280,0,47.3889,1290
640000.0,4,2.5,4090,0,8,3670,420,47.2964,2430
535000.0,3,1.0,1580,0,7,1180,400,47.6505,1560
253000.0,4,2.0,1910,0,7,1140,770,47.3493,1540
650000.0,2,2.5,1740,2,8,1210,530,47.622,1640
672000.0,3,2.25,1130,0,8,1130,0,47.6845,1330
606000.0,3,1.75,1970,3,8,1130,840,47.7213,2280
292000.0,3,2.25,1780,0,8,1280,500,47.4762,1710
289950.0,3,2.0,1670,0,8,1670,0,47.3802,2290
257500.0,4,1.5,1360,0,7,1360,0,47.3168,1180
380000.0,3,2.5,1840,0,7,1290,550,47.7586,2160
360000.0,3,1.75,1255,0,8,1255,0,47.6958,1010
269500.0,3,1.75,1840,0,7,1240,600,47.3933,1980
449000.0,4,2.5,2960,0,9,2960,0,47.3596,2570
375000.0,4,1.5,1430,0,7,1430,0,47.7197,1540
2200000.0,5,4.75,5990,4,11,4050,1940,47.5554,3330
810000.0,4,2.5,3480,0,11,3480,0,47.7391,2930
994000.0,5,3.25,4260,0,10,4260,0,47.611,4020
275000.0,5,2.25,1820,0,7,1080,740,47.4058,1820
300000.0,2,1.0,1290,0,7,1290,0,47.6972,1290
380000.0,5,2.5,2130,0,7,2130,0,47.4726,1500
200000.0,3,2.0,1170,0,7,1170,0,47.4229,1440
635000.0,3,3.5,1730,0,9,1350,380,47.6224,1830
280000.0,2,1.0,880,0,6,880,0,47.5642,1190
574000.0,3,2.5,2380,0,8,2380,0,47.5372,2580
1050000.0,4,1.0,1330,0,6,1330,0,47.6223,2920
545000.0,3,2.25,1780,2,8,1780,0,47.4575,2440
271950.0,3,1.5,1220,0,7,1220,0,47.5467,2110
630000.0,5,1.75,2490,2,8,1540,950,47.336,2790
400000.0,2,1.0,1180,0,7,1180,0,47.7273,1600
334000.0,4,2.5,2310,0,8,2310,0,47.3321,2480
332500.0,4,2.0,1440,0,7,1440,0,47.5717,1300
525000.0,2,1.5,1620,0,9,1080,540,47.5892,1660
408000.0,3,2.5,2620,0,8,2620,0,47.3675,2190
846450.0,4,2.5,3710,0,9,3710,0,47.5596,3040
411100.0,3,1.5,1040,0,7,1040,0,47.5882,1580
409124.0,5,3.25,3320,0,8,2480,840,47.3904,2330
335950.0,2,1.5,800,0,7,800,0,47.5119,1190
480000.0,5,2.5,2040,0,7,1240,800,47.6544,1800
280000.0,2,1.75,1960,0,7,980,980,47.4234,1960
668000.0,4,2.5,2670,0,8,2670,0,47.5978,2670
750000.0,4,2.5,2930,0,8,2930,0,47.7199,2120
394475.0,2,1.0,830,0,6,830,0,47.6929,950
848000.0,5,1.75,2290,0,7,1980,310,47.664,2870
675000.0,3,1.5,2510,0,8,2510,0,47.6195,1740
175000.0,3,1.0,1280,0,6,1280,0,47.4491,1170
560000.0,4,1.5,1810,1,8,1350,460,47.5233,2020
538888.0,5,2.75,2080,0,8,2080,0,47.6288,2030
359000.0,4,1.75,1680,0,8,1680,0,47.4612,1840
300000.0,3,2.25,1660,0,7,1660,0,47.7362,1680
273000.0,3,2.5,1650,0,7,1650,0,47.3603,1930
670000.0,3,2.5,1420,0,9,1280,140,47.6265,1490
530000.0,4,2.25,2240,0,8,1740,500,47.6323,1890
625000.0,3,1.5,1230,0,7,910,320,47.667,1260
248000.0,3,1.0,1260,0,6,1260,0,47.4187,1520
533000.0,3,2.5,2060,0,8,2060,0,47.5793,1930
549950.0,4,3.5,3090,0,8,2190,900,47.7176,2200
485000.0,4,1.75,3220,0,8,2010,1210,47.7719,1660
353500.0,3,2.5,2020,0,7,2020,0,47.3848,1930
435000.0,2,1.75,1910,0,9,1910,0,47.6276,2580
241000.0,3,1.0,1150,0,6,1000,150,47.5075,1340
885000.0,4,2.75,2730,0,8,1550,1180,47.6737,1860
799200.0,6,3.0,2890,0,7,2290,600,47.6227,2180
760000.0,3,2.5,2280,0,8,1490,790,47.6362,2100
270000.0,2,1.0,1040,0,6,1040,0,47.519,1380
675000.0,4,1.75,2440,0,9,2040,400,47.6339,2040
499000.0,3,2.5,1720,0,8,1000,720,47.6631,1720
1202500.0,3,2.5,3430,0,10,3430,0,47.6477,3440
320000.0,4,2.5,2570,0,8,2570,0,47.3588,2570
890000.0,4,3.25,4360,0,10,2320,2040,47.4375,2410
275000.0,4,2.75,2060,0,7,1210,850,47.3424,1940
490000.0,4,2.5,3020,0,10,3020,0,47.363,3020
550000.0,3,2.5,2340,0,7,1540,800,47.6033,1590
390000.0,5,2.0,2400,0,7,1210,1190,47.5112,1760
277000.0,3,2.25,1610,0,7,1110,500,47.3683,1690
236000.0,3,1.75,1090,0,7,1090,0,47.2613,1660
265953.0,3,1.75,1470,0,7,1470,0,47.3096,2090
545000.0,3,2.25,1670,0,8,1240,430,47.6413,1910
535000.0,3,2.5,1850,0,8,1850,0,47.7163,1780
1450000.0,3,2.75,3940,4,9,2140,1800,47.5654,3390
490000.0,4,3.0,2330,0,9,1920,410,47.554,2330
319950.0,4,2.5,2020,0,6,2020,0,47.5223,1440
625000.0,3,1.5,1300,0,7,1300,0,47.6821,2280
248000.0,3,1.0,1180,0,7,1180,0,47.4233,1760
475000.0,3,1.75,1320,0,8,1320,0,47.6024,2050
410000.0,6,2.75,2520,0,7,1320,1200,47.7636,1820
670000.0,3,2.5,1680,0,9,1680,0,47.6604,1950
430000.0,3,2.5,2000,0,7,2000,0,47.4733,2000
313000.0,2,1.0,1180,0,6,1180,0,47.5321,1650
950000.0,3,3.25,3330,0,9,3330,0,47.5395,4340
751750.0,2,2.0,1880,0,8,1880,0,47.6238,1590
760000.0,4,2.5,2990,0,9,2210,780,47.5353,2990
310650.0,3,1.75,1510,0,7,1510,0,47.5069,1480
367500.0,4,3.0,3110,0,8,3110,0,47.3279,2820
580000.0,4,2.5,2150,0,8,2150,0,47.6962,2030
580000.0,3,2.25,1900,0,8,1200,700,47.6122,1310
665000.0,4,2.5,2720,0,10,2720,0,47.6293,2720
239950.0,3,2.25,1560,0,7,1560,0,47.3393,1920
470000.0,4,2.5,1990,0,8,1990,0,47.7678,2220
733000.0,3,1.75,1740,0,8,950,790,47.6816,1800
250000.0,4,2.0,2130,0,7,1350,780,47.4133,1550
402000.0,4,1.75,1510,0,7,1510,0,47.7651,1480
295000.0,5,3.5,2100,0,7,1410,690,47.5108,1410
355000.0,5,2.5,2344,0,8,1560,784,47.3185,2344
289000.0,3,1.5,1970,0,6,1970,0,47.4511,1850
376000.0,3,2.25,1470,2,7,1470,0,47.7162,1400
212700.0,2,1.0,940,0,7,940,0,47.5375,940
325000.0,3,1.75,1780,0,9,1780,0,47.367,2750
415000.0,4,2.5,2230,0,7,2230,0,47.7245,2490
935000.0,3,2.5,3570,0,8,2400,1170,47.7475,3140
372000.0,3,2.5,1920,0,7,1920,0,47.7317,2370
240000.0,3,1.5,1290,0,7,1020,270,47.4853,1770
334950.0,3,1.75,1880,0,7,1880,0,47.5089,1900
426500.0,4,2.5,2960,0,9,2960,0,47.3597,2750
430000.0,2,1.75,1840,2,8,1300,540,47.4382,2920
400000.0,3,1.5,1890,0,7,1090,800,47.5396,1750
455850.0,3,2.25,1820,0,7,1120,700,47.5684,1970
1965220.0,4,3.5,4370,1,10,3610,760,47.5876,2960
400000.0,3,1.75,1530,0,7,1530,0,47.7655,2100
397500.0,3,1.0,1030,0,7,1030,0,47.5742,1480
755000.0,3,2.5,2000,0,8,2000,0,47.6476,1560
287000.0,5,1.5,1730,0,7,1010,720,47.4646,1730
480000.0,4,2.5,3620,0,9,3620,0,47.3711,2590
490000.0,3,2.5,2040,0,8,2040,0,47.4833,2390
365000.0,3,2.5,2640,0,8,1680,960,47.441,2260
260000.0,3,2.5,1600,0,7,1600,0,47.4899,1600
505000.0,4,1.0,1480,0,7,1480,0,47.763,1820
260000.0,2,1.0,700,0,7,700,0,47.6147,1440
430000.0,2,1.0,700,0,7,700,0,47.6147,1440
905000.0,4,2.5,3520,0,10,3520,0,47.5535,3470
440000.0,3,2.0,1650,0,8,1650,0,47.6638,1750
439500.0,4,1.0,1360,0,7,1360,0,47.6878,1530
270000.0,3,2.0,1350,0,6,680,670,47.4919,1350
306500.0,3,2.5,1970,0,7,1970,0,47.3627,1980
380000.0,3,2.0,1470,0,8,1310,160,47.5653,1470
215000.0,4,1.75,1610,0,7,1610,0,47.3281,1220
299900.0,2,1.0,810,0,7,810,0,47.7289,1080
1450000.0,4,3.5,2820,0,10,2820,0,47.622,2630
239950.0,3,1.0,1900,0,5,1900,0,47.2738,1430
494000.0,4,2.5,1830,0,8,1540,290,47.7741,1990
317500.0,4,1.5,1730,0,7,1010,720,47.4996,1650
670000.0,4,2.5,2110,0,7,2110,0,47.6888,2350
650000.0,3,2.5,3060,2,9,3060,0,47.5401,3140
852000.0,4,2.5,2620,0,8,2620,0,47.5514,1670
250000.0,2,1.5,1088,0,7,1088,0,47.7094,1098
264950.0,3,1.5,1400,0,7,1400,0,47.4433,1620
582500.0,2,2.0,1540,0,7,1020,520,47.7044,1380
384000.0,3,2.5,1540,0,7,1300,240,47.586,1540
817000.0,3,1.5,2310,0,8,1790,520,47.6431,1930
320000.0,4,1.75,1730,0,7,1730,0,47.4756,1550
445800.0,4,2.25,2070,0,8,1470,600,47.7765,2140
263300.0,2,1.0,900,0,7,900,0,47.5273,1175
215000.0,3,1.0,860,0,6,860,0,47.7508,1170
842500.0,5,4.0,2980,0,7,2070,910,47.6736,1560
850000.0,5,4.0,2980,0,7,2070,910,47.6736,1560
386000.0,5,2.5,2740,0,7,2740,0,47.4199,1900
251100.0,4,2.5,1790,0,7,1790,0,47.3849,1680
435000.0,3,1.75,1750,0,7,1330,420,47.7421,1750
870000.0,4,4.0,3610,0,10,3610,0,47.5812,3530
800000.0,6,1.0,1430,0,7,1430,0,47.6255,2450
555000.0,3,1.75,1570,0,7,1570,0,47.6916,1610
280000.0,2,1.0,2280,0,7,2280,0,47.525,2360
356000.0,3,1.0,940,0,6,940,0,47.6744,1500
675000.0,4,2.5,2920,4,9,2920,0,47.5333,3100
605000.0,4,2.25,2260,0,9,2260,0,47.6415,2470
690500.0,5,2.0,2000,2,7,1280,720,47.6283,1680
437000.0,2,1.75,1440,0,8,1440,0,47.7143,1680
850000.0,5,2.0,2310,0,8,2310,0,47.6395,2810
350000.0,4,2.25,2300,0,7,1340,960,47.5895,1540
480000.0,2,2.25,1490,0,8,1490,0,47.5577,1820
379500.0,3,2.25,1830,0,8,1830,0,47.4786,1500
600000.0,5,4.5,4440,0,10,4440,0,47.4702,2720
1436000.0,4,3.5,4970,3,11,3930,1040,47.5496,3580
303000.0,2,1.5,1000,0,7,840,160,47.5708,1000
800000.0,4,2.5,4940,4,9,3450,1490,47.5095,2430
549000.0,2,2.0,1980,0,7,1220,760,47.6809,1280
324950.0,3,2.5,1560,0,7,1210,350,47.457,2070
170000.0,2,1.0,870,0,6,870,0,47.4906,1100
178000.0,3,1.0,840,0,6,840,0,47.3704,870
144000.0,3,1.0,1250,0,6,1250,0,47.4522,1188
1580000.0,4,2.75,3120,2,9,1980,1140,47.5389,3330
258000.0,2,1.0,750,0,6,750,0,47.5655,1100
345000.0,3,1.75,710,0,6,710,0,47.5194,900
470000.0,3,1.75,2290,0,8,1620,670,47.7735,2320
2903000.0,5,2.5,3750,4,10,3750,0,47.5379,3540
350000.0,3,1.5,980,0,7,980,0,47.7141,1390
225500.0,2,1.75,1590,0,7,1590,0,47.3177,1750
473000.0,2,1.0,940,0,6,720,220,47.6488,1180
279000.0,3,1.75,1750,0,7,1150,600,47.3997,1820
470000.0,3,1.0,1460,0,6,880,580,47.7009,1530
565000.0,3,1.75,1540,0,6,770,770,47.67,1510
695000.0,3,2.0,2560,1,8,1380,1180,47.5506,1780
315000.0,3,1.75,1660,0,7,1660,0,47.2559,2070
529000.0,3,2.5,1880,0,8,1880,0,47.5664,2130
750000.0,5,3.75,3500,0,8,3500,0,47.6745,3250
481500.0,3,2.25,1840,0,7,1840,0,47.7326,1840
211000.0,3,2.0,1060,0,7,1060,0,47.3897,1080
455000.0,3,2.25,1790,0,7,1390,400,47.7321,1940
238950.0,2,1.0,810,0,5,810,0,47.4909,890
722500.0,4,3.5,2600,0,8,1820,780,47.6948,2000
795000.0,4,2.5,3230,3,8,2000,1230,47.5755,3230
327500.0,4,2.25,2240,0,8,2240,0,47.361,2050
585000.0,4,3.0,3400,0,9,3400,0,47.3548,3400
775000.0,4,2.0,3140,1,7,1940,1200,47.6656,3300
645000.0,4,2.5,2780,0,8,2780,0,47.5989,2510
445000.0,4,2.75,2320,0,8,1670,650,47.7373,2070
257950.0,3,1.75,1370,0,7,1370,0,47.3815,1400
375000.0,5,1.75,2230,0,7,1230,1000,47.5055,1380
245000.0,3,2.5,1610,0,7,1610,0,47.3661,1610
725000.0,3,2.5,3410,0,11,3410,0,47.3228,2150
702000.0,4,2.5,2810,0,9,2810,0,47.614,2920
330000.0,3,1.75,1850,0,6,1850,0,47.4837,2660
940000.0,3,1.5,1790,0,8,1790,0,47.6332,1780
354500.0,3,1.0,1150,0,7,1150,0,47.7435,1600
279950.0,4,2.75,2420,0,7,2420,0,47.3109,1070
284000.0,3,2.25,1580,0,7,1180,400,47.3564,1470
480000.0,5,2.0,1760,1,8,1560,200,47.7597,2150
647500.0,5,2.0,1760,1,8,1560,200,47.7597,2150
625000.0,3,2.5,2750,0,9,2750,0,47.75,2780
152000.0,3,1.0,920,0,7,920,0,47.3623,1160
322000.0,3,1.0,960,0,7,960,0,47.7231,1740
445000.0,3,1.75,1120,0,7,870,250,47.6684,1470
595000.0,3,1.0,1560,0,7,1560,0,47.5936,1280
165000.0,3,1.0,1380,0,7,980,400,47.4339,1910
278500.0,4,2.5,1940,0,7,1940,0,47.3063,2060
517500.0,3,1.75,1810,0,8,1370,440,47.5322,2140
343566.0,2,1.0,1100,0,7,1100,0,47.5312,1240
286285.0,4,2.25,1980,0,7,1170,810,47.3207,1610
474905.0,4,1.5,1340,0,6,1340,0,47.6214,1210
550000.0,3,1.75,1680,0,7,1400,280,47.5535,1540
286000.0,4,2.5,2060,0,6,2060,0,47.2849,1530
900000.0,3,3.25,2620,0,8,1770,850,47.5836,2180
449950.0,3,2.25,1610,0,7,1610,0,47.5675,1610
259000.0,4,1.5,1490,0,7,1490,0,47.3684,1490
340000.0,3,2.25,1900,0,7,1540,360,47.4564,1480
785000.0,4,2.5,3440,0,9,3440,0,47.6969,3150
490000.0,2,1.0,1840,0,6,1130,710,47.6757,1320
344950.0,4,2.0,2330,0,7,1400,930,47.3782,2050
950000.0,3,2.0,2250,0,9,1880,370,47.6289,2690
810000.0,4,1.75,2000,4,7,1000,1000,47.5925,1690
998160.0,2,2.5,3010,3,9,1260,1750,47.5643,3010
377000.0,3,1.75,1680,0,8,1150,530,47.5199,2100
595000.0,3,2.0,1530,0,8,1530,0,47.6653,2240
313300.0,2,1.0,970,0,6,970,0,47.5754,1180
360000.0,5,1.75,1550,0,7,1550,0,47.554,1220
188000.0,3,1.75,1660,0,8,1660,0,47.3118,1840
755000.0,3,2.5,3680,0,9,3680,0,47.6903,2410
1289000.0,5,3.5,3210,2,10,2290,920,47.6801,1940
455000.0,3,1.0,1480,0,6,1480,0,47.5378,1510
817500.0,5,3.5,3600,3,10,2680,920,47.6582,3420
550000.0,3,2.25,1700,0,8,1700,0,47.6598,1560
260000.0,3,1.75,1680,0,8,1240,440,47.3107,2020
320000.0,3,2.0,1550,0,7,1550,0,47.4855,2300
1153000.0,3,3.25,3780,1,11,2650,1130,47.5506,3850
362000.0,4,2.5,2360,0,7,1460,900,47.7201,1590
503500.0,3,2.5,1810,0,7,1350,460,47.6513,1640
653000.0,3,2.5,2290,0,9,2290,0,47.5551,2340
760000.0,4,2.75,3370,0,10,3370,0,47.7309,3700
775000.0,4,1.75,2090,0,7,1090,1000,47.6802,1760
1339000.0,4,3.75,2130,4,9,2130,0,47.5489,3030
417500.0,5,1.75,2060,0,7,1360,700,47.7767,2060
525000.0,3,1.5,1560,0,7,1220,340,47.6729,1870
217000.0,2,1.0,730,1,4,730,0,47.35,1220
525000.0,4,2.75,2910,0,8,1640,1270,47.7352,1970
442500.0,4,2.25,2490,0,7,1890,600,47.7397,1470
525000.0,4,1.75,1710,0,7,1710,0,47.5756,1480
425500.0,4,1.75,1520,0,7,1520,0,47.7347,1550
710000.0,3,2.75,2930,2,8,2930,0,47.5481,2450
545000.0,4,3.0,3160,3,8,1930,1230,47.3733,2380
410000.0,5,2.75,2910,0,8,2910,0,47.44,1980
245000.0,3,2.25,1700,0,7,1200,500,47.3601,1700
194900.0,2,1.0,810,0,6,810,0,47.3057,1140
284000.0,4,2.5,2000,0,7,2000,0,47.3732,2330
280000.0,2,1.75,1894,0,6,1520,374,47.3088,1820
280000.0,3,1.75,2080,0,6,1040,1040,47.6724,2080
360000.0,4,2.0,1730,0,7,1010,720,47.5304,1080
405000.0,2,1.0,720,0,6,720,0,47.6604,1460
865000.0,4,2.5,3560,0,10,3560,0,47.6002,3840
483300.0,4,2.0,1210,0,7,1210,0,47.5747,1280
355000.0,4,2.5,2130,0,8,2130,0,47.262,2100
274950.0,3,2.25,1570,0,7,1180,390,47.3568,1570
1925000.0,3,4.5,3950,3,11,2880,1070,47.6413,3050
755000.0,3,3.25,3450,0,11,2690,760,47.4294,3560
1940000.0,4,5.75,7220,4,12,6220,1000,47.7097,2680
309212.0,3,1.75,1150,0,7,1150,0,47.4434,1520
219950.0,3,2.25,1500,0,7,1150,350,47.3146,1540
690000.0,3,2.5,1300,0,7,1300,0,47.6838,1400
250800.0,3,1.75,1290,0,6,1170,120,47.5309,1140
557500.0,3,2.0,2510,2,9,2510,0,47.4012,3140
941000.0,4,1.75,2320,0,8,1820,500,47.6659,1940
3650000.0,6,4.75,5480,4,11,3910,1570,47.6515,3510
305000.0,4,2.75,2030,0,7,1230,800,47.3942,1810
815000.0,4,1.5,2060,0,8,2060,0,47.5983,2060
1015000.0,3,2.5,2920,4,9,1800,1120,47.5799,2480
1240000.0,4,3.0,3330,3,9,2330,1000,47.5886,2620
535000.0,3,2.5,2110,0,9,2110,0,47.5269,2390
775000.0,3,1.0,1175,0,6,1175,0,47.6388,2010
255000.0,3,2.0,1590,0,7,1590,0,47.3725,1590
327000.0,2,1.0,1070,0,7,1070,0,47.7532,1500
560000.0,4,2.0,2720,3,8,2240,480,47.338,2960
1339000.0,4,3.5,2980,3,9,2980,0,47.6819,2870
199500.0,3,1.75,1160,0,7,1160,0,47.3643,1470
760000.0,4,2.5,3580,0,9,3580,0,47.3901,2510
439000.0,3,2.25,3020,2,8,1980,1040,47.5249,1150
527000.0,4,2.25,2380,0,7,1410,970,47.6164,2150
199950.0,3,2.75,2270,0,6,1300,970,47.2099,1160
254000.0,3,2.25,1660,0,7,1660,0,47.3766,1660
393000.0,2,1.0,830,0,7,830,0,47.6914,1110
585000.0,5,2.25,2480,0,8,1860,620,47.7393,2470
450000.0,2,2.0,1900,0,7,1150,750,47.5227,1140
565000.0,2,1.75,1670,0,9,1670,0,47.5539,2330
330000.0,5,2.25,2000,0,7,1300,700,47.4291,2000
870000.0,3,2.0,2320,0,9,2320,0,47.6106,3100
585000.0,4,2.5,1860,0,8,1460,400,47.6228,2040
500000.0,3,2.5,2110,3,9,2110,0,47.2674,2390
225000.0,3,2.0,1400,0,7,1150,250,47.4655,1820
295000.0,3,2.0,1400,0,7,1150,250,47.4655,1820
775000.0,3,2.75,2850,0,9,1920,930,47.559,3300
280000.0,3,1.0,1370,0,7,1370,0,47.4485,1520
539000.0,3,2.5,2170,0,7,1280,890,47.6543,1180
567500.0,3,1.75,2570,2,8,2570,0,47.4335,2550
442500.0,4,2.25,1970,0,8,1310,660,47.7249,1860
598200.0,5,3.75,2980,0,8,2980,0,47.5508,1100
610000.0,4,2.5,2300,0,8,2300,0,47.6988,1780
544900.0,3,2.5,1990,0,8,1990,0,47.5911,2250
557500.0,4,2.5,2390,0,8,2390,0,47.7433,1960
532500.0,3,2.5,2160,1,7,1430,730,47.6188,1560
1350000.0,4,3.25,3300,0,10,3300,0,47.5413,2740
750000.0,3,2.0,1840,0,7,1040,800,47.6428,1820
530000.0,3,2.5,2030,0,8,2030,0,47.7251,1960
346100.0,3,2.5,1400,0,7,1400,0,47.5516,1500
260000.0,4,2.25,2320,0,9,2320,0,47.2959,2700
365000.0,3,1.75,1410,0,7,1410,0,47.5683,1800
615000.0,3,2.0,1860,0,7,930,930,47.5898,1980
318400.0,4,2.5,1820,0,7,1820,0,47.3862,1680
498500.0,4,2.5,1910,0,8,1910,0,47.7615,1630
450000.0,3,1.75,1540,0,7,1540,0,47.7222,1270
200000.0,3,2.0,1430,0,7,1430,0,47.2757,1870
234000.0,3,1.0,1010,0,7,1010,0,47.3627,1150
121800.0,2,1.0,940,0,5,940,0,47.5065,1290
805000.0,3,2.75,2600,2,8,1600,1000,47.5773,2260
410000.0,4,2.25,2060,0,8,1220,840,47.7435,1500
475000.0,3,2.5,1920,0,8,1920,0,47.7144,1380
1337500.0,4,2.5,2900,0,11,2900,0,47.6696,3390
269000.0,1,1.0,1020,0,7,1020,0,47.5385,1000
573000.0,4,2.25,2150,0,8,2150,0,47.6885,2000
330000.0,3,2.5,1660,0,7,1660,0,47.5434,1540
252750.0,4,1.0,1230,0,7,1230,0,47.4798,1020
745000.0,2,2.5,2170,0,8,2170,0,47.7242,2170
280000.0,3,2.0,1280,0,7,1280,0,47.3883,1450
535000.0,4,2.5,2240,0,8,1380,860,47.5011,1540
580000.0,4,1.5,1780,0,7,1320,460,47.6944,1880
301000.0,3,1.75,1840,0,7,1220,620,47.456,1770
600000.0,4,1.75,1740,0,7,1740,0,47.6259,1740
538900.0,5,3.0,3040,0,9,3040,0,47.548,1650
366000.0,3,2.5,2370,0,8,2370,0,47.354,2380
303000.0,4,2.5,2100,0,8,2100,0,47.3504,2100
432000.0,3,2.25,1470,0,8,1090,380,47.5388,1470
300000.0,2,1.5,1300,0,6,820,480,47.5088,1250
908800.0,3,3.0,3420,0,8,2430,990,47.5873,980
500000.0,3,1.5,1190,0,7,970,220,47.6726,1460
254000.0,5,2.0,2080,0,7,1740,340,47.3424,1510
470000.0,5,1.5,2180,0,7,1340,840,47.6848,1530
480000.0,3,2.0,1460,0,7,1460,0,47.6233,1850
536000.0,3,1.75,1530,0,7,1150,380,47.6872,1610
1349000.0,4,3.5,4740,3,11,3640,1100,47.5375,4042
550000.0,3,2.25,1980,0,8,1980,0,47.6478,2460
260000.0,3,1.75,1710,0,7,1240,470,47.3036,1600
284900.0,2,1.5,1160,0,7,890,270,47.7675,1160
740000.0,3,2.5,2200,0,9,1530,670,47.6451,2200
425000.0,2,1.0,1170,0,7,1030,140,47.5449,1170
230000.0,3,1.0,1120,0,7,1120,0,47.5112,1120
675000.0,3,1.5,1710,0,8,1710,0,47.5714,1910
267500.0,3,1.75,1650,0,7,1650,0,47.3514,1810
814000.0,4,2.5,2840,2,8,1420,1420,47.5542,2310
1250000.0,4,3.0,3310,0,9,3310,0,47.6616,2810
460000.0,3,2.0,1860,0,7,1320,540,47.7165,1830
445000.0,3,2.5,2250,0,8,2250,0,47.4865,2020
715000.0,3,2.5,2890,0,8,2890,0,47.6111,2890
425000.0,3,1.75,2120,0,7,1060,1060,47.7083,1840
370000.0,4,2.5,2130,0,8,2130,0,47.4324,2130
302000.0,2,1.75,1170,0,6,780,390,47.3263,1780
453000.0,4,1.75,2120,0,7,1060,1060,47.6019,1540
290000.0,3,1.75,1280,0,7,1280,0,47.4755,1440
1035000.0,4,2.5,3170,0,10,3170,0,47.6495,3190
925000.0,4,2.25,2260,0,9,2260,0,47.6622,2650
600000.0,3,1.75,2930,0,9,2030,900,47.7443,2740
354000.0,3,1.5,1060,2,7,1060,0,47.5512,1060
204950.0,4,1.75,1740,0,7,1180,560,47.3196,1440
675000.0,4,2.5,2990,0,8,2990,0,47.6122,2890
995000.0,4,3.25,3530,0,11,3530,0,47.7193,3850
800000.0,5,2.0,2960,0,7,1500,1460,47.6162,2160
472500.0,3,2.5,1650,0,8,1650,0,47.6863,1760
549950.0,4,2.5,2720,0,8,1510,1210,47.6191,2510
575575.0,3,1.75,1516,0,7,998,518,47.6842,2100
545000.0,4,3.25,4386,0,10,2356,2030,47.3329,3060
340000.0,3,2.25,2580,0,7,1630,950,47.7446,1920
225000.0,3,1.0,960,0,6,960,0,47.4944,1090
299950.0,2,1.75,1460,0,7,1460,0,47.4048,1460
829900.0,4,3.5,3840,0,8,2640,1200,47.6642,1620
340000.0,4,2.5,2090,0,7,2090,0,47.3659,2090
515000.0,4,2.25,2470,0,8,1470,1000,47.6913,2050
601000.0,4,2.5,2090,0,8,2090,0,47.5718,2090
470000.0,3,2.5,2070,0,8,2070,0,47.5101,2440
371500.0,3,1.0,1650,0,7,980,670,47.52,1230
550000.0,3,1.75,1880,0,8,1410,470,47.7662,2340
242550.0,4,2.5,2060,0,8,2060,0,47.2956,1630
367500.0,3,1.5,1410,0,8,1410,0,47.7608,2090
359000.0,4,3.5,2770,0,8,2100,670,47.2625,2030
204900.0,3,2.0,1390,0,7,1390,0,47.2669,1260
850000.0,4,2.75,5440,0,9,2720,2720,47.354,1970
187000.0,3,1.5,1280,0,6,1280,0,47.3344,1070
326000.0,3,2.75,1720,0,7,1720,0,47.4375,2000
340000.0,3,2.75,1720,0,7,1720,0,47.4375,2000
330000.0,6,2.25,3040,0,8,1890,1150,47.3864,1360
782000.0,4,3.5,3780,0,9,3110,670,47.691,3310
612000.0,4,2.5,2670,0,8,2670,0,47.7122,2140
400000.0,3,2.0,1350,0,7,1350,0,47.7616,1920
941500.0,5,3.5,3490,4,9,2460,1030,47.7757,3080
313000.0,2,1.5,870,0,8,800,70,47.6967,1710
735000.0,4,2.25,2410,0,7,1460,950,47.6849,1360
471000.0,3,1.75,1640,0,8,1340,300,47.7698,2210
350000.0,3,1.0,1540,0,7,1540,0,47.7604,1560
530000.0,4,2.5,2370,0,8,1570,800,47.5327,2550
415000.0,4,3.0,1830,0,7,1830,0,47.7379,1740
639500.0,4,2.25,2330,0,8,2330,0,47.7264,2330
580379.0,4,2.75,2240,0,8,2240,0,47.5936,2330
378000.0,2,2.5,1700,0,8,1700,0,47.5163,1760
265000.0,3,2.25,1750,0,7,1410,340,47.4579,1720
212000.0,3,1.75,1100,0,6,1100,0,47.2955,1100
400000.0,4,3.0,2320,2,8,2320,0,47.3497,2220
750000.0,4,2.5,2540,0,8,2540,0,47.6363,1990
384900.0,5,2.5,3090,0,8,1750,1340,47.3408,1760
176000.0,2,1.0,770,0,6,770,0,47.3627,1150
350000.0,3,2.75,2370,0,7,2370,0,47.3794,2290
168000.0,3,1.0,1200,0,6,1200,0,47.3729,1200
358000.0,4,2.0,2200,0,7,1100,1100,47.565,1410
580000.0,3,2.75,2660,0,8,2660,0,47.7649,2720
442500.0,3,1.75,1600,0,7,1050,550,47.725,1590
515000.0,2,2.5,1330,0,8,1330,0,47.6668,1430
554000.0,5,2.5,3440,2,8,1720,1720,47.4426,2100
659000.0,3,2.5,2510,0,9,2510,0,47.5868,2518
414999.0,4,2.5,2150,0,7,1090,1060,47.7166,1880
275000.0,3,1.5,1180,0,6,1180,0,47.488,1680
193000.0,2,1.0,680,0,5,680,0,47.4559,1320
525000.0,4,2.5,2840,0,9,2840,0,47.4511,2460
424000.0,3,2.5,1820,0,8,1820,0,47.7155,2040
455000.0,2,1.0,1070,0,6,870,200,47.6853,1520
463000.0,2,1.0,1250,1,7,1250,0,47.5495,1210
1100000.0,4,2.5,2190,3,7,1240,950,47.6918,2730
523000.0,3,1.75,3000,0,8,1900,1100,47.6962,1550
615000.0,4,1.75,2270,0,8,2270,0,47.5999,2540
1515000.0,4,4.0,4500,0,12,4500,0,47.5533,3930
870000.0,5,4.0,3400,0,8,2320,1080,47.6655,1910
710000.0,3,2.5,2830,0,10,2830,0,47.6249,2970
215000.0,3,1.0,960,0,7,960,0,47.2864,1280
590000.0,2,1.0,1530,0,7,1530,0,47.6833,1530
323000.0,5,2.5,2500,0,7,1300,1200,47.3343,2440
279000.0,4,2.0,1560,0,7,1560,0,47.4496,1480
535100.0,3,2.25,2070,0,8,1720,350,47.7735,2350
830000.0,5,2.25,2710,0,9,1910,800,47.5958,2120
815000.0,4,2.5,3150,0,9,3150,0,47.688,3150
535900.0,3,2.25,1880,0,8,1480,400,47.5937,2120
230000.0,3,1.0,1250,0,7,1250,0,47.497,1480
325500.0,4,1.75,2290,0,7,1490,800,47.4564,1840
359000.0,3,2.25,1990,0,7,1990,0,47.4917,1690
505000.0,3,2.5,2100,2,8,2100,0,47.5334,1890
253905.0,3,1.0,940,0,7,940,0,47.5112,950
369950.0,3,1.75,1640,0,8,1200,440,47.7125,1480
350000.0,3,2.25,1860,0,7,1860,0,47.3875,1870
650000.0,4,2.25,2100,0,8,2100,0,47.6726,1660
295000.0,3,1.75,1500,0,6,1500,0,47.4367,1500
620000.0,3,1.75,1680,3,8,1180,500,47.7648,2190
1998000.0,2,2.5,3900,0,12,3900,0,47.5371,2720
246000.0,3,1.0,1400,0,6,1400,0,47.4798,1070
430000.0,3,2.75,2600,0,7,1350,1250,47.695,2260
509990.0,3,2.0,1440,0,6,1440,0,47.5503,1360
490000.0,4,1.75,1870,0,7,1090,780,47.7012,2010
385000.0,4,2.75,2960,1,8,2360,600,47.4006,1870
769000.0,4,2.5,2440,0,9,2440,0,47.6374,2570
185000.0,2,1.0,1122,0,6,1122,0,47.328,840
303500.0,3,1.5,1060,0,7,1060,0,47.7313,1420
468000.0,4,2.5,2150,0,8,1430,720,47.773,2360
449950.0,4,2.5,3100,0,9,3100,0,47.3741,1850
235000.0,2,1.5,880,0,7,880,0,47.7064,880
520000.0,4,2.5,2490,0,9,2150,340,47.4823,2490
203000.0,2,1.0,1080,0,6,1080,0,47.4815,1080
657000.0,5,2.5,2530,0,7,1290,1240,47.616,2040
275000.0,3,1.0,1200,0,7,1200,0,47.5196,1230
540000.0,4,2.25,2850,0,9,2850,0,47.7439,2700
455000.0,4,2.5,2950,0,7,2950,0,47.5002,2360
458500.0,2,1.75,1160,0,7,860,300,47.6937,1250
549900.0,4,3.5,3420,0,10,3420,0,47.4734,3490
750000.0,3,1.75,2240,0,8,1550,690,47.6954,1570
235000.0,4,1.75,1450,0,7,1180,270,47.478,1450
286000.0,4,2.5,1820,0,7,1820,0,47.359,1490
2650000.0,4,3.5,4700,3,11,3500,1200,47.6899,3210
602000.0,4,1.75,2430,0,7,1580,850,47.6554,1910
640000.0,3,1.5,1960,0,7,1960,0,47.6768,1880
267000.0,3,1.75,1440,0,8,1440,0,47.3812,1720
712000.0,4,2.5,2730,0,8,2730,0,47.5975,2670
244500.0,2,1.0,910,0,5,910,0,47.526,1290
301000.0,2,1.0,910,0,5,910,0,47.526,1290
990000.0,4,2.5,2430,0,8,2020,410,47.6413,2340
739999.0,4,2.75,3350,0,10,3350,0,47.5838,2960
480000.0,4,1.75,2320,0,7,1140,1180,47.5755,1820
305000.0,3,2.5,1260,0,8,1260,0,47.7325,1340
703300.0,3,2.0,1980,0,8,1590,390,47.6847,1760
265000.0,4,1.5,1580,0,7,1580,0,47.3336,1580
600000.0,4,2.5,2710,2,9,2710,0,47.4815,2330
253000.0,3,1.0,1400,0,7,1400,0,47.3862,1640
617950.0,4,2.5,2410,0,8,2410,0,47.7185,1920
385000.0,4,3.25,1790,0,7,1100,690,47.534,1260
319000.0,3,2.0,1640,0,7,1060,580,47.5162,2230
696000.0,3,2.5,1670,0,7,1170,500,47.615,1960
345000.0,2,1.0,970,0,6,970,0,47.5518,1650
380000.0,3,2.5,1610,0,7,1610,0,47.6902,1120
647500.0,4,1.75,2060,0,8,1160,900,47.4444,2590
725000.0,3,2.5,3570,0,9,3570,0,47.4782,3510
269950.0,3,1.75,1400,0,7,1400,0,47.357,1530
875000.0,4,2.5,3470,0,10,3470,0,47.7311,3800
299950.0,3,1.0,1210,0,7,1210,0,47.5274,1680
1875000.0,4,3.25,3930,0,10,3930,0,47.6259,1780
430000.0,2,1.0,990,0,7,990,0,47.6876,1180
495000.0,5,2.5,2200,0,8,2200,0,47.5772,2200
275000.0,3,1.5,1510,0,7,1510,0,47.3926,1650
333000.0,3,1.0,1620,0,7,1120,500,47.5263,1790
247000.0,3,2.25,1580,0,7,1580,0,47.2843,1730
204555.0,3,1.75,1260,0,7,1260,0,47.2737,2400
432000.0,3,2.0,2190,0,9,2190,0,47.3542,2770
175000.0,3,1.75,1230,0,7,1230,0,47.3171,1690
556300.0,4,2.5,2030,0,7,1400,630,47.6244,1800
286000.0,2,1.0,780,0,5,780,0,47.4944,1210
320000.0,2,1.5,1110,0,8,1110,0,47.6931,1110
815000.0,3,2.5,2790,0,9,2790,0,47.7687,2740
385000.0,4,1.75,1660,0,7,1000,660,47.5071,1880
1039000.0,4,1.0,3410,0,8,2190,1220,47.5807,2550
350000.0,4,2.25,2390,0,8,2390,0,47.3111,2450
277000.0,4,2.5,1850,0,8,1850,0,47.3322,2370
415000.0,6,2.0,2500,0,8,1250,1250,47.5517,1800
295000.0,3,1.0,1000,0,6,1000,0,47.7548,1090
969000.0,4,2.0,2450,4,8,2200,250,47.5619,2360
339888.0,4,1.75,1440,0,6,720,720,47.5257,960
269950.0,3,2.25,1660,0,7,1660,0,47.3599,1840
1185000.0,3,2.5,2510,2,10,2510,0,47.7051,2560
780000.0,4,2.5,3090,0,10,3090,0,47.5932,3100
198000.0,3,1.0,860,0,6,860,0,47.3634,1120
350000.0,2,1.0,1220,0,7,1220,0,47.4952,2740
350000.0,3,1.0,1010,0,7,1010,0,47.732,1320
319000.0,4,2.25,2390,0,8,2390,0,47.2938,2390
311000.0,4,2.25,3340,0,8,3340,0,47.317,2230
394000.0,5,3.25,3620,0,8,2790,830,47.3552,2850
1335000.0,5,2.25,4200,0,9,2910,1290,47.6284,3060
2700000.0,5,2.75,3831,4,9,3831,0,47.5919,3850
396000.0,3,1.0,1980,0,7,1080,900,47.7551,1680
809000.0,4,1.75,1790,0,8,1340,450,47.6605,2180
480000.0,3,2.0,1580,0,7,1050,530,47.6715,1560
535000.0,6,1.75,2460,0,7,1230,1230,47.6721,1560
425000.0,5,2.75,2110,0,7,1870,240,47.5294,1580
408000.0,3,2.5,1470,0,8,1470,0,47.6998,1460
1255000.0,4,2.5,3510,0,10,3510,0,47.5306,3230
310000.0,1,0.75,520,0,6,520,0,47.6886,980
292000.0,3,2.5,1950,0,8,1950,0,47.3842,2200
217000.0,2,1.0,770,0,6,770,0,47.4924,1140
398500.0,4,2.5,2250,0,8,2250,0,47.4956,1520
2250000.0,3,3.0,4040,2,9,3340,700,47.6288,3450
700000.0,4,1.75,2360,0,7,1280,1080,47.6465,1700
585000.0,4,2.5,2330,0,9,2330,0,47.5842,2930
399950.0,3,1.0,1720,0,7,1720,0,47.7736,1870
235000.0,3,1.75,1900,0,6,950,950,47.4868,1370
212000.0,3,1.0,1040,0,6,1040,0,47.492,1430
310000.0,3,2.0,2070,0,8,1220,850,47.6491,2080
539000.0,3,2.0,2070,0,8,1220,850,47.6491,2080
390000.0,3,3.0,1550,0,8,1280,270,47.6042,1940
560000.0,3,2.5,2020,0,9,2020,0,47.632,2410
800000.0,5,2.5,3320,0,9,3320,0,47.5865,3320
1900000.0,4,3.25,4130,0,11,4130,0,47.6392,3140
472000.0,5,2.0,2030,0,7,1110,920,47.6297,1930
502550.0,3,1.75,1770,0,7,1170,600,47.606,1670
830000.0,4,3.25,3330,0,9,3330,0,47.5977,3100
224950.0,4,2.5,2260,0,7,1520,740,47.286,1750
375000.0,3,2.5,1950,0,8,1950,0,47.7603,1950
645000.0,3,2.5,2930,0,9,2930,0,47.7234,3160
599000.0,3,2.75,1960,0,7,1410,550,47.6744,2040
515000.0,4,2.5,2980,0,9,2980,0,47.3999,2630
135000.0,2,1.0,780,0,5,780,0,47.305,880
485000.0,3,2.5,1650,0,8,1650,0,47.5998,1650
890000.0,3,3.25,4030,0,9,2800,1230,47.6331,2670
215000.0,3,1.0,1010,0,7,1010,0,47.3423,1230
299500.0,3,1.0,1190,0,7,1190,0,47.4805,1360
800000.0,2,1.0,1050,0,7,1050,0,47.6294,3360
275000.0,3,2.5,1560,0,7,1560,0,47.3834,1670
256400.0,3,1.5,1490,0,7,1010,480,47.3431,1570
310000.0,2,1.0,770,0,6,770,0,47.7439,820
385000.0,1,1.0,620,0,6,620,0,47.5699,1540
203000.0,3,1.5,1200,0,7,1000,200,47.4545,1640
285000.0,4,2.0,2120,0,7,1060,1060,47.7775,1460
473975.0,3,2.5,2330,0,8,2330,0,47.6022,1830
320000.0,3,1.75,2000,0,8,1400,600,47.4417,1890
599000.0,5,2.75,2820,0,7,1450,1370,47.6886,1620
580000.0,3,2.0,2040,0,7,1020,1020,47.5561,1640
269500.0,4,2.25,1700,0,7,1700,0,47.3385,1650
274000.0,2,1.0,820,0,6,820,0,47.4163,1410
347000.0,2,1.75,1315,0,8,1315,0,47.752,1640
270000.0,3,1.75,1390,0,6,860,530,47.5517,1390
1430000.0,3,2.0,1890,2,8,1890,0,47.6203,2000
220000.0,3,1.75,1460,0,7,1460,0,47.3839,1760
243000.0,3,1.0,1480,2,8,1480,0,47.2142,1190
457500.0,3,1.75,1840,0,7,1050,790,47.5549,1840
340000.0,2,1.75,1880,0,7,940,940,47.6946,1880
657500.0,4,1.5,1910,0,7,1610,300,47.6597,2170
332500.0,4,2.5,2220,0,7,2220,0,47.3541,2090
340000.0,3,2.0,1410,3,6,1410,0,47.4948,1570
350000.0,4,3.0,3380,1,8,2330,1050,47.5501,2500
428000.0,4,2.5,1950,0,7,1120,830,47.5437,2000
515055.0,4,2.5,2400,0,8,2400,0,47.4808,2430
450000.0,3,1.75,1560,0,8,1560,0,47.6243,1990
190000.0,3,1.0,1040,0,6,1040,0,47.5024,1330
1000000.0,4,2.75,3090,0,8,2590,500,47.5803,1500
299000.0,3,2.5,1850,0,7,1850,0,47.4661,2160
508000.0,2,1.0,1200,2,7,1090,110,47.6304,2690
294000.0,4,2.25,2190,0,8,2190,0,47.3896,2200
320000.0,2,1.0,1380,0,7,1380,0,47.6875,1540
641000.0,5,2.75,3710,0,9,3710,0,47.514,3250
675000.0,3,2.5,2320,0,8,1380,940,47.7323,2830
255000.0,3,1.5,1110,0,7,1110,0,47.422,1330
286651.0,3,2.5,1830,0,7,1830,0,47.3035,2488
607500.0,4,2.5,2460,0,8,1650,810,47.5952,2550
765000.0,3,1.0,1270,0,7,1270,0,47.6874,2260
334950.0,4,1.75,1700,0,8,1700,0,47.3439,2760
426000.0,3,1.0,1130,0,7,1130,0,47.7006,1930
775000.0,3,1.75,1640,0,7,1640,0,47.5975,1670
343000.0,2,1.5,1040,0,6,1040,0,47.7349,1310
470101.0,4,2.5,2320,0,8,2320,0,47.7738,2090
195000.0,3,1.5,1200,0,7,1200,0,47.3137,1390
772500.0,4,1.0,1720,2,7,1720,0,47.6791,2140
450000.0,3,1.5,2330,0,8,1330,1000,47.7481,2630
1437500.0,4,3.75,4410,3,11,4410,0,47.5427,2160
525000.0,4,1.75,1650,0,8,1650,0,47.6652,1700
280000.0,3,1.5,1370,0,7,1370,0,47.4477,1390
270000.0,3,2.5,1770,0,7,1420,350,47.326,1894
406100.0,3,2.25,1410,0,8,1410,0,47.6916,1430
332544.0,2,1.75,1710,0,7,1710,0,47.4732,1760
110000.0,2,1.0,790,0,6,790,0,47.4523,900
685000.0,6,2.25,2770,0,8,2120,650,47.6466,2300
461000.0,4,1.0,1260,0,7,1260,0,47.7181,1480
615000.0,3,2.25,2300,0,8,1300,1000,47.7091,2120
550000.0,2,1.0,1070,0,7,870,200,47.6828,1890
1060000.0,4,3.5,3850,1,11,2430,1420,47.6855,2620
685000.0,3,2.5,2320,0,8,2320,0,47.6847,2340
1555000.0,5,2.5,2870,0,8,2870,0,47.6308,2870
312000.0,4,2.5,1830,0,7,1830,0,47.3565,1830
507500.0,3,1.75,1990,0,8,1190,800,47.6617,1930
217000.0,3,1.0,1110,0,7,1110,0,47.369,1540
439000.0,3,2.25,1830,3,7,1170,660,47.7243,1960
620000.0,6,3.5,3600,0,8,2740,860,47.5401,3150
915000.0,4,2.5,3210,0,10,3210,0,47.625,2950
425000.0,4,2.0,1490,0,7,1110,380,47.5949,1330
435000.0,2,1.0,990,0,7,870,120,47.6802,1280
305000.0,3,2.25,1646,0,7,1646,0,47.363,1654
276000.0,2,1.0,720,0,6,720,0,47.5346,1630
327500.0,3,2.25,2310,0,8,2310,0,47.4051,1960
810000.0,3,2.5,2670,0,9,2670,0,47.6673,2620
715000.0,3,3.25,3060,0,10,2460,600,47.6971,2990
272000.0,3,1.5,1380,0,7,1380,0,47.4243,1650
266000.0,2,1.0,700,0,6,700,0,47.7492,1230
543000.0,3,1.5,1710,2,7,1710,0,47.5175,2430
400000.0,3,2.5,1450,0,8,1450,0,47.6256,1710
509500.0,5,2.25,2060,0,7,1320,740,47.6122,2050
495000.0,3,3.5,2380,3,8,1670,710,47.5137,2540
424950.0,4,2.5,2760,0,7,2760,0,47.4814,2670
230000.0,3,1.0,940,0,7,940,0,47.5121,1250
235000.0,4,1.5,1760,0,7,1760,0,47.3871,1760
763000.0,3,2.0,1360,2,6,1360,0,47.6879,2530
350000.0,3,1.75,2010,0,7,2010,0,47.4975,1770
900000.0,3,1.5,2160,2,8,1620,540,47.6321,2570
250000.0,3,1.0,930,0,6,930,0,47.5289,1640
225000.0,3,2.5,1020,0,7,720,300,47.5294,1060
255000.0,2,2.0,1360,0,8,1360,0,47.3804,1160
161700.0,4,1.75,1720,0,7,1220,500,47.306,1790
336000.0,3,3.0,1790,0,7,1190,600,47.4958,1740
410500.0,3,1.0,1150,0,7,1150,0,47.727,1210
502700.0,4,3.5,2710,0,8,2710,0,47.7601,1590
505000.0,3,2.5,2400,0,7,1390,1010,47.7256,2010
250000.0,3,1.0,1660,0,7,1350,310,47.5576,1750
570000.0,3,1.0,1660,0,7,1350,310,47.5576,1750
349900.0,4,2.5,2290,0,8,2290,0,47.3762,2130
465000.0,3,2.5,2870,0,10,2870,0,47.2769,2950
625000.0,4,3.25,4240,3,10,3550,690,47.3241,3590
655000.0,3,1.75,1800,0,7,1170,630,47.6514,1720
469000.0,4,1.75,2960,0,8,1570,1390,47.4738,1660
355000.0,3,2.25,1980,0,8,1300,680,47.7625,1820
596000.0,3,2.5,1730,0,8,1730,0,47.5878,1730
790000.0,4,2.5,3020,0,9,3020,0,47.768,3020
885000.0,4,2.25,4470,0,10,4470,0,47.6377,3850
1030000.0,4,3.25,2830,0,9,1910,920,47.5845,2740
710000.0,4,1.75,2120,0,8,1060,1060,47.6501,2052
428040.0,3,2.5,2150,0,8,2150,0,47.7445,2150
1370000.0,5,2.25,3510,2,8,1850,1660,47.5817,2680
546000.0,2,1.0,970,0,7,970,0,47.6444,1180
540000.0,4,1.0,1360,0,7,1360,0,47.6827,1500
435000.0,3,2.5,1470,0,7,930,540,47.6832,1470
540000.0,4,2.25,3040,0,8,1430,1610,47.6268,1870
284000.0,2,1.0,860,0,7,860,0,47.5361,1200
208000.0,2,1.0,820,0,5,820,0,47.4915,1000
315000.0,3,1.75,1900,0,7,1130,770,47.7569,1540
417500.0,2,1.0,1330,0,6,850,480,47.6901,1200
345000.0,3,1.75,1240,0,7,1240,0,47.6522,2060
375000.0,3,2.5,1330,0,8,1330,0,47.6835,1330
389800.0,3,1.75,1880,0,7,1880,0,47.7681,1540
475000.0,3,1.75,1890,0,8,1430,460,47.7322,1890
569000.0,4,2.25,2250,0,8,2250,0,47.6695,2350
985000.0,5,4.25,4650,0,10,3260,1390,47.5669,2810
532000.0,3,2.5,1830,0,8,1830,0,47.6198,2030
280000.0,2,1.0,720,0,6,720,0,47.5195,810
435000.0,4,2.0,1960,0,7,1050,910,47.4353,2340
223000.0,3,1.0,1220,0,6,1220,0,47.3261,1960
390000.0,2,1.0,1800,0,7,1200,600,47.4617,2320
315000.0,3,1.75,1340,0,7,880,460,47.4437,1500
612000.0,3,3.0,1740,0,7,1740,0,47.6102,1830
591000.0,3,1.75,1680,0,7,870,810,47.6155,1440
800000.0,4,2.25,3220,0,8,3220,0,47.6381,2500
225000.0,3,2.0,1610,0,8,1610,0,47.1958,1930
589900.0,2,3.0,3160,0,7,3160,0,47.7479,3140
565000.0,4,2.5,2520,0,8,1520,1000,47.6558,2050
650000.0,3,1.5,2120,0,7,1060,1060,47.6438,1620
499000.0,3,2.5,2090,0,8,2090,0,47.7195,1640
280000.0,3,1.0,1330,0,5,1330,0,47.4807,1350
649950.0,3,2.5,2420,2,8,1210,1210,47.6949,2340
420000.0,3,1.75,1510,0,7,1510,0,47.7321,1480
319990.0,4,2.5,2120,0,7,2120,0,47.4217,1990
265000.0,3,2.0,1850,0,7,1850,0,47.6565,1528
482000.0,3,1.75,2300,0,7,1220,1080,47.7609,1940
452000.0,3,2.25,2600,2,8,1490,1110,47.4326,2450
1488000.0,4,4.25,5180,3,12,4280,900,47.5513,5030
375000.0,2,1.0,1810,0,7,1810,0,47.7275,1490
588000.0,5,3.0,2190,0,7,1490,700,47.6892,1370
635000.0,4,2.5,2500,0,9,2500,0,47.5912,2890
280500.0,4,2.5,1890,0,8,1890,0,47.3328,2170
210500.0,2,1.75,2040,0,6,1430,610,47.2755,1310
196500.0,3,2.0,1310,0,7,1310,0,47.303,1390
1395000.0,5,3.5,4010,1,9,2850,1160,47.6578,2610
475000.0,3,1.75,1780,0,7,1210,570,47.7275,1630
550000.0,3,2.5,1980,0,8,1980,0,47.6366,1930
1580000.0,3,3.25,3690,0,11,3690,0,47.6815,1880
240000.0,3,1.75,1540,0,7,1200,340,47.1938,1540
272000.0,3,1.0,1130,0,6,1130,0,47.4935,1080
408506.0,3,2.75,2480,0,8,1870,610,47.3085,2040
640000.0,3,2.5,2580,0,9,2580,0,47.5577,910
316000.0,4,2.5,2010,0,8,2010,0,47.2588,2160
299000.0,4,2.0,2320,0,7,1720,600,47.5246,1390
447500.0,2,2.25,1180,0,7,1180,0,47.6032,1550
736500.0,4,2.5,3180,3,9,3180,0,47.515,3715
665000.0,4,2.0,2970,0,8,2970,0,47.7333,3280
707000.0,5,2.5,3050,0,8,1590,1460,47.5596,2550
215000.0,4,1.75,1630,0,7,1630,0,47.3948,1630
275000.0,3,2.25,1620,0,7,1620,0,47.3577,1640
648000.0,4,2.25,2170,1,8,2170,0,47.5634,2600
415000.0,4,2.5,2150,0,8,2150,0,47.511,2080
690000.0,3,2.0,1770,0,8,1770,0,47.6102,1890
320000.0,4,2.75,2110,0,7,1290,820,47.4513,1980
750000.0,3,1.75,1590,0,8,1590,0,47.5855,1970
355000.0,3,2.25,1370,0,8,1370,0,47.6982,1370
246000.0,3,1.75,1390,0,7,1390,0,47.4183,1460
1155000.0,3,1.75,1640,2,8,1640,0,47.5873,2630
744000.0,3,2.5,2670,0,8,2670,0,47.6677,2400
1210000.0,3,3.75,5400,0,11,5400,0,47.6426,1690
217000.0,3,2.0,1690,0,7,1210,480,47.3021,1930
583000.0,3,2.5,2600,1,8,2600,0,47.5175,2270
515000.0,2,1.5,1400,0,7,1150,250,47.6681,1530
594000.0,4,1.75,2140,0,8,1410,730,47.622,2080
303100.0,3,1.5,1640,0,8,1640,0,47.509,1640
430000.0,3,1.75,1720,0,7,1020,700,47.579,1860
708000.0,5,3.25,3060,0,8,3060,0,47.7212,1840
221000.0,3,1.0,1150,0,7,1150,0,47.7344,1200
325000.0,3,2.5,2000,0,8,2000,0,47.3499,2180
1295650.0,0,0.0,4810,0,12,4810,0,47.6642,4740
385000.0,3,1.75,1560,0,6,780,780,47.719,1320
359500.0,3,2.5,2070,0,8,2070,0,47.3545,1880
433000.0,3,2.0,1920,0,7,1300,620,47.7703,2010
525000.0,2,1.0,1000,0,7,800,200,47.5671,1060
356200.0,3,2.0,1690,2,7,940,750,47.5102,2390
595000.0,4,2.0,3090,0,7,1590,1500,47.7275,2560
560000.0,4,1.5,1790,0,7,1020,770,47.6489,1680
2175000.0,4,3.0,4750,0,11,4750,0,47.6454,3120
513000.0,4,2.0,2090,0,7,1480,610,47.6751,1510
365000.0,2,1.0,680,0,5,680,0,47.6767,1120
368000.0,4,1.75,2100,0,7,1030,1070,47.55,1170
870000.0,4,2.75,2840,0,8,1960,880,47.5846,2750
225000.0,3,2.25,1470,0,7,1160,310,47.2884,1570
1387000.0,4,4.5,4490,2,11,3800,690,47.5544,3370
177000.0,3,1.75,1150,0,7,1150,0,47.3766,1540
465000.0,3,1.5,1460,0,7,1460,0,47.6346,1610
750000.0,4,2.75,3150,3,8,1810,1340,47.5424,2250
149000.0,3,1.0,1090,0,6,1090,0,47.3162,1040
605000.0,3,2.5,2670,3,9,2670,0,47.7443,2760
725000.0,3,2.0,2110,0,7,1990,120,47.6645,1620
413900.0,4,2.25,1770,0,7,1770,0,47.5137,2470
199950.0,3,1.5,1510,0,6,1510,0,47.4821,990
400000.0,1,1.0,530,0,6,530,0,47.6422,1930
870000.0,3,1.5,2420,0,8,2200,220,47.6744,2070
292000.0,5,2.5,2490,0,7,1490,1000,47.4022,1930
225000.0,3,1.0,990,0,7,990,0,47.4557,1260
466750.0,4,2.0,1730,0,8,1730,0,47.7181,1410
330000.0,2,1.5,1440,0,8,1440,0,47.2909,1460
770000.0,7,2.25,3260,0,8,3260,0,47.6336,2340
802500.0,4,2.25,1950,1,8,1450,500,47.5426,1840
378800.0,5,2.5,2740,0,8,2740,0,47.4036,2900
795000.0,3,2.75,2940,0,10,2940,0,47.5879,3110
460000.0,3,2.0,1200,0,7,1200,0,47.6986,1750
567000.0,3,2.5,2070,0,8,2070,0,47.5665,2220
209950.0,3,1.75,1570,0,7,1570,0,47.3207,2000
415000.0,2,1.0,1050,0,7,1050,0,47.3226,1380
424500.0,4,1.5,1830,0,7,1080,750,47.7494,1650
261000.0,2,1.0,970,0,6,970,0,47.5102,1280
365000.0,3,2.5,2200,0,8,2200,0,47.4197,2200
631000.0,4,2.0,1930,0,7,1930,0,47.6156,1480
3800000.0,5,5.5,7050,2,13,4320,2730,47.6229,5070
584000.0,3,2.5,1790,0,8,1790,0,47.6894,1340
310000.0,3,1.75,1560,0,7,1560,0,47.3674,2100
717000.0,4,2.5,2780,0,10,2780,0,47.5608,2650
667000.0,3,1.5,1720,0,8,1720,0,47.6746,2210
190000.0,3,1.0,1640,0,6,1040,600,47.482,1600
430000.0,3,2.0,1730,0,8,1370,360,47.5202,2390
213000.0,2,1.0,740,0,6,740,0,47.4481,1500
475000.0,3,2.5,2280,0,8,1550,730,47.735,2030
649000.0,2,2.75,2090,3,8,2090,0,47.4145,1820
715000.0,3,2.5,2550,0,9,2550,0,47.5586,3180
845000.0,4,3.5,3350,0,11,2460,890,47.5796,3360
390000.0,3,2.5,2770,0,7,1900,870,47.3685,1850
390000.0,4,3.0,2860,0,7,1730,1130,47.5427,2340
328000.0,4,1.75,1990,0,8,1400,590,47.4417,1820
239999.0,3,2.75,1740,0,7,1140,600,47.3456,1550
225000.0,3,2.0,1460,0,7,1460,0,47.3467,1540
920000.0,3,1.75,3670,2,9,1950,1720,47.5604,3020
940000.0,4,2.75,3270,0,10,3270,0,47.6539,3380
465000.0,3,1.0,1210,0,6,1210,0,47.5551,1070
241000.0,3,2.0,1770,0,7,1770,0,47.3321,1510
307550.0,4,2.5,1980,0,8,1980,0,47.3913,2550
490000.0,4,2.5,2650,3,8,1610,1040,47.7684,2650
647000.0,4,2.5,3040,0,8,3040,0,47.6073,2790
780000.0,4,2.75,3640,0,10,3640,0,47.5078,2670
517500.0,3,2.5,1810,0,8,1810,0,47.5776,1740
295000.0,3,2.0,1380,0,7,1380,0,47.4238,1410
560000.0,4,1.5,1810,0,8,1810,0,47.6264,1770
319450.0,5,2.0,2250,0,7,1750,500,47.3065,1540
1500000.0,4,3.25,3860,1,9,2870,990,47.6855,2940
340000.0,4,3.0,2380,0,8,1500,880,47.3046,2370
249950.0,3,1.0,1370,0,6,1370,0,47.4576,1080
499950.0,3,1.0,1830,0,7,1430,400,47.6619,1510
1038000.0,4,1.75,1440,0,8,1440,0,47.634,3520
750000.0,4,2.5,2510,2,9,1540,970,47.6287,2370
875000.0,4,2.5,3230,0,9,3230,0,47.6544,3080
678000.0,3,1.75,1670,0,8,1670,0,47.6344,2200
360000.0,2,1.0,780,0,6,780,0,47.5381,1620
354900.0,3,1.0,1720,0,7,1720,0,47.4772,1550
632000.0,5,2.5,2260,0,8,1520,740,47.5982,2500
350000.0,3,1.75,1480,0,7,1480,0,47.5076,1370
990000.0,3,4.0,2550,2,8,2050,500,47.6415,2340
1650000.0,4,3.25,3920,3,11,3920,0,47.5385,2970
481000.0,4,2.5,2286,0,8,2286,0,47.5174,2110
485000.0,3,2.5,1500,0,7,900,600,47.5499,1090
477000.0,3,2.5,1740,0,8,1740,0,47.5772,1740
560000.0,5,2.5,2880,0,8,1440,1440,47.5456,2010
600000.0,6,3.0,2600,0,8,1340,1260,47.6198,2090
622500.0,5,2.75,3320,0,8,2190,1130,47.7498,2520
410000.0,2,2.25,1660,0,8,1660,0,47.7528,1640
318200.0,3,2.5,1990,0,7,1990,0,47.3531,2580
289000.0,3,2.0,1680,0,7,1680,0,47.1969,1990
263000.0,3,1.75,1570,0,7,1570,0,47.3876,1580
240000.0,3,1.0,1150,0,6,1150,0,47.5321,1760
281500.0,3,1.0,1270,0,7,1270,0,47.4921,1340
587206.0,3,3.5,1890,0,8,1640,250,47.6592,1680
482000.0,2,2.25,1350,0,7,1180,170,47.6399,1760
485000.0,3,1.75,1650,0,8,1650,0,47.631,1880
309000.0,3,2.5,1450,0,7,1450,0,47.672,2080
221000.0,3,2.25,1640,0,7,1140,500,47.2625,1480
700000.0,3,2.5,2030,0,9,2030,0,47.6272,2450
411500.0,5,3.0,2420,0,7,1360,1060,47.536,1840
285000.0,4,3.5,2770,0,8,2770,0,47.7412,1760
395000.0,4,3.0,1980,0,7,1160,820,47.7513,1910
237950.0,2,1.75,1460,0,7,1460,0,47.3665,1680
680000.0,3,2.5,1610,2,7,1160,450,47.6818,2260
199950.0,2,1.0,1010,0,6,1010,0,47.3286,1040
765000.0,4,3.5,2760,2,8,2000,760,47.5687,1690
515000.0,2,1.0,1060,0,7,1060,0,47.6896,1420
470000.0,3,1.5,1510,0,7,1510,0,47.5865,1430
330000.0,2,1.0,880,0,6,780,100,47.6931,950
284000.0,3,2.5,2150,0,8,1550,600,47.4578,1950
295000.0,3,2.5,1660,0,7,1150,510,47.4373,1250
555000.0,4,2.5,2160,0,8,1440,720,47.6333,1280
350000.0,3,1.0,1370,0,6,1370,0,47.7263,1560
240000.0,3,2.25,1460,0,7,1140,320,47.3113,1490
419900.0,3,1.5,1450,0,7,1450,0,47.5983,1490
528000.0,3,2.0,1560,0,7,1560,0,47.5407,1620
481000.0,4,2.5,2480,0,8,1240,1240,47.7612,2230
304700.0,2,1.0,740,0,7,740,0,47.7291,1140
715000.0,4,2.5,2927,0,10,2927,0,47.5948,2967
738950.0,4,2.75,2260,0,8,2260,0,47.6342,1870
215000.0,3,1.5,1240,0,7,1240,0,47.3727,2260
300000.0,6,2.0,2040,0,5,2040,0,47.4919,1440
346000.0,3,1.75,1270,0,6,880,390,47.4828,1650
473000.0,4,3.5,4370,3,8,2780,1590,47.241,2860
500000.0,3,1.75,1700,0,7,1700,0,47.5807,1330
750000.0,2,1.5,1300,2,7,1300,0,47.6134,1420
519900.0,4,2.0,1820,0,8,1820,0,47.6288,2260
378500.0,2,1.0,880,0,7,880,0,47.7262,2260
314500.0,3,1.75,1870,0,8,1870,0,47.3358,1950
499950.0,3,1.5,1350,0,7,1350,0,47.6587,1840
1735000.0,5,3.5,4870,3,10,3650,1220,47.5832,3220
630000.0,3,2.5,2460,0,9,2460,0,47.7602,2470
360000.0,4,1.5,1720,0,7,1720,0,47.7268,1430
460000.0,2,1.5,2730,0,8,1570,1160,47.7698,1450
361000.0,3,1.0,1100,4,6,1100,0,47.344,2550
713400.0,3,2.25,1810,0,8,1810,0,47.5505,1900
445000.0,2,1.0,930,0,6,930,0,47.6783,1900
305000.0,4,1.5,1590,3,7,1590,0,47.2558,2280
1430000.0,3,2.75,2710,4,9,1480,1230,47.7039,2960
222000.0,3,1.0,1460,0,6,1460,0,47.3086,1060
510000.0,5,3.25,3400,0,8,2740,660,47.5385,3400
500000.0,5,3.0,2920,0,8,2920,0,47.7607,1720
605000.0,2,1.0,910,0,7,910,0,47.6341,1720
393000.0,3,2.0,1320,0,8,1320,0,47.6203,1910
725000.0,4,2.5,2490,0,9,2490,0,47.6836,2490
320000.0,3,1.75,2220,0,7,1270,950,47.7762,1490
210000.0,4,1.5,1130,0,7,1130,0,47.2986,1690
419900.0,4,2.5,2750,0,9,2750,0,47.3595,2800
410000.0,4,2.5,2240,0,7,2240,0,47.4868,2000
721000.0,3,2.25,2680,1,8,1540,1140,47.561,2140
605000.0,2,2.0,1270,0,8,1270,0,47.6121,1870
738000.0,3,1.75,1520,0,7,1520,0,47.5839,2310
725000.0,6,3.0,2480,0,8,2480,0,47.6131,2220
255000.0,2,1.0,960,0,7,960,0,47.4485,1240
303000.0,3,2.25,1340,0,8,1340,0,47.7325,1340
394950.0,3,2.5,1090,0,7,1090,0,47.607,1740
530000.0,4,3.0,2240,0,7,1830,410,47.5598,1530
475000.0,4,2.5,3740,0,10,2260,1480,47.4587,2650
250000.0,4,2.5,1800,0,7,1800,0,47.3611,1590
180000.0,3,1.0,780,0,6,780,0,47.565,1260
443500.0,2,1.0,1330,0,7,930,400,47.6802,1410
390000.0,4,2.0,1900,0,8,1900,0,47.3491,1740
430000.0,4,1.75,1570,0,7,1100,470,47.6801,1580
460000.0,5,4.5,3100,0,8,3100,0,47.5004,1650
660000.0,3,3.5,2740,0,9,2190,550,47.7195,2060
515000.0,3,1.75,1570,0,8,1200,370,47.6389,1760
482500.0,3,2.0,1330,0,7,1330,0,47.7181,1580
305000.0,2,1.5,1140,0,7,1140,0,47.5707,1150
835000.0,4,2.75,1550,0,9,1550,0,47.6596,2120
237000.0,3,2.0,1290,0,7,1290,0,47.3867,1670
445000.0,2,1.5,1510,0,8,1510,0,47.6211,1510
710000.0,4,2.5,2720,0,7,1360,1360,47.5237,1790
180000.0,3,1.0,840,0,5,840,0,47.3948,1430
280017.0,3,2.5,1850,0,8,1850,0,47.2091,2350
436500.0,4,2.5,2290,0,8,2290,0,47.4314,2290
1255000.0,4,2.5,3200,0,9,3200,0,47.666,1650
420000.0,3,2.25,1800,0,7,1300,500,47.7393,1680
205000.0,3,1.0,860,0,6,860,0,47.4947,1280
570000.0,3,1.5,1980,0,7,1680,300,47.3402,1980
565000.0,4,1.75,2140,0,7,1070,1070,47.7042,1950
287000.0,2,2.5,2410,0,7,1550,860,47.3078,1840
260000.0,4,1.75,1650,0,7,1010,640,47.7721,1840
470000.0,4,1.75,1650,0,7,1010,640,47.7721,1840
700000.0,3,2.5,2410,0,10,2410,0,47.6911,2310
249000.0,3,1.75,1520,0,8,1520,0,47.2646,2180
568000.0,3,1.75,2050,0,7,1070,980,47.5536,2050
500000.0,4,1.0,1720,0,7,1720,0,47.6719,1580
358000.0,5,2.5,2390,0,7,1270,1120,47.4639,1800
225000.0,3,2.5,1680,0,8,1680,0,47.3293,1860
275500.0,3,1.0,1060,0,6,1060,0,47.4936,1090
495000.0,3,2.5,1860,0,8,1860,0,47.719,2050
758800.0,5,2.25,1750,0,8,960,790,47.6589,2580
280000.0,3,1.75,1480,0,7,1480,0,47.3624,1450
380500.0,3,2.5,1900,0,8,1900,0,47.4324,2100
3200000.0,7,4.5,6210,2,11,4760,1450,47.6307,2940
260000.0,3,1.75,1440,2,7,1090,350,47.471,1710
630000.0,4,2.5,1910,0,8,1910,0,47.6747,1520
875000.0,3,2.0,2010,0,7,1210,800,47.6638,1770
457500.0,3,1.0,960,0,6,960,0,47.5553,1380
900000.0,2,1.0,1240,0,7,1240,0,47.6461,2080
235000.0,2,2.0,870,0,6,740,130,47.5354,1640
410000.0,3,2.0,1400,0,8,1400,0,47.3624,2390
355000.0,3,3.0,1850,0,7,1230,620,47.7717,1970
1300000.0,4,4.0,4270,3,10,3180,1090,47.5443,4280
467500.0,3,1.75,2260,0,7,1130,1130,47.7129,2240
500000.0,4,4.5,2690,0,7,2690,0,47.7062,1660
995000.0,4,3.5,2780,4,10,2530,250,47.454,2724
277000.0,3,1.0,1140,0,7,1140,0,47.7464,1150
630000.0,4,2.25,2900,0,7,1990,910,47.7037,1850
628000.0,5,2.75,2830,0,7,1710,1120,47.5828,2460
655000.0,5,2.5,2560,0,8,2560,0,47.7125,2430
170000.0,2,1.0,1240,0,7,940,300,47.4862,1050
352500.0,4,2.5,2100,2,8,2100,0,47.3338,2310
615000.0,4,2.75,3120,0,9,3120,0,47.3431,2420
165000.0,3,1.0,970,0,7,970,0,47.4836,1200
243500.0,4,2.5,2300,0,7,2300,0,47.3683,1820
304000.0,2,1.5,950,0,7,850,100,47.6005,950
369000.0,3,1.5,2110,0,7,1210,900,47.5283,1950
779950.0,4,2.75,2990,0,9,2990,0,47.7101,2990
605000.0,4,2.25,2940,0,7,1520,1420,47.7422,2470
292500.0,4,2.5,1860,0,8,1860,0,47.3289,1990
500007.0,2,1.75,1820,0,7,910,910,47.6928,1730
449999.0,4,2.5,1950,0,8,1950,0,47.5042,1760
355000.0,4,2.5,1890,0,8,1890,0,47.3788,2250
258000.0,4,3.0,2710,0,7,1710,1000,47.3789,2070
380000.0,4,2.25,2150,0,7,1090,1060,47.7627,2150
650000.0,4,3.0,3720,0,9,1880,1840,47.6469,2560
456500.0,4,2.5,2580,0,9,2580,0,47.3658,2410
259950.0,4,2.0,1540,0,7,1540,0,47.2056,1480
123000.0,2,1.0,1050,0,6,1050,0,47.4828,1330
520000.0,3,2.25,1210,0,8,1210,0,47.6722,1780
506000.0,4,2.25,2040,0,7,1300,740,47.7362,1930
425000.0,3,1.0,980,0,7,980,0,47.5663,2030
438000.0,5,2.5,1990,0,7,1990,0,47.7162,1990
1490000.0,4,2.5,2420,0,9,2420,0,47.6214,3330
375000.0,4,2.0,1240,0,7,1040,200,47.6076,1480
337500.0,3,2.25,1530,0,7,1240,290,47.462,1500
300000.0,4,2.25,2080,0,7,1450,630,47.4349,1900
627000.0,5,3.25,3570,0,7,3570,0,47.5933,2690
1400000.0,5,4.25,4230,0,10,3450,780,47.6866,2650
674725.0,4,2.5,2700,0,9,2700,0,47.5685,2760
325000.0,3,2.75,2200,0,7,1280,920,47.4574,1670
230000.0,5,2.0,1210,0,7,1210,0,47.2848,1510
485000.0,5,1.75,2140,2,7,1220,920,47.5516,2520
315000.0,4,2.5,2740,2,8,2740,0,47.1947,2030
560000.0,3,2.75,1370,0,8,1370,0,47.67,1320
444000.0,4,3.0,2800,0,8,2800,0,47.3538,3610
325000.0,3,1.5,1060,0,7,1060,0,47.5549,1300
118125.0,2,1.0,790,0,6,790,0,47.4869,810
212000.0,2,1.0,790,0,6,790,0,47.4869,810
428900.0,4,2.5,2820,0,9,2820,0,47.3591,2820
510000.0,3,2.0,1850,0,7,1850,0,47.7671,1770
416000.0,3,1.5,1110,0,7,1110,0,47.676,1900
950000.0,4,3.0,3230,0,9,3230,0,47.4141,1600
204000.0,3,1.5,1460,0,7,980,480,47.3954,1400
7700000.0,6,8.0,12050,3,13,8570,3480,47.6298,3940
878000.0,4,2.5,3480,0,11,3480,0,47.5504,3290
1045000.0,4,3.0,3560,2,9,2970,590,47.6265,1190
350000.0,2,1.0,840,0,6,840,0,47.5354,1270
659500.0,3,1.75,1820,0,8,1620,200,47.6737,2330
395000.0,3,2.5,1630,0,7,1120,510,47.7454,2050
308950.0,4,2.5,1920,2,7,1920,0,47.1932,1820
410000.0,3,2.0,1750,0,7,1750,0,47.7329,1370
710000.0,4,3.0,2750,0,8,1630,1120,47.7134,2440
175000.0,1,1.0,620,0,5,620,0,47.4095,1300
508800.0,3,2.0,1720,0,8,1140,580,47.6231,1840
606400.0,3,3.0,1800,2,8,1500,300,47.6475,1670
245100.0,3,1.75,1300,0,7,1300,0,47.3162,1640
540000.0,3,2.5,1970,0,7,1320,650,47.5031,2030
415000.0,3,1.5,1740,0,7,1740,0,47.7402,1830
469500.0,4,2.75,1930,0,8,1180,750,47.7502,1880
195000.0,3,1.75,1190,0,7,1190,0,47.2933,2240
1615000.0,4,3.25,4250,4,12,3020,1230,47.5507,4940
1450000.0,4,3.5,4360,0,12,4360,0,47.6035,4770
1200000.0,3,2.5,3420,4,10,2410,1010,47.5638,3460
1065000.0,4,3.75,4260,0,10,4260,0,47.6739,1950
555500.0,2,1.0,920,0,7,920,0,47.6938,1340
440000.0,3,1.0,1040,0,7,1040,0,47.6178,1170
485000.0,3,1.0,1260,2,7,960,300,47.6947,1540
693000.0,3,2.5,2460,0,9,2460,0,47.691,2540
295000.0,3,1.0,830,0,6,830,0,47.7027,1300
700000.0,3,2.5,2060,0,8,1050,1010,47.5627,2690
767500.0,2,1.75,2210,3,8,1560,650,47.6634,2140
800000.0,6,4.25,5480,0,10,5140,340,47.412,2470
440000.0,3,2.0,1860,2,8,1860,0,47.5157,2500
600000.0,3,2.5,1350,0,7,1350,0,47.7369,2310
1160000.0,4,2.5,2790,0,10,1930,860,47.6453,2320
506000.0,2,1.0,1570,0,8,1150,420,47.7221,1680
474950.0,4,1.75,2030,1,9,1130,900,47.4603,2040
654000.0,3,2.5,2570,0,7,1320,1250,47.6417,1460
710000.0,2,1.0,1210,0,7,1000,210,47.6482,1840
620000.0,4,2.25,1530,0,7,1030,500,47.5589,1710
390000.0,3,2.0,1510,0,7,1510,0,47.654,1900
550000.0,3,2.25,1720,0,7,1220,500,47.6581,1720
353000.0,3,1.75,2190,2,7,1390,800,47.5033,2180
465000.0,4,2.5,3030,0,8,1660,1370,47.4598,2740
279900.0,3,2.0,1410,0,7,1410,0,47.3596,1750
700000.0,2,1.75,1679,0,9,1679,0,47.463,1850
395000.0,4,1.0,1980,0,7,1430,550,47.5226,1890
375000.0,4,2.5,1900,0,8,1900,0,47.7628,1830
547000.0,4,1.0,1720,0,7,1200,520,47.6743,1530
525000.0,5,3.25,2480,0,8,1640,840,47.7726,2270
285000.0,3,1.0,1210,0,7,1210,0,47.6865,1450
570000.0,2,1.75,1540,0,7,1190,350,47.5876,1950
409000.0,3,2.5,2740,0,9,2740,0,47.3835,2690
260000.0,4,2.5,1811,0,8,1811,0,47.454,1811
348000.0,4,2.5,2720,0,8,2120,600,47.4391,2340
389000.0,4,1.0,1520,0,7,1520,0,47.7303,1540
445000.0,4,2.75,2160,0,7,1220,940,47.7177,1790
400000.0,3,1.75,1390,0,7,930,460,47.6944,1230
302000.0,4,2.5,1740,0,7,1740,0,47.3401,1720
798000.0,3,2.5,2849,0,10,2849,0,47.6487,3190
335000.0,2,1.0,1440,0,7,840,600,47.7443,1650
585000.0,4,2.5,3000,0,8,3000,0,47.7623,3000
2500000.0,4,4.0,3330,0,10,3330,0,47.5708,3880
555000.0,4,2.25,1720,0,7,860,860,47.5762,1720
3100000.0,3,3.0,3920,4,11,3920,0,47.5716,3450
295000.0,3,2.5,1500,0,7,1500,0,47.5605,2700
265000.0,4,1.5,2050,0,7,1050,1000,47.3395,1950
330000.0,4,2.0,1180,0,7,1180,0,47.7301,1210
286000.0,4,1.5,1600,0,6,1600,0,47.5437,1690
305000.0,3,2.5,1260,0,7,1160,100,47.7072,1190
970000.0,2,1.0,1290,0,6,1290,0,47.6966,1180
525000.0,4,2.0,2680,0,8,1460,1220,47.4286,2100
355000.0,3,1.75,2370,0,7,1280,1090,47.4459,1230
469950.0,5,2.5,2310,0,7,1300,1010,47.7212,1930
435000.0,4,1.0,1450,0,7,1450,0,47.5746,1260
363500.0,4,2.5,2680,0,8,2680,0,47.4094,2400
595000.0,2,1.5,1030,0,7,830,200,47.6455,1250
275000.0,3,1.0,1320,0,7,1320,0,47.7748,1320
295000.0,2,1.0,670,0,6,670,0,47.5124,1080
345000.0,3,2.25,2670,0,9,2670,0,47.3347,2290
485000.0,3,2.25,2440,0,8,2090,350,47.6347,2150
1245000.0,5,2.5,3370,0,9,3370,0,47.5812,2470
340500.0,2,1.0,940,0,7,940,0,47.6956,1340
280000.0,3,1.0,1100,0,6,840,260,47.7011,1280
449888.0,3,2.25,2520,0,9,2520,0,47.3514,1490
483000.0,2,1.75,1400,0,7,820,580,47.5705,1330
445500.0,3,1.75,1880,0,7,940,940,47.7131,1390
379900.0,5,3.5,2800,0,7,2800,0,47.5273,2190
599950.0,4,3.5,2500,0,8,1810,690,47.6749,2060
215000.0,3,1.0,810,0,6,810,0,47.4734,1700
263000.0,3,2.5,1720,0,7,1720,0,47.3266,1610
565000.0,4,1.0,2170,0,7,2170,0,47.6893,1270
950000.0,5,3.0,4530,0,9,3200,1330,47.7702,3430
395000.0,4,1.0,1440,0,7,1440,0,47.7529,1440
1535000.0,4,3.25,2850,3,10,1820,1030,47.6147,2130
922000.0,4,2.5,2620,4,8,1620,1000,47.6983,2620
330000.0,3,2.5,1676,0,7,1676,0,47.6521,1410
1525000.0,4,3.75,5850,0,12,4410,1440,47.5485,4830
323000.0,3,1.75,1910,0,8,1910,0,47.19,2510
554000.0,2,2.0,1670,0,8,1670,0,47.7141,1670
500000.0,3,2.0,2050,0,8,2050,0,47.6389,1980
775000.0,5,3.5,3730,0,10,2760,970,47.5987,3280
340000.0,4,1.75,1800,0,7,1080,720,47.5298,1870
560000.0,4,1.75,2230,0,7,1320,910,47.5742,1580
304000.0,3,2.5,1670,0,8,1670,0,47.3925,1920
279900.0,3,1.0,1400,0,6,1400,0,47.719,1430
315000.0,5,3.0,2110,0,7,2110,0,47.3599,1460
849000.0,4,2.0,2160,1,8,2160,0,47.5662,1980
325000.0,3,1.75,2420,0,8,1380,1040,47.3301,2550
786000.0,4,3.5,3320,0,9,3320,0,47.592,3160
384000.0,5,2.75,3220,0,9,3220,0,47.3154,2876
907000.0,3,1.5,1340,1,9,1340,0,47.66,2600
700000.0,3,2.5,2490,0,9,2490,0,47.6716,2900
269500.0,3,2.0,1640,0,7,1640,0,47.348,1510
269000.0,3,2.25,1420,0,7,1130,290,47.4046,1730
749950.0,4,2.5,3340,0,10,3340,0,47.6101,3730
325000.0,3,2.75,1580,0,7,1580,0,47.7367,1770
1150000.0,3,1.5,2170,2,10,1130,1040,47.6307,3130
406000.0,3,1.5,1370,0,7,1370,0,47.5409,1730
650000.0,4,2.5,2840,0,10,2840,0,47.6274,2540
295000.0,3,1.75,1940,0,8,1940,0,47.2062,1650
375000.0,4,2.0,1757,2,7,1757,0,47.3974,1850
395000.0,2,1.0,980,0,6,980,0,47.6824,1190
609000.0,6,3.0,2470,0,8,2470,0,47.6025,2470
510000.0,3,1.75,1610,2,7,1210,400,47.6705,1610
190000.0,3,2.25,1590,0,7,1090,500,47.3553,1540
250000.0,1,1.0,780,0,7,780,0,47.6155,1040
295000.0,3,1.5,720,1,5,720,0,47.584,2600
740000.0,3,1.5,1630,0,8,1630,0,47.6756,1950
323000.0,3,1.0,1590,0,7,1590,0,47.5217,1600
713000.0,3,2.75,2310,0,10,2020,290,47.5304,2340
1070000.0,3,1.75,2320,3,8,2040,280,47.643,3110
460000.0,3,1.75,1660,0,8,1660,0,47.6704,1720
880000.0,3,1.75,2070,0,8,2070,0,47.5828,2630
585000.0,4,1.75,2500,0,7,1250,1250,47.648,1680
249950.0,2,1.0,940,0,7,940,0,47.4814,1050
450000.0,3,2.5,1990,0,10,1520,470,47.6361,1710
450000.0,3,2.5,2620,0,9,2620,0,47.3513,3010
1775000.0,4,3.25,3730,2,11,3730,0,47.6292,3730
350000.0,3,3.25,1600,0,8,1600,0,47.6954,1600
292500.0,3,2.5,2095,0,7,2095,0,47.3523,1805
879000.0,4,2.75,4230,0,10,4230,0,47.731,4080
1184000.0,4,2.5,3200,1,8,1860,1340,47.6826,2500
584999.0,4,2.75,2050,0,7,1300,750,47.5945,2960
366000.0,4,2.75,2020,0,7,1300,720,47.7685,1920
987500.0,4,2.25,3270,0,10,2000,1270,47.5295,4100
300000.0,3,1.0,1320,0,7,1320,0,47.5048,1720
299000.0,2,1.75,1270,0,7,890,380,47.4438,2020
560000.0,4,1.75,1980,0,8,1210,770,47.6865,1720
695000.0,3,2.5,2620,0,9,2620,0,47.7211,2620
360000.0,4,1.75,1750,0,7,1220,530,47.4719,1840
183500.0,3,1.0,1040,0,6,800,240,47.3273,820
311000.0,3,1.75,1900,0,7,1070,830,47.5255,1130
263000.0,3,1.75,1660,0,7,1660,0,47.3609,2150
269000.0,3,1.75,1530,0,7,1530,0,47.3609,1610
1600000.0,4,3.5,4280,0,11,4280,0,47.5979,2360
564000.0,4,2.5,2870,0,8,2870,0,47.5394,2770
425000.0,3,2.5,2540,0,9,2540,0,47.4965,2380
679000.0,4,2.75,2100,0,7,1780,320,47.6691,2050
410000.0,3,2.0,1740,0,7,1740,0,47.4526,1540
340000.0,4,2.5,2441,0,8,2441,0,47.3237,2724
360000.0,3,1.75,1810,0,7,1030,780,47.4993,1950
450000.0,3,1.5,2060,0,8,2060,0,47.7503,2320
552000.0,4,2.75,3160,3,7,1620,1540,47.511,1760
294000.0,4,2.0,2930,0,8,2930,0,47.2957,1960
663500.0,2,1.0,1310,0,7,910,400,47.6784,1320
1975000.0,6,4.5,4800,0,10,3580,1220,47.6259,2180
175409.0,4,1.5,1450,0,6,1450,0,47.3613,1060
459000.0,4,3.0,1900,0,7,1900,0,47.7684,1900
339950.0,3,1.0,1050,0,7,1050,0,47.5867,1510
393000.0,5,1.75,1610,0,6,1610,0,47.5654,1410
275500.0,2,1.0,720,0,6,720,0,47.7641,1690
485000.0,3,1.0,1020,0,7,1020,0,47.5728,1210
250000.0,3,1.0,1250,0,7,1250,0,47.4853,1440
935100.0,4,3.5,3200,0,8,2700,500,47.5841,1640
245000.0,3,1.0,990,0,6,990,0,47.2934,1216
670000.0,4,2.5,2850,0,9,2850,0,47.5318,2480
1393000.0,3,3.5,4240,0,10,3500,740,47.5614,3120
440000.0,4,1.75,2800,0,7,1400,1400,47.4649,2560
1248000.0,2,2.5,2310,0,9,2310,0,47.6318,2700
203000.0,3,1.75,1490,0,7,1200,290,47.3187,1540
583000.0,4,2.5,1840,0,9,1840,0,47.6662,2120
575000.0,3,1.0,1740,0,7,1740,0,47.705,1490
2575000.0,4,3.5,3280,0,11,2880,400,47.6299,2050
1600000.0,5,3.5,4050,3,10,3020,1030,47.5348,3880
312500.0,4,2.5,2160,0,7,2160,0,47.3585,1990
455000.0,3,2.75,2720,2,8,2720,0,47.3689,2290
1310000.0,5,3.0,3650,3,9,1860,1790,47.56,3150
605000.0,4,2.25,1750,0,7,1150,600,47.6958,1350
325000.0,3,2.25,2450,0,7,1770,680,47.486,1340
630000.0,3,1.75,1940,0,8,1470,470,47.6632,2360
928950.0,4,3.75,3280,0,9,3280,0,47.554,2900
489950.0,3,1.75,2480,0,8,1800,680,47.7721,2480
550000.0,3,2.25,2120,0,8,1590,530,47.6279,2120
237000.0,3,2.0,1710,0,8,1260,450,47.3473,1760
390000.0,3,2.5,1690,0,7,1310,380,47.7381,1690
665000.0,3,2.5,2190,0,9,2190,0,47.6218,2470
277000.0,4,3.0,1960,0,7,1170,790,47.5313,1960
545000.0,3,1.0,1510,0,7,1510,0,47.6708,1680
615000.0,3,2.5,1490,0,10,1300,190,47.6478,1490
343000.0,3,1.75,2210,0,7,1400,810,47.4968,2220
597000.0,4,2.5,2340,0,9,2340,0,47.73,1920
600000.0,3,1.0,940,0,6,940,0,47.5828,2280
479000.0,3,1.75,1470,0,8,1470,0,47.6171,1720
292000.0,3,1.75,1650,0,7,1650,0,47.4984,1370
265000.0,3,1.5,1400,0,7,1110,290,47.4535,1690
623000.0,4,2.5,2710,0,9,2710,0,47.774,2560
486000.0,4,2.5,2150,0,7,1420,730,47.5531,2010
520500.0,3,2.0,1900,0,7,950,950,47.6997,1400
1300000.0,4,3.5,4380,0,11,4380,0,47.6587,5170
825000.0,4,1.0,2290,4,7,2150,140,47.5917,2390
259900.0,3,1.75,1690,0,7,1690,0,47.3556,1680
1170000.0,5,2.75,3090,0,9,1600,1490,47.5342,2280
245000.0,2,1.0,1120,1,6,720,400,47.5155,2160
830200.0,3,2.5,2680,0,8,1440,1240,47.6538,2320
650000.0,4,2.5,2400,0,9,2400,0,47.5707,2330
305000.0,4,2.0,1610,0,7,1610,0,47.5293,1310
599000.0,5,2.5,3470,0,8,3470,0,47.624,2220
272000.0,4,2.5,2070,0,8,2070,0,47.3262,1940
415000.0,3,2.5,2420,0,8,2420,0,47.3835,1950
319000.0,4,2.25,2380,0,8,1760,620,47.3555,1940
425000.0,4,1.75,2120,0,7,1060,1060,47.771,2200
297500.0,4,2.5,2190,0,8,1250,940,47.3131,2100
725000.0,4,2.5,2740,0,10,2740,0,47.5811,2830
325000.0,3,2.5,1830,0,8,1830,0,47.3893,2070
460000.0,3,1.75,1370,0,7,970,400,47.6644,1650
396480.0,3,1.0,1000,0,7,1000,0,47.52,1140
1025000.0,3,1.0,2050,0,8,1950,100,47.6315,2220
370000.0,3,2.75,1750,0,7,1170,580,47.7696,1810
260656.0,3,1.0,1620,0,6,1620,0,47.3631,1260
431000.0,3,2.5,1710,0,8,1710,0,47.75,1610
320000.0,3,1.0,1060,0,7,1060,0,47.5294,1220
296500.0,3,2.75,2170,0,8,1380,790,47.362,2170
679000.0,4,2.5,3080,0,7,1540,1540,47.674,1550
359000.0,3,3.0,1320,0,7,1080,240,47.5942,1780
330000.0,4,3.0,1920,0,7,1920,0,47.4805,1530
350000.0,4,2.5,2440,0,7,2440,0,47.3841,2410
242000.0,3,1.5,1640,0,7,1640,0,47.495,1540
692500.0,3,2.5,2420,0,9,2420,0,47.772,2780
441000.0,2,1.5,1190,0,7,990,200,47.6726,1410
765000.0,4,2.5,2910,0,10,2910,0,47.69,2870
375000.0,2,1.0,1010,0,7,1010,0,47.5838,2310
365000.0,3,1.75,2080,0,7,1220,860,47.4536,1770
580000.0,2,1.5,1990,0,6,1430,560,47.6521,1350
1605000.0,4,3.5,3920,1,10,2240,1680,47.576,3800
841000.0,4,2.5,3080,0,9,3080,0,47.6197,2920
515000.0,5,3.0,2670,0,7,1370,1300,47.6895,2580
565000.0,5,2.5,4320,0,8,2160,2160,47.4009,2480
365000.0,2,1.5,1200,0,7,1200,0,47.697,1290
295000.0,3,1.5,1640,0,7,1640,0,47.5215,1240
406500.0,2,1.0,870,0,7,870,0,47.5637,1100
614905.0,3,2.5,2410,0,8,2410,0,47.7211,1940
1398000.0,5,2.25,2640,0,7,1770,870,47.6191,3240
250000.0,2,1.0,990,0,7,990,0,47.5118,1350
549000.0,5,1.0,1500,0,7,1500,0,47.6811,1350
397000.0,4,2.5,1790,0,7,1790,0,47.4829,1950
184000.0,3,1.75,1490,0,7,1490,0,47.3075,2488
2500000.0,4,3.25,3960,2,12,3100,860,47.6701,3960
499100.0,3,1.5,1620,0,7,1620,0,47.6978,1380
676101.0,4,1.5,2270,0,8,1290,980,47.6743,2120
290000.0,3,1.0,1150,0,6,990,160,47.7471,1200
390000.0,4,1.75,2180,0,7,1560,620,47.757,1810
465000.0,3,1.0,910,0,7,910,0,47.6828,1370
470000.0,3,2.75,2770,0,8,2370,400,47.7555,1640
435000.0,3,1.0,940,0,6,940,0,47.6231,1250
415000.0,3,1.75,2410,0,8,1860,550,47.4494,2750
450000.0,3,2.0,1010,0,7,1010,0,47.6066,1330
645000.0,3,2.5,2120,1,9,2120,0,47.4089,1304
231000.0,4,2.0,1530,0,7,1530,0,47.4692,1500
358000.0,3,1.5,1810,0,7,1810,0,47.2175,1540
330000.0,3,1.0,1040,0,6,1040,0,47.4332,1250
229950.0,2,1.5,1160,0,7,1160,0,47.7366,1160
403250.0,2,1.5,1430,0,7,1130,300,47.7307,1430
470000.0,3,2.5,2280,0,8,2280,0,47.5335,2640
239000.0,3,1.0,1200,0,7,1200,0,47.3631,1590
579000.0,4,1.5,2480,0,8,1520,960,47.5233,1810
380500.0,3,2.0,1270,0,8,1270,0,47.6929,1180
614285.0,5,2.75,2730,0,8,2730,0,47.7685,2520
376000.0,2,2.0,1340,0,8,1340,0,47.5476,1410
290000.0,3,1.0,1240,0,7,1240,0,47.4363,1250
487000.0,4,2.25,2400,0,8,1800,600,47.7207,2210
935000.0,4,2.0,1220,0,7,1220,0,47.6133,1220
255000.0,4,2.5,2163,0,7,2163,0,47.2736,1760
380000.0,2,2.5,1860,0,7,1860,0,47.776,1860
450000.0,2,1.0,810,0,6,810,0,47.6915,1890
622000.0,3,2.5,1950,0,8,1950,0,47.564,1980
292500.0,3,2.25,1390,0,8,1390,0,47.3536,1630
1320000.0,4,3.0,2120,3,8,1830,290,47.6344,2120
410000.0,4,2.0,1510,0,7,870,640,47.5972,1420
160000.0,3,1.75,1010,0,6,1010,0,47.5202,750
809000.0,4,1.5,1840,0,8,1840,0,47.6312,2250
183750.0,5,2.75,1650,0,7,1650,0,47.5293,1670
411000.0,5,1.75,2860,0,8,1430,1430,47.7385,1920
1050000.0,3,1.75,2650,0,9,2250,400,47.6265,1440
625000.0,2,1.0,1100,0,7,1100,0,47.6352,1900
305000.0,3,2.25,1646,0,7,1646,0,47.3646,1975
915000.0,4,4.5,5250,0,10,5250,0,47.4858,2500
317000.0,3,1.5,1390,0,7,1390,0,47.7383,1470
165000.0,2,1.0,780,0,6,780,0,47.5423,1270
575000.0,2,1.0,1490,0,7,1090,400,47.6296,1590
219900.0,3,1.0,970,0,6,970,0,47.3173,970
1485000.0,4,3.25,3730,0,10,2810,920,47.6824,2490
300000.0,3,1.0,1090,0,7,1090,0,47.6755,1720
520000.0,3,1.75,1940,0,7,1940,0,47.4214,2060
310000.0,4,2.25,1780,0,8,1480,300,47.3618,1780
322500.0,3,2.0,1190,0,7,1190,0,47.5057,1920
320000.0,4,2.25,2000,1,7,2000,0,47.3342,2170
440000.0,3,2.5,1390,0,7,1390,0,47.5303,2340
578000.0,3,1.0,1500,0,7,1120,380,47.6873,1440
382000.0,2,1.5,1070,0,8,1070,0,47.6699,1320
535000.0,3,2.5,1720,0,8,1720,0,47.569,1780
679000.0,4,2.5,3680,0,10,3680,0,47.3543,3310
258900.0,3,2.25,1400,0,7,1040,360,47.4261,1860
563000.0,3,1.5,1730,0,8,1270,460,47.7067,1810
562000.0,5,3.0,2795,0,8,2795,0,47.7301,2750
725000.0,4,1.75,2000,0,8,1120,880,47.6816,1370
236775.0,3,2.5,1830,0,8,1830,0,47.3116,1770
860000.0,4,3.5,3380,1,9,1690,1690,47.6839,1890
270000.0,3,1.5,1500,0,7,1500,0,47.7276,1420
621000.0,4,2.75,1950,2,7,1250,700,47.616,1950
527900.0,3,2.5,2490,2,8,2490,0,47.5385,2420
395000.0,4,2.25,1780,0,8,1780,0,47.762,2070
320000.0,3,2.0,1110,0,7,1110,0,47.4456,1230
300000.0,4,2.5,2500,0,8,2500,0,47.3666,2690
320000.0,3,1.75,1480,0,7,1480,0,47.513,1430
625000.0,3,2.25,2570,0,9,2570,0,47.6854,2570
505000.0,2,1.0,810,0,6,810,0,47.5635,900
300000.0,4,2.5,2700,0,8,1560,1140,47.369,2460
363000.0,4,2.5,2180,0,8,2180,0,47.3673,2520
1700000.0,4,3.5,4330,0,11,3230,1100,47.5315,3840
1146800.0,4,3.5,4210,0,10,4210,0,47.5905,3860
680000.0,4,2.5,2880,0,8,1780,1100,47.6658,2500
678940.0,5,2.25,2610,0,7,1750,860,47.6757,2160
299000.0,3,1.75,2010,0,7,1090,920,47.4171,1560
379900.0,4,1.75,1500,0,7,1000,500,47.7373,1740
205000.0,3,1.0,1290,0,7,1290,0,47.3004,1690
387500.0,4,1.0,1320,0,7,1320,0,47.6145,1260
256000.0,3,1.0,1290,0,6,790,500,47.5186,1110
548000.0,4,2.5,2440,0,9,2440,0,47.5318,2590
163000.0,3,1.75,1290,0,7,1290,0,47.3912,1310
367500.0,2,2.0,1030,0,8,680,350,47.5788,1120
390000.0,3,2.25,1640,0,6,1240,400,47.5686,1500
415000.0,4,2.5,1160,0,7,1160,0,47.7643,1570
449000.0,4,2.25,2230,0,8,2230,0,47.7558,2160
460000.0,5,2.0,1910,0,7,1010,900,47.601,1700
395000.0,4,2.0,1980,0,7,1980,0,47.638,1420
300000.0,3,2.0,1470,0,7,1470,0,47.3617,1720
345000.0,3,1.75,1520,0,7,1520,0,47.457,1650
825000.0,3,1.75,1930,0,7,1930,0,47.6313,1790
539950.0,3,2.5,1330,0,8,1330,0,47.6987,1330
410000.0,4,2.0,1580,0,7,1580,0,47.692,1580
245000.0,3,1.0,1370,0,7,1370,0,47.4879,1370
482000.0,4,2.75,3010,0,8,1560,1450,47.7336,2110
270000.0,3,1.75,1390,0,7,1390,0,47.4469,1400
475000.0,3,1.75,1330,0,7,1330,0,47.6599,1510
445800.0,3,2.0,1320,0,7,1320,0,47.7119,1110
518000.0,4,3.0,2430,0,7,1330,1100,47.7307,1580
785000.0,2,0.75,1260,2,6,1080,180,47.6843,2660
430000.0,3,2.5,1690,0,8,1140,550,47.5404,1640
715000.0,4,1.75,3420,3,8,1770,1650,47.7081,2450
560000.0,3,1.5,2790,2,8,1700,1090,47.7328,2410
449000.0,3,1.75,1270,0,7,1270,0,47.5976,1490
805000.0,4,2.5,2910,0,9,2910,0,47.5451,2530
296000.0,3,2.5,1560,0,7,1560,0,47.3851,1860
275000.0,2,1.0,770,0,7,770,0,47.551,930
419950.0,3,1.75,1770,0,8,1770,0,47.4458,1960
285000.0,3,1.75,1100,0,7,780,320,47.5601,1170
775000.0,3,2.5,2890,0,10,2890,0,47.5785,3000
288250.0,3,1.75,2110,0,7,1380,730,47.4861,2110
257000.0,2,1.75,1220,0,6,610,610,47.592,1240
377000.0,1,1.0,950,0,6,950,0,47.6968,1400
550000.0,2,1.0,1420,0,7,820,600,47.6737,1420
339000.0,3,1.0,1100,0,7,720,380,47.5296,1510
481500.0,3,1.75,2140,0,7,1070,1070,47.6913,1240
224500.0,3,1.75,1300,0,7,1300,0,47.1983,1300
260000.0,3,1.0,1790,0,7,1790,0,47.3887,1660
865000.0,2,1.0,1470,0,8,1470,0,47.6391,1760
730000.0,5,3.0,2500,0,8,1550,950,47.5696,2580
550000.0,2,1.0,980,0,7,980,0,47.6646,1450
645000.0,3,2.0,2130,0,7,2130,0,47.6741,2010
250000.0,3,1.75,1360,0,7,1360,0,47.7583,1360
507200.0,3,3.5,1630,0,9,1360,270,47.6159,1580
380000.0,4,2.5,2500,2,8,1300,1200,47.336,2500
540000.0,4,1.75,2260,2,8,1450,810,47.6555,2980
738500.0,3,2.5,2300,0,8,2300,0,47.7067,1640
206000.0,3,1.0,1060,0,7,1060,0,47.365,1500
265000.0,2,1.0,940,0,6,940,0,47.7523,1450
190000.0,1,0.75,780,0,5,780,0,47.4396,1750
339900.0,3,1.0,1200,0,7,1200,0,47.5234,1250
250000.0,6,2.5,2590,0,7,1340,1250,47.4126,2474
416500.0,3,1.0,1100,0,7,1100,0,47.5309,1630
575000.0,4,2.5,2890,2,8,2890,0,47.5339,2640
385000.0,3,1.75,1230,0,7,1230,0,47.7316,1930
253000.0,3,1.0,1030,0,7,1030,0,47.4988,1160
460000.0,3,1.0,1140,0,7,1140,0,47.6897,1370
1445000.0,4,2.5,3200,3,9,2600,600,47.632,2490
492000.0,2,1.0,950,0,7,950,0,47.6897,1440
275000.0,4,2.0,1960,2,7,1060,900,47.1924,1460
542500.0,5,3.25,3010,0,8,2010,1000,47.4564,2450
345000.0,2,1.0,1080,0,6,1080,0,47.5447,1730
575000.0,4,2.75,2730,0,8,1530,1200,47.7726,2310
275000.0,5,2.5,2570,0,7,1300,1270,47.7753,1760
510000.0,6,4.5,3300,0,8,3300,0,47.6795,2470
2538000.0,4,3.5,4350,0,10,2970,1380,47.6277,4190
830000.0,3,3.5,3820,3,9,2870,950,47.4419,2500
640000.0,4,2.5,2260,0,9,2260,0,47.7047,2680
702000.0,4,2.75,3880,0,7,3880,0,47.6777,2620
960000.0,3,2.5,2010,0,9,1450,560,47.6402,2380
190000.0,3,1.0,950,0,7,950,0,47.3188,1360
500000.0,3,2.25,1730,0,8,1290,440,47.6809,1730
529000.0,3,2.5,3070,0,9,3070,0,47.4724,3070
435000.0,3,1.75,1500,0,7,1500,0,47.7293,1970
670000.0,3,1.75,2160,0,8,1260,900,47.5346,2090
365000.0,3,2.25,1960,0,7,1750,210,47.5419,1760
1270000.0,5,3.0,3950,0,9,2250,1700,47.6363,1890
465000.0,3,1.0,1100,0,6,1100,0,47.5697,1100
285000.0,3,1.5,1400,0,7,1400,0,47.4536,1280
219950.0,3,1.0,1020,0,6,920,100,47.5328,1230
220000.0,3,1.5,1600,0,7,1600,0,47.2925,2880
1465000.0,6,4.5,4230,3,8,2360,1870,47.6301,3450
1112750.0,5,3.5,3090,0,9,2060,1030,47.6217,2240
694000.0,2,2.5,2320,0,8,2320,0,47.7226,1680
620000.0,3,2.5,2440,0,9,2440,0,47.5634,2500
415000.0,3,1.0,2020,0,6,1760,260,47.7552,1780
765000.0,3,3.0,3270,0,10,3270,0,47.6692,1870
864000.0,4,1.75,2260,0,8,1220,1040,47.6753,2240
385000.0,5,2.0,2020,0,7,2020,0,47.5799,1960
725000.0,3,1.0,1000,0,7,1000,0,47.6745,1370
545000.0,4,2.25,2030,0,7,1590,440,47.6561,1960
299900.0,3,1.75,1730,0,9,1730,0,47.3747,2120
639500.0,3,1.75,2010,0,8,2010,0,47.6327,2030
345000.0,4,1.5,1540,0,7,1160,380,47.455,1540
1125000.0,6,4.0,5330,0,11,3950,1380,47.5503,4590
345000.0,2,1.0,960,0,6,780,180,47.6013,1400
600000.0,3,2.0,1460,0,7,730,730,47.67,1780
355000.0,4,1.75,2160,0,7,1360,800,47.5122,1880
698000.0,3,2.75,2640,0,9,2260,380,47.6491,2640
566000.0,4,2.25,2170,0,8,2170,0,47.637,1850
449950.0,3,2.5,1530,0,8,1530,0,47.5691,1720
404600.0,3,1.0,1570,2,8,1270,300,47.4821,2440
258000.0,3,1.0,1490,0,7,1120,370,47.368,1490
415000.0,4,2.0,1960,0,7,1960,0,47.7494,1580
320000.0,4,2.25,2190,0,8,2190,0,47.3742,2170
295000.0,3,2.5,1690,0,7,1690,0,47.3552,1830
389000.0,5,2.0,2330,0,7,1190,1140,47.7325,1830
299900.0,3,1.75,1470,0,7,1470,0,47.3943,2230
394000.0,3,2.5,2550,0,7,2550,0,47.3504,2640
762000.0,4,2.0,2130,0,7,2130,0,47.6807,1490
697000.0,4,2.75,3650,0,8,3650,0,47.7632,2820
485000.0,3,2.5,3340,0,9,2420,920,47.2666,2760
189900.0,2,1.0,800,0,6,800,0,47.4959,1100
2150000.0,3,2.75,3470,4,11,3470,0,47.7205,4130
345000.0,3,1.5,1030,0,6,1030,0,47.5492,1420
376500.0,3,2.0,1630,0,7,1630,0,47.7326,1470
775000.0,3,2.0,2010,3,7,2010,0,47.6828,2450
450000.0,3,1.0,1360,0,6,1360,0,47.6751,1820
760000.0,4,2.25,2040,0,8,1480,560,47.7077,2330
569000.0,4,2.5,2830,0,8,2830,0,47.5396,2470
500000.0,3,1.5,2040,0,7,1280,760,47.7013,1970
592500.0,2,2.0,1340,0,8,1340,0,47.6384,2210
620000.0,4,2.5,2130,0,9,2130,0,47.5648,2150
1000000.0,5,4.25,3920,0,9,2900,1020,47.5871,2540
815000.0,3,2.5,2415,1,9,2415,0,47.6506,2660
775000.0,5,2.75,3750,4,10,3750,0,47.3525,3120
340000.0,3,1.0,1010,0,7,1010,0,47.6169,1230
458000.0,2,1.75,990,0,6,990,0,47.7132,840
250000.0,2,1.5,1200,0,7,1200,0,47.4723,1530
151600.0,2,1.0,1060,0,6,1060,0,47.4305,2320
515000.0,4,2.5,3200,0,7,3200,0,47.5012,2480
216000.0,2,1.0,1810,0,6,1010,800,47.5039,1810
245000.0,3,1.75,1670,0,7,1670,0,47.1764,1810
645000.0,3,2.75,1850,2,8,1850,0,47.7128,2470
249900.0,3,1.0,1100,0,7,1100,0,47.5433,1020
410000.0,3,1.75,1660,0,7,830,830,47.5859,1660
499000.0,6,1.75,2400,0,7,1400,1000,47.7661,1980
790000.0,5,3.25,2900,0,8,1890,1010,47.6154,2590
458000.0,1,2.25,2140,0,7,1470,670,47.7352,1980
925000.0,4,2.5,2670,0,8,1940,730,47.6768,1470
152000.0,3,1.0,1090,0,6,1090,0,47.3155,1090
402000.0,3,2.5,1970,0,8,1970,0,47.7397,2640
340000.0,2,2.0,1250,0,7,980,270,47.5426,1270
1250000.0,4,2.5,4040,2,10,3690,350,47.559,3770
775000.0,4,2.5,3220,0,10,3220,0,47.6854,3090
299800.0,2,1.0,1310,0,6,810,500,47.5185,1300
340000.0,4,2.25,2060,0,7,1300,760,47.4984,1990
626000.0,3,2.25,1750,0,9,1470,280,47.6498,2410
324950.0,2,1.0,1150,0,7,1150,0,47.5081,1390
535500.0,3,2.5,2050,0,8,2050,0,47.5689,2050
817500.0,3,3.25,3230,0,10,3230,0,47.6338,3230
810000.0,4,3.5,4170,0,9,2940,1230,47.6136,2970
565000.0,5,1.5,1940,0,6,1220,720,47.6853,1830
978000.0,3,1.5,2390,0,9,1690,700,47.6604,2350
530000.0,3,1.0,1440,0,8,1440,0,47.7553,2430
305000.0,4,2.5,2230,0,7,2230,0,47.3287,2230
345000.0,3,2.5,1210,0,8,1210,0,47.6977,1190
258000.0,2,2.0,750,2,7,750,0,47.4982,1140
275000.0,4,1.0,1770,0,7,1770,0,47.5393,1580
310000.0,3,1.0,1020,0,7,1020,0,47.3836,1490
713250.0,3,2.0,2050,0,7,2050,0,47.5885,2910
500000.0,3,1.0,2000,0,8,1480,520,47.6064,2000
472000.0,3,1.75,2180,3,8,1090,1090,47.5044,2180
250000.0,3,1.0,920,0,7,920,0,47.5369,1320
725000.0,4,2.25,3440,0,9,3440,0,47.7241,3250
345000.0,3,2.0,1610,0,7,1610,0,47.6886,1610
460000.0,3,1.5,1870,0,7,1470,400,47.723,1340
440150.0,2,1.0,1110,0,7,1000,110,47.7184,1410
390000.0,3,1.75,2200,0,7,1270,930,47.7763,1850
375000.0,2,1.0,790,0,6,790,0,47.557,1250
224950.0,3,1.5,1630,0,7,1630,0,47.2021,1420
480000.0,3,1.5,2100,0,7,1220,880,47.7592,1610
721000.0,4,2.75,2690,0,7,2210,480,47.6963,1620
174000.0,2,1.0,600,0,6,600,0,47.4927,1470
170000.0,2,1.0,810,0,6,810,0,47.4925,950
658000.0,3,1.5,1660,0,7,1660,0,47.6368,2200
860000.0,3,2.0,1880,0,7,1200,680,47.6217,1290
407450.0,4,1.5,2310,0,7,2310,0,47.3354,2020
615000.0,4,1.5,2650,0,7,2650,0,47.7516,1960
920000.0,4,3.0,3130,0,9,3130,0,47.5599,3250
195000.0,2,1.0,860,0,6,860,0,47.3682,1390
269950.0,3,1.0,990,0,7,990,0,47.5104,1370
855000.0,4,3.5,4030,0,10,4030,0,47.4619,1830
620000.0,3,2.25,1780,0,8,1570,210,47.6413,1470
276000.0,2,2.0,1480,0,7,740,740,47.5317,1230
329000.0,3,1.0,1140,0,6,1140,0,47.5122,1140
270000.0,3,1.5,1230,0,7,1230,0,47.4202,1260
440000.0,4,2.5,3080,0,9,3080,0,47.3828,2740
639000.0,4,2.5,1990,0,10,1990,0,47.561,2580
403500.0,1,1.0,700,0,6,700,0,47.734,1020
585000.0,3,2.5,1700,2,9,1320,380,47.6373,1710
216000.0,2,1.0,860,0,6,860,0,47.4801,990
1150000.0,3,2.5,3160,3,11,2160,1000,47.5531,3990
575000.0,3,2.0,2500,0,8,1840,660,47.4468,2500
430000.0,4,2.5,3000,0,9,3000,0,47.3959,3000
660000.0,2,1.0,1670,0,7,1670,0,47.6627,1980
338000.0,2,1.0,690,0,6,690,0,47.5287,1000
400000.0,4,2.75,1240,0,7,800,440,47.7157,1150
210000.0,2,1.0,900,0,6,900,0,47.2008,1150
305000.0,4,1.75,2200,0,6,1400,800,47.4945,1520
365000.0,2,1.0,960,0,6,960,0,47.6668,1830
325000.0,5,2.75,2130,0,7,1300,830,47.5272,2130
245000.0,4,1.75,2020,0,8,2020,0,47.3202,2320
182000.0,3,1.0,1060,0,7,1060,0,47.3809,1060
440000.0,2,1.0,1230,0,7,1130,100,47.5573,1260
225000.0,3,2.25,2510,0,8,2510,0,47.3473,1870
358000.0,3,2.25,2510,0,8,2510,0,47.3473,1870
580000.0,5,2.5,2720,0,7,1530,1190,47.6827,1210
240000.0,3,1.5,1070,0,7,1070,0,47.3516,1730
700000.0,4,3.25,3580,0,8,3580,0,47.5595,2070
325000.0,4,2.5,2230,0,8,2230,0,47.2082,2270
488000.0,4,2.25,2500,0,7,1800,700,47.7318,2500
875000.0,4,1.0,1670,0,8,1670,0,47.6838,1820
615000.0,4,2.5,2150,0,8,2150,0,47.7279,2230
321000.0,3,2.5,2020,0,7,2020,0,47.3658,2030
1035000.0,3,2.5,2230,0,9,2230,0,47.6938,1900
299500.0,2,1.0,740,0,6,740,0,47.5158,740
459000.0,4,1.5,2020,0,7,2020,0,47.7283,1770
435000.0,3,2.5,1730,0,8,1730,0,47.5668,1730
222000.0,3,1.75,1370,0,7,1370,0,47.4096,1850
485000.0,4,1.0,1210,0,7,1210,0,47.6924,1340
750000.0,5,3.5,2160,0,9,2160,0,47.6726,1750
266000.0,3,2.25,1550,0,8,1550,0,47.3525,1650
455000.0,2,1.0,1170,0,7,970,200,47.6994,2130
490000.0,3,1.75,2020,0,7,2020,0,47.4189,1810
280000.0,3,1.75,1740,0,7,1240,500,47.3054,1980
1450000.0,4,3.25,3100,2,9,2090,1010,47.6385,2110
291000.0,4,1.0,1590,0,6,1140,450,47.4906,1000
745000.0,5,3.0,2400,3,8,2400,0,47.5726,2250
685900.0,3,2.5,2290,0,8,2290,0,47.691,1770
160000.0,3,1.75,1610,0,7,1610,0,47.3413,1450
650000.0,4,2.5,2240,0,8,1490,750,47.6147,2640
250000.0,2,1.0,850,0,6,850,0,47.5198,850
265000.0,2,1.5,920,0,7,920,0,47.7081,1110
599000.0,5,3.25,2590,0,7,1330,1260,47.551,1560
199950.0,3,1.0,1340,0,6,1340,0,47.4934,1210
712500.0,4,2.75,2420,1,8,1420,1000,47.5459,3170
490000.0,2,1.0,1420,0,7,920,500,47.6864,1420
511500.0,4,1.0,1360,0,7,1360,0,47.6854,1710
299000.0,3,1.0,1510,0,6,1010,500,47.5293,1710
685000.0,4,2.5,2650,2,9,2330,320,47.7537,3020
597000.0,4,2.0,2120,0,7,1720,400,47.688,1760
210000.0,3,1.0,1200,0,6,1200,0,47.3746,1200
659000.0,4,2.5,3190,0,8,2210,980,47.704,1100
540000.0,3,1.0,1050,0,7,1050,0,47.6756,1580
469000.0,3,2.0,1300,0,7,1300,0,47.5337,2250
1065000.0,3,2.5,3970,0,9,3970,0,47.6067,3970
575000.0,5,2.5,2990,2,9,1800,1190,47.7707,2800
725000.0,4,2.75,2440,2,7,1640,800,47.5731,2170
299950.0,4,1.0,1170,0,6,1170,0,47.492,1100
375000.0,4,2.0,2270,0,7,2270,0,47.3264,2150
342450.0,3,1.5,1280,0,7,1280,0,47.7339,1330
315000.0,4,2.5,1950,0,7,1950,0,47.5014,1980
328000.0,4,2.75,1930,0,7,1170,760,47.5303,1610
323000.0,4,2.75,1970,0,8,1170,800,47.4424,1980
320000.0,4,3.0,1820,0,7,1000,820,47.5468,1600
550000.0,2,1.0,950,0,7,950,0,47.6765,1120
1646000.0,6,3.5,4010,0,8,2090,1920,47.6322,3560
1212500.0,4,3.5,4560,3,12,2230,2330,47.5521,4060
1200000.0,4,3.5,4560,3,12,2230,2330,47.5521,4060
120000.0,3,1.0,1150,0,6,1150,0,47.3865,1492
175000.0,3,1.0,1150,0,6,1150,0,47.3865,1492
169900.0,3,1.0,910,0,5,910,0,47.2068,1400
508000.0,6,2.75,2890,0,8,1830,1060,47.7099,1880
335000.0,2,1.0,1070,0,7,1070,0,47.7315,1680
613200.0,3,2.75,2050,0,7,1580,470,47.6719,1760
420000.0,2,1.5,1040,0,6,1040,0,47.588,1340
1000000.0,4,3.25,3320,0,11,2950,370,47.691,1860
342000.0,2,1.0,740,0,6,740,0,47.5517,1330
850000.0,4,2.0,3380,0,9,1690,1690,47.5936,3380
582000.0,2,1.75,1210,0,7,910,300,47.686,1310
475000.0,3,2.5,2480,0,8,2480,0,47.772,1850
570000.0,3,2.25,2010,0,8,1330,680,47.6912,2080
826600.0,4,3.25,3230,0,7,1750,1480,47.6702,1730
387000.0,2,2.5,1170,0,8,1170,0,47.6131,1250
330000.0,3,1.0,1250,0,7,1250,0,47.7554,1440
653450.0,3,2.5,2070,0,8,1540,530,47.5936,2620
285000.0,2,1.0,1050,0,7,1050,0,47.5471,1890
217000.0,3,1.0,1400,0,7,1400,0,47.4789,1400
615000.0,3,1.0,1120,0,7,1120,0,47.6842,2380
580135.0,4,2.5,3150,0,8,3150,0,47.4787,2650
1150000.0,4,3.5,4540,0,11,4200,340,47.5445,3990
231200.0,3,2.0,1400,0,7,1400,0,47.1949,1450
680000.0,4,2.75,2500,0,8,2500,0,47.6964,2500
267500.0,3,1.5,1390,0,7,1390,0,47.5506,1100
942000.0,4,2.75,3160,3,8,2310,850,47.7214,3130
435000.0,3,1.75,1310,0,6,1310,0,47.701,1420
315000.0,2,1.0,1740,0,7,950,790,47.5541,1270
354901.0,3,2.5,1490,0,8,1490,0,47.7173,1364
439888.0,2,2.0,1300,0,8,1300,0,47.7078,1640
360000.0,4,1.0,1460,0,8,1340,120,47.533,990
205000.0,4,1.0,1030,0,6,1030,0,47.4857,1420
299995.0,3,2.5,1970,0,8,1970,0,47.2658,1950
150000.0,2,1.0,790,0,6,790,0,47.4771,850
575000.0,3,2.25,3800,0,10,3330,470,47.3797,3470
625000.0,3,2.0,2168,1,7,2168,0,47.4933,2168
950000.0,4,3.5,4140,0,11,4140,0,47.5261,4140
278800.0,4,2.5,2440,0,8,1560,880,47.3895,2090
713500.0,3,2.0,1720,0,8,1720,0,47.6285,1720
1900000.0,4,2.25,3020,3,10,2110,910,47.5395,3890
439000.0,5,2.0,2610,0,7,1710,900,47.6969,1600
425000.0,3,2.0,1500,0,7,1060,440,47.5584,1550
252500.0,4,2.5,2600,0,7,1570,1030,47.336,1660
185000.0,3,1.5,1370,0,7,1370,0,47.2874,1710
406550.0,5,2.75,2400,0,7,1200,1200,47.622,2390
243000.0,2,1.5,1068,0,7,1068,0,47.7527,1078
500000.0,3,1.5,2220,0,8,1110,1110,47.5473,2220
204750.0,2,1.0,880,0,7,880,0,47.3757,1800
222000.0,3,1.5,1310,0,7,1310,0,47.3683,1710
200000.0,4,1.0,1350,0,7,1350,0,47.4269,1320
367000.0,3,2.25,1400,2,8,1400,0,47.7147,1490
183000.0,3,1.0,1170,0,7,1170,0,47.4685,2040
300000.0,3,2.5,1020,0,7,720,300,47.5871,1470
369000.0,3,1.75,1300,0,7,1300,0,47.7024,1290
380000.0,3,2.0,2010,0,6,2010,0,47.7643,1890
463000.0,3,2.0,1590,0,6,1590,0,47.7012,1730
475000.0,3,1.0,1470,0,7,1470,0,47.7155,1300
225000.0,3,1.75,1580,0,7,1580,0,47.2598,1480
371000.0,3,1.75,1970,0,8,1970,0,47.4545,2250
625000.0,3,2.5,2330,0,8,2330,0,47.5622,1980
3200000.0,6,5.0,7100,0,13,5240,1860,47.6427,3130
329000.0,3,1.75,1230,0,7,1230,0,47.4431,1250
634000.0,3,1.75,2570,0,7,2570,0,47.7705,2570
616000.0,4,2.5,3440,0,10,3440,0,47.3538,3200
1824100.0,3,2.25,3330,0,9,3330,0,47.6395,2870
435000.0,4,2.25,1780,0,7,1780,0,47.7642,1670
320000.0,4,2.5,2110,0,8,2110,0,47.3641,2720
820000.0,4,3.5,2770,0,9,2770,0,47.6469,3410
310000.0,3,2.5,1590,0,7,1590,0,47.7349,1820
443750.0,3,2.25,1460,0,7,1140,320,47.6601,1460
795000.0,4,2.25,2070,0,8,1700,370,47.5606,2520
475000.0,3,2.5,2420,0,8,1530,890,47.3264,1670
585000.0,5,1.75,2000,0,7,2000,0,47.6618,1520
315000.0,2,1.0,1010,0,7,1010,0,47.5123,1220
635000.0,4,2.5,3050,0,8,3050,0,47.5772,2580
305000.0,3,1.0,1160,0,7,1160,0,47.7427,1160
785000.0,3,2.0,2180,0,7,1100,1080,47.657,1470
525000.0,3,1.75,1560,0,6,780,780,47.6501,1560
537000.0,4,1.75,1580,0,7,790,790,47.6795,1190
279950.0,3,1.75,1660,0,7,1380,280,47.4366,1740
659000.0,4,2.0,2350,0,8,2350,0,47.583,1640
203000.0,2,1.0,1440,0,7,970,470,47.2896,1600
782500.0,4,2.5,2930,0,9,2930,0,47.6219,2600
250000.0,3,1.75,1590,0,7,1130,460,47.4016,1500
279000.0,3,1.0,1400,0,7,1060,340,47.5051,1400
664000.0,6,2.5,3190,0,8,3190,0,47.6309,2790
2900000.0,4,3.25,4580,3,11,3080,1500,47.6305,3540
378500.0,4,2.0,1830,0,7,1070,760,47.5453,1830
535000.0,3,1.75,2720,0,9,2720,0,47.7092,2560
520000.0,2,1.0,1360,0,7,1360,0,47.7101,2830
369950.0,3,2.0,1520,0,6,800,720,47.531,1430
545000.0,3,2.25,2290,0,8,2290,0,47.5874,1660
360000.0,3,2.5,2150,0,8,2150,0,47.4621,2400
760000.0,3,1.5,1170,0,7,1170,0,47.6077,1870
450000.0,3,1.75,1830,2,7,1010,820,47.6914,1200
612500.0,4,2.5,2730,0,9,2730,0,47.7419,2730
280000.0,3,1.0,1090,0,7,1090,0,47.5,1090
750000.0,3,2.5,2560,0,9,2560,0,47.5361,2800
237000.0,3,1.0,1160,0,7,1160,0,47.5015,1280
441500.0,2,1.75,1010,0,7,1010,0,47.6665,1470
251000.0,3,2.0,1650,0,7,1650,0,47.3617,1510
200000.0,3,1.0,2120,0,7,1220,900,47.4938,1790
332000.0,1,1.0,960,0,7,760,200,47.6223,1620
401500.0,3,2.5,1509,0,8,1509,0,47.7048,1509
585000.0,4,1.75,2270,0,8,1300,970,47.7637,2380
340000.0,4,2.5,1954,0,8,1954,0,47.4297,1714
920000.0,3,3.5,2800,0,9,2800,0,47.7095,2420
153000.0,3,1.0,1270,0,6,1270,0,47.4959,1110
299950.0,4,2.25,1810,0,7,1080,730,47.2857,1570
440000.0,4,2.5,2410,0,8,2410,0,47.4388,2420
293000.0,3,2.5,1690,0,7,1690,0,47.3691,2610
203000.0,3,1.75,1190,0,7,1190,0,47.5026,1200
193000.0,2,1.75,1280,0,7,1280,0,47.2925,1450
305000.0,3,1.75,1460,0,7,1460,0,47.7755,2200
495000.0,4,1.75,1600,0,8,1130,470,47.701,1090
420000.0,3,1.75,1770,0,7,1130,640,47.7135,1900
569500.0,4,2.5,2800,0,8,1700,1100,47.7695,2460
620000.0,4,2.5,2680,0,9,2680,0,47.5738,2810
466000.0,3,1.75,1680,0,7,1680,0,47.5525,1690
355500.0,3,1.0,1120,0,7,1120,0,47.7182,1210
687500.0,2,1.0,1040,0,6,1040,0,47.6823,1640
432100.0,3,2.25,1790,0,8,1790,0,47.6343,1780
500000.0,3,2.5,2410,0,8,2410,0,47.5694,2420
690000.0,5,3.25,3370,0,8,2140,1230,47.5632,2990
350000.0,2,1.0,800,0,6,800,0,47.5525,1280
268000.0,2,1.0,1380,0,7,870,510,47.5339,1450
120000.0,2,1.0,990,0,4,990,0,47.3577,1560
285000.0,4,2.5,1800,0,7,1800,0,47.1927,1970
365000.0,4,1.5,1820,0,7,1380,440,47.5767,1450
635000.0,3,2.5,2620,0,7,2620,0,47.6846,2280
630000.0,2,2.5,2290,0,9,2290,0,47.5545,2290
450000.0,4,3.0,2200,0,7,2200,0,47.7005,1780
590000.0,4,2.5,2940,0,8,1850,1090,47.6294,2030
895000.0,2,1.75,1700,1,8,1260,440,47.6336,2200
160000.0,3,1.0,860,0,6,860,0,47.3574,1660
520000.0,2,1.0,910,0,7,910,0,47.6733,1050
432000.0,4,3.25,2820,0,8,2820,0,47.4508,2360
141800.0,2,1.0,930,0,5,930,0,47.4966,930
980000.0,4,2.0,2190,0,8,2190,0,47.662,2190
1290000.0,4,2.5,3430,0,9,3430,0,47.6842,1530
740000.0,4,2.75,2560,0,8,1480,1080,47.686,2600
230000.0,2,1.0,770,0,6,770,0,47.531,780
3400000.0,3,4.5,5230,4,10,3740,1490,47.5348,3670
954500.0,3,2.25,2440,2,8,1830,610,47.6141,2730
622000.0,3,1.5,1650,0,8,1650,0,47.6156,1650
90000.0,1,1.0,780,0,5,780,0,47.5424,1150
342000.0,3,3.0,1260,0,8,1260,0,47.697,1260
305000.0,4,2.5,2320,0,7,2320,0,47.3349,2230
259900.0,4,2.75,1560,3,7,1060,500,47.3382,2140
420000.0,3,2.0,2330,0,6,1600,730,47.5135,1380
250000.0,2,1.0,1400,0,6,1100,300,47.4724,2250
249950.0,3,1.5,1450,0,7,1450,0,47.4205,1270
199000.0,2,1.0,1140,0,6,990,150,47.4521,2320
355200.0,3,1.0,1120,0,7,1120,0,47.5103,1410
425000.0,3,1.5,1970,0,7,1680,290,47.7562,2200
379500.0,3,1.0,1110,0,7,1110,0,47.6968,1510
860000.0,4,2.5,3070,0,9,3070,0,47.669,2190
335000.0,3,2.5,1940,0,8,1940,0,47.4479,2070
865000.0,3,2.5,3050,0,10,3050,0,47.6549,3543
390000.0,3,1.0,1240,0,7,1240,0,47.5986,1680
569950.0,5,4.25,3380,0,8,3380,0,47.4349,2790
495500.0,3,2.5,3190,0,9,3190,0,47.5047,2970
476500.0,4,1.75,1670,0,7,1390,280,47.5524,1720
261000.0,3,1.0,1660,0,7,1660,0,47.5121,1380
375000.0,4,2.0,2070,0,7,2070,0,47.566,1300
550000.0,4,2.0,2070,0,7,2070,0,47.566,1300
230000.0,2,1.0,1430,0,7,930,500,47.5233,1110
526750.0,5,2.5,2270,0,8,1570,700,47.741,2020
606000.0,3,2.0,1980,0,6,1070,910,47.6839,1330
368500.0,4,2.75,2500,0,8,1780,720,47.3444,2180
275000.0,3,1.0,1230,0,7,1230,0,47.4397,1550
342000.0,4,1.0,1390,0,7,1390,0,47.7754,1760
278100.0,4,1.75,2120,0,7,1600,520,47.302,2160
450000.0,4,2.75,1540,2,7,850,690,47.5491,1180
349950.0,4,2.5,2000,0,7,2000,0,47.466,2410
425000.0,4,2.5,2400,0,8,2400,0,47.3869,2460
435000.0,4,2.75,2110,0,7,1510,600,47.7617,1660
460000.0,4,2.5,2550,0,7,1300,1250,47.7682,2080
323000.0,4,1.75,1440,0,7,1440,0,47.7639,1940
325000.0,2,1.0,810,0,6,810,0,47.5495,990
480000.0,2,1.75,1170,0,6,690,480,47.6842,1240
1325000.0,3,2.5,3590,0,9,2950,640,47.595,1620
210000.0,4,1.75,2090,0,7,1280,810,47.4958,2190
920000.0,5,4.5,3820,3,9,2830,990,47.5581,1750
399000.0,3,1.0,1460,0,8,1460,0,47.7246,1470
631750.0,3,1.75,2360,0,7,1180,1180,47.6902,1660
184000.0,3,1.0,1100,0,6,1100,0,47.3072,1100
333000.0,4,2.5,2100,0,8,2100,0,47.4478,2060
218000.0,2,2.0,1310,0,6,1310,0,47.3502,1360
258305.0,2,1.5,750,0,5,750,0,47.5518,1350
775000.0,5,1.5,1720,0,8,1720,0,47.6627,1720
515000.0,3,2.5,3370,0,7,3200,170,47.7388,1730
455000.0,2,1.5,1200,0,8,1000,200,47.6001,1320
440000.0,3,2.5,1830,0,7,1830,0,47.7613,1340
1440000.0,3,3.5,3870,0,11,2760,1110,47.6452,2530
850000.0,3,2.25,2220,0,8,1620,600,47.617,2030
480000.0,3,1.75,2920,0,8,1850,1070,47.7666,1540
420000.0,5,2.75,2540,0,8,1520,1020,47.4326,1800
408000.0,3,1.75,1970,0,7,1590,380,47.7353,1790
278000.0,5,1.75,2170,0,7,1100,1070,47.3355,1810
1195000.0,3,3.0,2350,0,9,1560,790,47.6308,2000
454000.0,4,2.25,2630,0,9,2630,0,47.4089,2270
1851000.0,4,2.5,4120,4,8,2070,2050,47.5571,3620
499000.0,4,2.25,2440,0,7,2440,0,47.5407,2440
590000.0,5,3.0,3480,0,8,3480,0,47.4815,2800
385000.0,3,3.5,1900,0,8,1560,340,47.5686,1360
1250000.0,4,3.25,3160,2,9,3160,0,47.7001,3450
202200.0,2,1.75,1330,0,8,1330,0,47.3822,1220
450000.0,3,2.25,1420,0,7,960,460,47.6693,1480
435000.0,3,2.0,2570,0,8,2570,0,47.4199,2280
550000.0,2,1.0,1270,0,5,1270,0,47.3651,1870
361000.0,3,2.25,2470,2,7,1550,920,47.5072,1660
760000.0,4,2.25,2590,0,9,2590,0,47.5566,2620
902000.0,4,2.5,3030,0,9,3030,0,47.6675,2570
505000.0,3,1.75,1240,0,7,1240,0,47.5803,2110
200000.0,3,1.0,1040,0,6,1040,0,47.3265,1040
260000.0,5,2.25,2320,0,7,1270,1050,47.3351,1760
417000.0,2,1.0,1190,0,7,1190,0,47.6773,1920
287500.0,3,2.25,2030,0,8,1360,670,47.3185,1720
450000.0,3,1.5,1390,0,7,1390,0,47.7025,1750
825000.0,2,1.75,2050,2,8,2050,0,47.6415,1940
1475000.0,4,3.0,3050,0,9,2330,720,47.6253,3020
319950.0,2,1.0,1240,0,6,1240,0,47.5257,1520
682000.0,4,2.5,3030,0,9,3030,0,47.7468,2600
560000.0,3,1.75,1930,0,8,1130,800,47.6516,1870
350000.0,3,1.75,1490,0,7,1490,0,47.7517,1450
270000.0,3,2.0,1510,0,7,1510,0,47.2078,1370
284000.0,3,1.75,1320,0,7,1320,0,47.312,1660
308000.0,4,2.5,2330,0,8,2330,0,47.3934,2330
450000.0,4,2.0,2240,0,7,1120,1120,47.5331,1340
540000.0,4,2.5,2050,0,8,2050,0,47.7572,2240
380000.0,4,1.5,1680,0,7,1130,550,47.7565,1770
522500.0,4,2.75,2200,0,7,2200,0,47.6301,1710
118000.0,1,1.0,670,0,6,670,0,47.3594,1600
280400.0,4,1.75,1730,0,7,1010,720,47.354,1620
710000.0,4,2.75,2710,0,8,1690,1020,47.5836,2110
720000.0,3,3.25,3410,0,8,3410,0,47.6929,1660
787000.0,3,1.75,1330,0,8,1330,0,47.6074,1690
537000.0,4,2.5,1990,0,8,1990,0,47.732,1990
650000.0,2,1.5,1900,0,7,1500,400,47.5834,2130
154200.0,4,1.0,1310,0,6,910,400,47.5104,1310
238000.0,4,2.5,1690,0,7,1080,610,47.3001,1690
285650.0,3,1.0,1040,0,7,1040,0,47.7348,1420
485500.0,2,1.5,1340,0,8,1190,150,47.617,1460
315000.0,2,1.0,1120,0,7,1120,0,47.7648,1320
4668000.0,5,6.75,9640,4,12,4820,4820,47.557,3270
627000.0,3,2.0,2310,0,7,2310,0,47.6727,1430
525000.0,3,2.5,2190,0,8,2190,0,47.4594,2460
526000.0,3,3.25,1220,0,8,930,290,47.67,1303
480000.0,3,1.5,1200,0,7,1060,140,47.679,1410
970000.0,3,3.5,3840,0,9,3840,0,47.7322,3810
640000.0,4,2.5,2460,0,8,1560,900,47.7133,1830
279000.0,3,2.5,1630,0,8,1320,310,47.4224,1650
303000.0,2,2.0,970,0,6,970,0,47.5073,1850
315000.0,4,2.0,1780,0,6,930,850,47.5094,1910
336500.0,4,1.75,1760,0,7,1080,680,47.4267,1830
163250.0,2,1.0,770,0,6,770,0,47.5324,1140
444950.0,3,1.0,1760,0,7,1050,710,47.7623,2060
285000.0,2,1.0,990,0,7,990,0,47.5919,1260
370000.0,2,1.0,1250,0,7,940,310,47.6893,2030
330000.0,3,2.25,1440,0,7,1440,0,47.5456,1530
395000.0,2,2.0,1960,0,7,980,980,47.5629,1240
440000.0,6,3.0,2510,0,7,1460,1050,47.5533,1390
625000.0,4,2.75,2920,0,8,2920,0,47.4909,3030
435000.0,3,2.5,1730,0,8,1730,0,47.4614,1750
299950.0,3,2.5,1570,0,7,1570,0,47.7456,1970
560000.0,2,1.75,970,0,7,970,0,47.6384,1340
380000.0,4,3.0,2800,0,8,2800,0,47.3543,3610
333000.0,4,2.0,1580,0,6,1580,0,47.5848,1190
499000.0,2,1.0,1220,0,7,920,300,47.6823,1270
386000.0,3,1.5,1550,0,6,1330,220,47.5536,1150
320600.0,3,2.0,1220,0,6,720,500,47.4564,1640
285000.0,2,2.0,1651,0,6,1651,0,47.4621,1510
450000.0,7,4.0,3150,0,8,3150,0,47.5259,1880
175000.0,2,1.0,800,0,5,800,0,47.3788,1220
544800.0,5,2.75,3190,0,9,3190,0,47.4575,3100
220000.0,3,1.75,1720,0,7,1140,580,47.3175,1120
374000.0,2,2.25,1100,0,9,1100,0,47.5663,1100
200000.0,3,2.0,1010,0,7,1010,0,47.4046,1540
259950.0,3,2.0,1010,0,7,1010,0,47.4046,1540
255000.0,4,2.75,1760,0,7,1140,620,47.3099,1800
447000.0,3,1.75,1400,0,7,1040,360,47.717,1860
287000.0,3,2.5,1820,0,7,1820,0,47.2137,1480
344950.0,3,2.0,1470,0,6,1470,0,47.7619,1660
212000.0,2,1.0,770,0,6,770,0,47.5654,1100
425000.0,5,2.75,1340,0,7,1190,150,47.709,1950
170000.0,1,1.0,480,0,5,480,0,47.5253,890
565000.0,3,1.0,1260,0,7,1260,0,47.6893,1130
234000.0,2,1.0,870,0,6,870,0,47.5038,1370
1511250.0,3,2.5,4010,3,11,2600,1410,47.554,4010
345000.0,3,2.5,2340,0,7,1280,1060,47.4685,2340
415000.0,3,2.75,1770,0,8,1770,0,47.5164,1760
760000.0,5,1.75,2660,0,7,1670,990,47.6945,1570
484000.0,5,2.5,3600,0,9,3600,0,47.4484,2860
360000.0,2,1.75,1230,0,8,1230,0,47.5475,1380
875000.0,3,2.75,3270,0,11,3270,0,47.731,3480
930000.0,3,2.5,3100,0,10,3100,0,47.7635,3000
250000.0,3,2.0,1900,0,7,950,950,47.3594,1690
394000.0,2,2.0,1750,0,8,1750,0,47.5169,1650
865000.0,4,3.5,3380,1,9,2160,1220,47.6124,2910
477500.0,2,2.0,2090,1,7,2090,0,47.5732,1600
1250000.0,4,2.75,4120,4,8,2060,2060,47.5914,3680
270000.0,3,1.75,1260,0,6,840,420,47.772,1340
567000.0,3,2.25,1800,0,8,1230,570,47.6773,1800
635000.0,3,2.5,1960,0,8,980,980,47.5655,1440
1865000.0,6,2.75,4460,2,10,3460,1000,47.6626,2750
183000.0,3,1.75,1330,0,7,1330,0,47.2916,1590
309933.0,3,1.75,1820,0,6,1220,600,47.3364,1340
945800.0,4,2.75,3360,0,8,1760,1600,47.5641,2620
503000.0,2,1.75,2860,4,8,1510,1350,47.3276,2720
220000.0,3,1.0,1460,0,7,1460,0,47.4238,1460
335000.0,3,1.75,1900,0,8,1900,0,47.3041,1950
650000.0,3,2.25,1790,2,7,1240,550,47.5822,2610
511000.0,4,3.5,3100,0,10,3100,0,47.3892,3350
275000.0,2,1.0,900,0,6,900,0,47.4735,1440
576250.0,2,1.75,1530,0,7,1260,270,47.6755,1470
1452000.0,2,3.25,2070,3,9,1760,310,47.5686,2740
186000.0,3,2.0,1340,0,5,920,420,47.299,980
655100.0,1,1.0,1220,0,7,1220,0,47.6746,1970
328000.0,4,2.5,2370,0,9,2370,0,47.3328,2590
441000.0,3,2.5,1890,0,8,1460,430,47.7426,2040
370000.0,3,1.75,1480,0,7,1480,0,47.483,1720
630000.0,2,1.0,1050,0,7,1050,0,47.5627,2400
470500.0,4,2.25,2070,0,7,1720,350,47.7484,1690
285950.0,2,1.0,1170,0,6,1170,0,47.5033,1130
698000.0,3,1.5,1090,0,7,1090,0,47.5817,2010
268000.0,3,2.5,1650,0,7,1650,0,47.4051,1850
1625000.0,4,3.75,4410,4,11,3570,840,47.5888,2770
355000.0,4,2.5,1780,0,7,1780,0,47.4239,2005
299000.0,3,1.0,1550,0,7,1250,300,47.5413,2120
1003000.0,4,2.75,2290,0,7,2170,120,47.6746,1910
275000.0,4,2.0,2220,0,7,2220,0,47.3722,1660
475000.0,3,1.75,1150,0,6,1030,120,47.5222,1270
260000.0,4,2.5,2000,0,8,2000,0,47.3398,2390
416000.0,2,1.75,1270,0,7,1270,0,47.7083,1480
495000.0,5,1.0,1810,2,7,1810,0,47.5099,1860
357500.0,3,1.0,1450,0,6,1450,0,47.7027,1450
459500.0,2,1.5,1170,0,7,1170,0,47.6607,1170
258000.0,3,2.5,1730,0,8,1730,0,47.2621,1780
600000.0,3,2.25,2680,0,8,2680,0,47.5015,2340
665000.0,3,1.0,1260,2,7,1260,0,47.5442,2500
165000.0,3,1.5,1020,0,6,1020,0,47.4971,1320
297000.0,5,2.5,1970,0,7,1970,0,47.1944,1970
350000.0,2,1.0,830,0,7,830,0,47.5259,1220
2450000.0,4,4.5,5030,2,11,3250,1780,47.5722,3640
180000.0,2,1.0,800,0,6,800,0,47.4563,1090
339950.0,3,1.75,1330,0,6,720,610,47.5102,1770
365000.0,3,1.0,1030,0,7,1030,0,47.5118,1030
955000.0,4,4.25,5660,0,10,4100,1560,47.7064,3620
732000.0,3,2.5,2330,4,9,1410,920,47.6735,2640
500000.0,3,1.75,1540,0,6,770,770,47.5763,2020
610000.0,6,2.75,2040,2,7,1100,940,47.616,2230
525000.0,3,2.0,1540,0,8,1540,0,47.7041,1510
170000.0,4,1.0,1920,0,7,1220,700,47.4502,1490
300000.0,3,2.5,1870,0,7,1870,0,47.3992,2190
389500.0,5,3.5,2960,0,9,1940,1020,47.3134,2210
330000.0,3,1.5,1690,0,7,1690,0,47.4531,1990
269950.0,3,2.25,1610,0,7,1610,0,47.3764,1640
107000.0,2,1.0,670,0,6,670,0,47.5243,1480
249000.0,3,1.0,1752,2,8,1752,0,47.3755,1800
442500.0,4,2.0,1540,0,7,1540,0,47.7148,1630
579000.0,3,2.5,3160,3,9,3160,0,47.3401,2110
621500.0,3,1.75,2570,0,8,2570,0,47.596,2990
203000.0,3,1.5,1370,0,7,1080,290,47.4167,1400
222900.0,2,1.0,860,0,5,860,0,47.4979,900
453000.0,2,1.5,1680,0,7,1680,0,47.3836,1610
190000.0,1,0.75,930,0,6,930,0,47.4837,2000
320000.0,4,1.75,1820,0,7,1150,670,47.4567,1610
733500.0,3,1.5,2120,0,8,2120,0,47.606,1960
555000.0,4,2.25,3330,0,9,3330,0,47.4725,3330
364950.0,3,2.25,2520,0,7,1850,670,47.3522,2260
490000.0,3,1.75,1560,0,7,1160,400,47.6954,1690
688000.0,5,1.75,2250,1,8,1350,900,47.7108,2580
165000.0,2,1.0,640,0,6,640,0,47.515,840
506000.0,5,3.75,3880,0,7,3880,0,47.4811,2160
2193000.0,3,2.25,3360,0,10,2770,590,47.6187,3450
754000.0,5,1.75,2350,0,8,1510,840,47.6225,2220
949950.0,5,2.5,2340,4,8,2340,0,47.5193,2200
443600.0,3,2.5,1430,0,8,1430,0,47.684,1310
380600.0,3,2.5,1920,0,7,1920,0,47.7256,1920
722800.0,3,3.25,4330,0,10,3630,700,47.6341,3220
342888.0,2,1.0,790,0,6,790,0,47.5528,1460
555000.0,4,1.75,2350,2,8,1350,1000,47.6879,2060
613000.0,3,2.5,1350,0,7,1350,0,47.6099,1900
480000.0,3,2.0,1470,0,8,1470,0,47.726,1480
619500.0,6,1.5,1680,0,7,1680,0,47.6798,1890
437000.0,4,2.5,1890,0,8,1290,600,47.6796,1720
621000.0,4,2.5,2030,0,8,2030,0,47.5518,2130
810000.0,4,1.75,1760,0,8,1760,0,47.675,1760
415000.0,3,2.25,1950,0,7,1350,600,47.7538,1300
250000.0,4,1.0,1440,0,6,1080,360,47.5328,1620
585000.0,3,1.5,2230,1,8,1260,970,47.5373,2120
220000.0,3,1.0,1180,0,7,1180,0,47.7529,1470
580000.0,5,2.5,2500,0,7,1400,1100,47.5915,2820
1320000.0,3,2.75,2680,0,9,1820,860,47.6304,3060
675000.0,4,2.5,2040,0,8,1610,430,47.636,1730
695000.0,4,2.75,2660,0,9,2660,0,47.5993,2820
915000.0,5,2.75,2580,0,7,1730,850,47.6226,2040
375000.0,3,1.0,1000,0,7,1000,0,47.7142,1000
500000.0,3,1.5,1330,0,8,1140,190,47.5773,1330
335000.0,2,2.0,1420,0,7,1420,0,47.3543,2140
170000.0,2,1.0,1280,0,6,1280,0,47.3096,1520
320900.0,5,2.5,2200,0,7,1400,800,47.3073,1360
508000.0,3,1.75,1800,0,8,1440,360,47.6623,2210
228950.0,3,1.75,1200,0,7,1200,0,47.2795,1200
433000.0,4,2.0,1840,0,6,1080,760,47.5297,1170
267500.0,2,1.0,960,0,6,960,0,47.5201,1010
910000.0,4,1.5,2890,4,8,2090,800,47.5682,2550
370000.0,3,1.75,1290,0,7,1290,0,47.7598,1770
320000.0,2,1.0,1140,0,6,1140,0,47.5642,1190
660000.0,3,1.75,1750,1,8,1750,0,47.6995,2060
787888.0,4,2.25,2580,0,9,2580,0,47.5566,2690
329000.0,4,2.5,2650,0,9,2650,0,47.3509,2610
602000.0,2,1.0,1470,0,7,970,500,47.6716,1950
375000.0,3,2.0,1640,0,7,1640,0,47.7425,1340
212000.0,1,1.0,620,0,6,620,0,47.4697,1160
224000.0,3,1.5,1440,0,7,1440,0,47.5418,1440
315500.0,3,2.0,1160,0,7,1160,0,47.7341,1130
350000.0,2,1.0,1070,0,7,1070,0,47.6261,2030
389000.0,6,4.5,3560,0,7,3560,0,47.3244,1710
285000.0,3,1.75,1720,0,7,1720,0,47.4709,1840
425000.0,3,1.75,1530,0,8,1530,0,47.7655,1660
190000.0,3,1.75,1270,0,7,1270,0,47.3696,1830
374000.0,3,1.75,1510,0,7,1510,0,47.5491,1600
292000.0,2,1.0,880,0,6,880,0,47.5573,1080
475000.0,5,1.75,2020,0,7,1320,700,47.6915,1130
546500.0,3,2.5,1410,0,7,820,590,47.6786,1410
82000.0,3,1.0,860,0,6,860,0,47.4987,1140
219900.0,3,1.0,860,0,6,860,0,47.4987,1140
440000.0,3,1.0,1210,0,7,1210,0,47.5403,1160
400000.0,3,2.5,2090,4,7,1550,540,47.3338,1200
453000.0,3,1.75,1430,0,7,1430,0,47.5619,2140
330000.0,6,3.25,2120,0,7,1060,1060,47.5508,1380
359950.0,3,2.75,2540,0,8,2540,0,47.3209,2260
616000.0,4,2.5,2490,0,9,2490,0,47.6161,2440
245000.0,2,1.0,670,0,6,670,0,47.5918,1220
296000.0,2,2.0,1320,0,7,1320,0,47.7224,1430
193000.0,2,1.0,950,0,6,950,0,47.5219,1000
456000.0,3,2.0,1870,0,7,1060,810,47.6964,1640
480000.0,4,1.75,1840,0,7,980,860,47.708,1520
382000.0,3,3.25,1410,0,8,1410,0,47.6981,1410
650000.0,2,1.0,1050,0,7,880,170,47.6172,1620
431750.0,2,2.0,1400,0,8,1400,0,47.7262,1400
419900.0,3,2.5,1630,0,8,1320,310,47.691,1920
315000.0,3,2.0,1900,0,8,1900,0,47.2843,1790
597500.0,4,3.0,1890,0,9,1510,380,47.7112,2730
615000.0,3,2.5,2980,0,8,1930,1050,47.7631,2890
605000.0,4,3.25,2885,0,8,2885,0,47.5174,1910
220000.0,3,2.5,1980,0,8,1980,0,47.2656,2130
340000.0,4,2.5,3020,0,8,1710,1310,47.4298,1900
620000.0,4,2.5,2980,0,9,2980,0,47.4575,2530
602000.0,5,1.75,3290,0,8,3290,0,47.6626,2210
575000.0,3,1.75,1580,0,7,1180,400,47.5368,2150
285000.0,3,2.5,2090,0,8,1360,730,47.3537,1750
306500.0,3,1.5,1100,0,7,1100,0,47.5004,1430
325000.0,3,2.5,1870,0,7,1870,0,47.4831,2160
623000.0,3,2.75,2390,0,8,1450,940,47.7339,2390
256500.0,3,2.0,1320,0,7,1320,0,47.3904,1600
473000.0,5,3.5,3430,0,10,2830,600,47.4065,3650
549000.0,3,2.5,2250,0,8,2250,0,47.7268,2290
305000.0,3,1.0,1710,0,6,1710,0,47.656,1650
317000.0,4,2.5,2160,0,9,2160,0,47.3337,2490
450000.0,3,1.75,1400,0,8,1400,0,47.7413,2200
225000.0,2,2.5,1560,0,5,780,780,47.4749,1010
500000.0,5,2.0,2300,0,8,2300,0,47.7556,2030
207000.0,2,1.0,820,0,6,820,0,47.5298,1240
474900.0,3,1.0,1630,0,7,1630,0,47.5075,1170
515000.0,3,2.5,2010,0,8,2010,0,47.7372,1970
542000.0,4,1.0,1540,0,7,1090,450,47.6754,1590
725000.0,4,2.75,2420,0,8,1530,890,47.6218,2620
314950.0,3,2.5,1690,0,7,1690,0,47.3575,1830
375000.0,3,2.0,1410,0,6,1410,0,47.7587,2090
500000.0,3,1.75,1640,0,7,1640,0,47.654,2280
689000.0,3,1.75,2200,0,8,1500,700,47.559,2410
525000.0,3,2.25,1290,0,8,1000,290,47.637,1300
360000.0,3,1.5,1060,0,7,1060,0,47.5329,1120
425000.0,3,1.0,1240,0,6,1240,0,47.564,1240
239950.0,2,1.0,1280,0,7,1280,0,47.5179,1270
577500.0,2,2.5,2330,3,8,2330,0,47.5953,1760
615000.0,3,1.75,2360,0,8,1360,1000,47.5274,1860
516000.0,4,2.75,2210,0,8,1170,1040,47.6086,2210
1218000.0,4,2.75,3670,3,10,3670,0,47.5581,3370
1655000.0,4,3.5,3080,3,10,2300,780,47.6417,2910
315000.0,2,1.0,770,0,6,770,0,47.7505,1120
250000.0,4,2.0,2600,0,8,1410,1190,47.381,2600
250000.0,4,1.5,1220,0,6,1220,0,47.5292,1410
925000.0,4,2.5,2910,0,8,1910,1000,47.6495,2760
358000.0,3,1.0,1150,0,7,1150,0,47.7284,1150
262000.0,3,2.5,1700,0,8,1700,0,47.2621,1720
500000.0,3,1.75,1220,0,7,1220,0,47.6334,1580
1300000.0,5,1.0,1670,0,8,1670,0,47.6542,1910
500000.0,3,1.75,2420,1,8,2420,0,47.6525,2970
675000.0,3,2.25,2610,0,9,2610,0,47.6909,2320
235000.0,3,1.0,960,0,7,960,0,47.5611,1460
545000.0,3,1.0,960,0,7,960,0,47.5611,1460
350000.0,3,1.0,1010,0,6,1010,0,47.6874,1470
320000.0,2,2.25,1550,0,8,1550,0,47.5394,1420
452000.0,5,2.5,5067,2,9,3154,1913,47.3391,2860
875000.0,3,2.0,2350,0,8,1990,360,47.6476,2010
325000.0,3,1.5,1310,0,7,1310,0,47.5873,1310
756000.0,4,2.25,2160,0,7,1080,1080,47.6442,1850
319000.0,4,2.5,2510,0,8,1610,900,47.3715,2030
455000.0,3,1.75,890,0,7,750,140,47.6803,1280
330000.0,2,1.0,1129,0,7,1129,0,47.5313,1300
510000.0,4,3.25,1980,0,8,1340,640,47.6883,1980
532000.0,3,1.0,2360,0,7,1560,800,47.5705,1690
775000.0,3,2.5,2480,0,8,1960,520,47.6974,1650
410000.0,3,1.75,2160,0,7,1080,1080,47.5721,1260
205000.0,2,1.75,1740,0,6,580,1160,47.5211,1440
585000.0,4,2.5,2430,0,8,2430,0,47.7294,1820
255000.0,2,1.75,1950,0,8,1950,0,47.3161,2370
415000.0,2,1.0,910,0,7,910,0,47.6772,1160
459000.0,4,2.0,2360,0,6,1180,1180,47.5261,1340
354000.0,3,1.0,1130,0,7,1130,0,47.7254,1410
587000.0,3,2.5,2150,0,8,2150,0,47.6952,2150
782000.0,4,3.5,5270,0,10,3440,1830,47.4358,2340
570000.0,3,1.5,1300,0,7,1300,0,47.6889,1300
414500.0,3,1.0,1050,0,7,840,210,47.6988,1180
185000.0,4,1.0,1380,0,7,1190,190,47.4871,1380
262500.0,3,1.5,1610,0,7,1610,0,47.2025,1410
370000.0,4,2.75,3150,0,9,2250,900,47.3382,2210
362500.0,3,1.0,1520,0,7,1520,0,47.7162,1360
536000.0,3,2.5,1990,0,9,1990,0,47.7703,2210
425000.0,5,2.0,2500,0,7,1570,930,47.5031,1170
435000.0,3,2.25,1890,0,7,1230,660,47.7156,1970
435000.0,5,2.0,1840,0,7,1540,300,47.7308,1200
400000.0,2,1.0,1220,0,7,760,460,47.5299,1850
446000.0,2,1.5,1370,0,8,1080,290,47.6039,1560
1250000.0,3,2.5,2710,0,10,2710,0,47.6718,3130
300000.0,3,2.25,1760,0,7,1760,0,47.3484,1570
404500.0,2,1.0,800,0,7,800,0,47.6978,1560
910000.0,4,2.5,3530,0,9,3530,0,47.7285,3750
771000.0,3,2.25,1780,0,9,1390,390,47.6025,1960
335000.0,4,2.5,2610,0,8,2610,0,47.2649,2583
390000.0,3,1.75,1850,0,7,1850,0,47.4991,1160
288000.0,3,2.25,1560,0,7,1560,0,47.3191,1510
403000.0,3,1.75,1270,0,7,1270,0,47.6647,1270
510000.0,3,2.25,1420,0,8,1420,0,47.6534,1500
751000.0,6,3.0,2880,0,7,2880,0,47.5873,1640
408000.0,3,1.0,1420,4,7,1420,0,47.5169,1780
1014250.0,3,1.0,1640,0,6,1500,140,47.6169,2190
575000.0,3,2.0,1730,0,7,1730,0,47.5875,1470
330000.0,3,1.75,1250,0,7,1250,0,47.5016,1300
565000.0,3,2.25,1520,0,8,1520,0,47.674,1550
456000.0,3,2.5,1820,0,8,1820,0,47.6018,1820
652500.0,4,2.5,2700,0,9,2700,0,47.5771,2500
582000.0,3,1.75,1820,0,8,1820,0,47.5271,2030
700000.0,4,2.5,2770,0,9,2770,0,47.5997,2910
235000.0,2,1.0,1270,0,6,1270,0,47.5365,1760
460000.0,3,1.75,1400,0,7,1400,0,47.5926,2540
475000.0,3,2.25,1820,0,8,1240,580,47.7206,2030
579000.0,2,2.0,1870,0,8,1870,0,47.7108,1670
507000.0,4,2.0,1360,0,7,1360,0,47.6736,1960
210000.0,3,2.5,1040,0,7,720,320,47.5165,1540
359500.0,4,2.75,2140,0,8,2140,0,47.3537,1920
248000.0,3,1.75,1330,0,7,1330,0,47.3304,1330
239300.0,3,1.0,1070,0,7,1070,0,47.5071,1420
315000.0,3,2.25,1370,0,8,1370,0,47.7326,1370
970000.0,4,3.0,3510,0,9,3510,0,47.6381,3000
510000.0,3,1.5,1730,1,8,1000,730,47.5282,1620
418000.0,4,1.5,1550,0,7,1000,550,47.6005,1730
699000.0,4,2.5,3280,0,9,3280,0,47.6711,3200
871000.0,4,2.5,2150,3,8,1400,750,47.5663,2800
515000.0,3,1.75,1580,1,7,1210,370,47.6069,2600
400000.0,3,1.0,1460,0,7,1460,0,47.4434,2250
445000.0,3,1.75,1410,0,7,1110,300,47.7026,1600
1110000.0,4,2.75,3090,2,9,1800,1290,47.6339,2380
212000.0,3,1.5,1690,0,7,1210,480,47.3857,1450
710000.0,4,2.5,2870,0,9,2870,0,47.5547,2690
225800.0,4,1.0,1100,0,7,880,220,47.3858,1150
520000.0,3,1.75,2310,2,8,1580,730,47.7697,2000
1295000.0,5,3.75,3490,1,10,1940,1550,47.5479,3410
248000.0,4,2.0,2080,0,7,1040,1040,47.4918,2010
556000.0,4,2.5,2230,0,7,1220,1010,47.589,1920
319950.0,5,1.75,1710,0,7,1070,640,47.506,1030
320000.0,4,2.75,1640,0,7,1000,640,47.5625,1150
245000.0,3,2.5,1600,0,7,1600,0,47.4034,1720
700000.0,3,2.5,2850,0,10,2850,0,47.7376,3340
628000.0,5,2.75,2600,0,8,2600,0,47.7348,1600
640000.0,3,2.0,1380,0,7,1380,0,47.651,1740
420000.0,4,1.75,1320,0,7,940,380,47.5266,1260
349950.0,3,2.5,1420,0,8,1420,0,47.6982,1430
307999.0,4,2.75,2420,0,8,2420,0,47.2091,2420
749950.0,4,2.75,2600,0,8,1960,640,47.5656,1990
290000.0,2,1.0,840,0,6,840,0,47.7048,1040
235000.0,3,1.75,1420,0,7,1420,0,47.2931,1420
225000.0,3,1.0,1790,0,6,1790,0,47.508,830
302100.0,3,1.0,1790,0,6,1790,0,47.508,830
520000.0,2,1.0,1340,0,7,890,450,47.697,1380
285000.0,2,1.0,1010,0,7,1010,0,47.7651,1890
525000.0,3,2.0,1640,0,8,1640,0,47.6301,1640
374900.0,5,2.75,2980,0,8,1540,1440,47.3641,2310
377500.0,3,2.0,1370,0,7,1130,240,47.7329,1300
587450.0,3,2.25,2190,1,8,2190,0,47.7303,1910
245000.0,3,2.25,1530,0,7,1070,460,47.2715,2140
200000.0,3,2.0,1290,0,7,1290,0,47.3175,1580
2140000.0,4,3.75,5150,3,11,4360,790,47.6795,2500
607000.0,3,2.5,2470,0,9,2470,0,47.7439,2820
1247000.0,1,1.25,1810,4,8,1230,580,47.5814,2280
549950.0,4,2.5,2230,0,7,1180,1050,47.6305,1470
250000.0,3,3.0,2300,0,7,2300,0,47.5102,1570
525000.0,3,2.5,2030,0,8,2030,0,47.5718,2000
440000.0,3,1.75,2000,2,8,1480,520,47.4436,2310
425000.0,3,2.75,3610,3,8,3130,480,47.3351,2630
739900.0,5,2.5,3290,0,8,3290,0,47.5773,2990
315000.0,3,2.0,1300,0,7,900,400,47.5374,1300
340000.0,5,1.0,1880,0,6,1360,520,47.566,1420
366000.0,4,2.75,2170,0,7,2170,0,47.3814,1670
315000.0,3,1.75,1680,0,7,930,750,47.7201,1340
299000.0,3,1.5,1190,0,7,1190,0,47.5164,1520
350000.0,2,1.0,940,0,7,940,0,47.7518,1800
340000.0,2,1.75,1010,0,7,670,340,47.6515,1500
460000.0,3,1.75,1290,0,7,1290,0,47.6707,1840
224000.0,3,1.5,1480,0,7,1480,0,47.2872,1370
140000.0,2,1.0,900,0,6,900,0,47.5287,1350
246000.0,4,2.0,1400,0,6,1400,0,47.4625,1400
330000.0,3,2.5,2040,0,7,2040,0,47.7278,1890
306000.0,3,1.0,1450,0,7,1010,440,47.7311,1500
324950.0,3,1.0,1210,0,7,1210,0,47.7402,1120
345000.0,2,1.5,1800,0,7,1240,560,47.302,2010
207000.0,3,1.0,1490,0,7,1490,0,47.4901,1490
238000.0,3,1.0,1240,0,6,1240,0,47.4927,1140
695000.0,3,2.0,2632,3,10,2632,0,47.3743,1970
649950.0,3,2.5,2150,0,9,2150,0,47.5573,2540
515000.0,3,2.75,1710,0,7,1010,700,47.6693,1960
452000.0,3,2.5,1530,0,7,1530,0,47.6985,1450
236000.0,4,2.5,1630,0,7,1630,0,47.5072,1270
1285000.0,4,3.5,4080,2,12,3210,870,47.5519,4080
563000.0,3,2.75,2340,0,8,1500,840,47.5952,2210
410988.0,3,1.75,1000,0,7,1000,0,47.7417,1260
339950.0,0,2.5,2290,0,8,2290,0,47.3473,2500
1200000.0,4,2.5,3180,0,11,3180,0,47.5382,3070
340000.0,4,2.5,2170,0,8,2170,0,47.4034,2280
808100.0,4,3.25,3020,0,9,3020,0,47.7174,2120
236000.0,3,1.75,1330,0,7,1330,0,47.3411,1330
330000.0,4,1.75,1720,0,8,1720,0,47.4654,1840
799990.0,4,3.5,2540,0,8,1820,720,47.6857,1520
240000.0,0,2.5,1810,0,7,1810,0,47.3493,1810
343000.0,3,1.0,1410,0,7,1410,0,47.5031,1610
332000.0,3,2.5,1530,0,7,1270,260,47.4852,1700
945000.0,5,3.5,4380,0,11,4380,0,47.5848,4310
239950.0,3,1.0,1140,0,6,1140,0,47.4768,960
674000.0,5,1.75,2110,0,7,1250,860,47.6745,1720
200000.0,3,1.0,1050,0,6,1050,0,47.4923,1050
453000.0,3,1.75,1600,0,8,1600,0,47.6293,1970
330000.0,3,1.75,1430,0,7,1430,0,47.7331,1250
285000.0,4,2.5,1996,0,7,1996,0,47.3365,2180
338000.0,4,1.75,1530,0,6,910,620,47.7557,1310
264950.0,2,1.0,1000,0,6,1000,0,47.5208,1250
880000.0,4,2.0,2530,0,8,1350,1180,47.5705,2960
209500.0,3,1.5,970,0,7,970,0,47.5366,1040
380000.0,4,2.5,2400,0,7,1310,1090,47.4952,1330
336500.0,3,2.0,1830,0,7,1830,0,47.3924,2320
360000.0,3,2.25,2130,0,7,1290,840,47.4537,2250
911100.0,4,3.25,3330,0,8,3330,0,47.7596,2580
249900.0,2,1.0,560,0,6,560,0,47.5271,990
175000.0,4,1.0,1210,0,7,1210,0,47.5008,1210
549950.0,3,2.5,2380,3,9,2380,0,47.5734,2270
225000.0,3,1.75,1370,0,6,1370,0,47.6774,1580
270000.0,3,1.75,1370,0,6,1370,0,47.6774,1580
400000.0,3,2.25,1740,0,8,1740,0,47.7376,1720
299800.0,2,1.0,790,0,6,790,0,47.5303,1430
555000.0,3,2.5,2480,0,8,2480,0,47.53,2540
230000.0,3,2.5,1920,0,8,1920,0,47.4818,1930
360000.0,4,2.5,2750,0,9,2750,0,47.3304,2810
415000.0,2,1.0,880,0,7,880,0,47.6575,1880
355000.0,4,1.75,2160,0,9,1660,500,47.3165,2350
635000.0,4,2.5,2570,0,8,2570,0,47.6343,2500
353000.0,5,2.75,2130,0,7,1100,1030,47.5271,1340
999000.0,7,4.0,3150,0,9,3150,0,47.6029,2390
265000.0,3,1.5,1780,0,7,1270,510,47.3375,1320
250000.0,4,1.75,1910,0,7,1910,0,47.6131,1500
225000.0,2,1.0,1170,0,7,1170,0,47.7497,1170
553000.0,2,1.0,900,0,7,900,0,47.6883,1280
565000.0,5,2.5,2650,0,7,1400,1250,47.6141,1960
312000.0,2,1.0,1170,0,6,980,190,47.5503,1660
475000.0,3,2.5,2630,0,9,2630,0,47.7035,2630
320000.0,4,2.75,2150,0,8,1340,810,47.266,2260
453000.0,3,2.0,1430,0,7,1430,0,47.7206,1890
320000.0,3,1.0,960,0,6,960,0,47.5518,1250
610000.0,4,2.75,2640,2,8,1440,1200,47.5882,2610
385000.0,3,1.5,1490,0,8,1490,0,47.7623,1960
215000.0,3,1.75,1210,0,6,1210,0,47.2666,1310
215000.0,4,1.5,1860,0,8,1860,0,47.2077,1680
415000.0,3,2.5,1980,0,7,1980,0,47.7767,2000
350000.0,1,1.0,900,0,6,900,0,47.7019,1830
395000.0,1,1.0,900,0,6,900,0,47.7019,1830
898000.0,2,1.75,1490,0,7,1490,0,47.6246,2280
480000.0,3,2.5,2980,0,8,2980,0,47.437,3010
1240000.0,3,2.5,2660,3,9,1870,790,47.6264,1640
599000.0,4,2.5,2790,0,8,2790,0,47.7647,1590
770000.0,4,3.0,2800,0,9,2800,0,47.6123,2780
1208000.0,3,2.25,1590,0,8,1590,0,47.6477,2470
1590000.0,4,2.25,3240,0,9,2080,1160,47.6182,2300
880000.0,3,2.0,2130,0,8,2130,0,47.7489,2860
332000.0,3,2.0,1510,0,6,1510,0,47.4683,1050
445000.0,3,1.75,1750,0,7,1750,0,47.6289,1810
849000.0,4,2.75,4010,0,10,4010,0,47.4299,2451
752000.0,4,1.5,1650,0,7,1650,0,47.6233,1670
450000.0,9,7.5,4050,0,7,4050,0,47.5923,1448
420000.0,3,1.0,1320,0,7,1320,0,47.5705,1480
330000.0,4,2.5,2310,0,8,2310,0,47.3287,1850
409000.0,3,1.75,1440,0,8,1440,0,47.7163,1990
350000.0,5,1.75,2330,0,7,1180,1150,47.4768,1690
570000.0,4,2.5,2430,0,8,2430,0,47.7125,2200
315000.0,3,1.0,1390,0,7,1390,0,47.7652,1320
224000.0,2,1.0,1150,0,6,1060,90,47.4935,1350
293550.0,4,1.75,2120,0,7,1370,750,47.4939,1730
350000.0,4,2.75,2300,0,6,1340,960,47.5732,1260
1108000.0,4,2.5,3320,3,10,3320,0,47.5655,2870
442500.0,4,2.5,2400,0,7,2400,0,47.7522,2350
616500.0,3,2.5,3580,0,9,3240,340,47.4453,3240
506400.0,3,2.5,2100,0,8,1700,400,47.5329,2430
324000.0,3,2.25,1550,0,7,1550,0,47.7373,1620
169000.0,3,1.5,1570,0,6,1570,0,47.2021,1400
595000.0,3,2.0,1480,0,7,750,730,47.6859,1250
299900.0,3,2.5,2720,0,7,2720,0,47.3344,2760
332000.0,3,2.25,2270,0,7,1380,890,47.4653,2150
432000.0,4,1.75,2410,0,7,1600,810,47.7341,1850
510000.0,4,2.75,2730,2,9,1740,990,47.4005,3050
270000.0,3,2.5,1540,0,7,1540,0,47.3511,1720
750000.0,5,2.5,3120,4,11,3120,0,47.6142,3390
509250.0,2,1.5,1480,0,7,930,550,47.6684,1000
189000.0,3,1.0,860,0,6,860,0,47.3677,1010
726500.0,4,2.5,2180,0,8,2180,0,47.6886,1710
287000.0,3,2.0,1300,0,7,1300,0,47.4839,1480
679000.0,4,3.5,3420,0,9,3420,0,47.3534,3580
316000.0,3,2.25,2130,0,8,1570,560,47.4202,2130
498000.0,4,2.5,2300,0,8,2300,0,47.6454,2640
448000.0,4,1.75,2560,0,7,1480,1080,47.7572,2320
535000.0,2,1.0,1040,0,7,1040,0,47.6774,2080
560000.0,4,3.0,3080,1,10,3080,0,47.334,3200
437850.0,4,2.25,2670,0,8,1610,1060,47.5623,2470
435000.0,4,2.75,3270,0,8,2720,550,47.347,2780
510000.0,4,2.5,2610,0,8,2610,0,47.7717,2320
520000.0,3,2.5,2460,0,8,2460,0,47.4996,2770
509000.0,2,1.5,1930,0,8,1930,0,47.6092,1840
575000.0,3,1.0,1220,0,6,1220,0,47.5767,1490
365000.0,4,2.5,2030,0,7,1330,700,47.5067,1980
795000.0,3,2.0,2420,1,9,1500,920,47.7074,2955
285000.0,3,2.5,1870,0,7,1870,0,47.3986,2190
955000.0,3,2.25,3020,0,10,2720,300,47.6456,3910
775000.0,4,2.5,2880,4,8,2050,830,47.7704,2880
400000.0,4,3.0,1810,0,7,1810,0,47.5691,1670
570000.0,4,2.5,2590,0,9,2590,0,47.738,2660
955990.0,5,3.25,3830,0,9,3830,0,47.6843,3950
1150000.0,3,2.25,3250,0,10,2260,990,47.6077,2770
459950.0,4,2.0,2760,0,9,2120,640,47.3818,2550
245000.0,2,1.75,1220,0,6,1220,0,47.5033,1100
281000.0,3,1.5,1280,0,7,1280,0,47.7162,1420
205000.0,3,0.75,770,0,4,770,0,47.5661,950
290000.0,3,1.75,1520,0,7,1520,0,47.398,1580
635000.0,4,2.5,2080,0,8,2080,0,47.7107,1390
310000.0,1,1.0,570,0,5,570,0,47.5517,1530
470000.0,4,2.0,1500,0,7,830,670,47.6088,1560
600000.0,2,2.5,2510,0,10,2510,0,47.7525,3080
279000.0,4,2.0,1980,0,7,1980,0,47.3231,1520
538500.0,3,3.5,2500,0,8,2500,0,47.536,2420
594950.0,4,2.5,2720,0,9,2720,0,47.6295,2720
533050.0,2,1.0,910,0,5,910,0,47.3752,2050
510000.0,3,1.75,1480,0,7,1480,0,47.6723,2040
360000.0,4,2.25,2470,0,7,1270,1200,47.4371,1900
435000.0,2,1.0,1650,0,7,1090,560,47.6992,1300
559000.0,3,1.75,1700,0,8,1700,0,47.6837,1880
645000.0,2,1.5,1995,1,8,1995,0,47.4022,2142
340000.0,2,1.0,1280,0,6,640,640,47.5341,1630
565000.0,4,2.5,2980,0,9,2980,0,47.7354,2920
575700.0,3,1.75,1730,0,7,1480,250,47.6978,1730
1010000.0,3,3.25,2420,2,10,1840,580,47.637,1840
540500.0,3,2.0,2800,0,8,2320,480,47.4133,2200
265000.0,5,4.0,1400,0,7,900,500,47.456,1220
699950.0,4,2.0,2070,1,7,1180,890,47.7058,2390
355000.0,1,1.75,750,0,4,550,200,47.4756,2020
381000.0,3,1.5,1460,0,7,1460,0,47.746,1470
564000.0,5,2.25,2140,2,8,1220,920,47.6969,1720
114975.0,2,1.0,740,0,6,740,0,47.506,980
325000.0,1,0.75,410,0,4,410,0,47.5077,1190
299990.0,2,1.0,1570,3,7,1570,0,47.2077,1660
751000.0,5,2.75,2860,0,9,2860,0,47.707,3150
425000.0,3,2.25,1400,0,8,1400,0,47.542,1800
665000.0,3,1.75,2700,2,8,1560,1140,47.5834,3010
833450.0,5,4.0,4460,4,9,3330,1130,47.4992,2670
575000.0,7,1.5,2670,0,8,2320,350,47.7121,2030
190000.0,3,1.75,1520,0,7,1520,0,47.473,1590
314950.0,3,1.75,1520,0,7,1520,0,47.473,1590
601150.0,2,2.0,1660,0,7,1120,540,47.6871,1260
315000.0,2,1.0,860,0,7,860,0,47.508,1200
545000.0,2,1.5,2340,0,7,1280,1060,47.5017,1490
565000.0,4,2.25,2110,0,8,2110,0,47.5614,2220
175000.0,3,1.0,1010,0,7,1010,0,47.49,1440
530000.0,3,2.0,2330,0,8,2330,0,47.6009,2030
4489000.0,4,3.0,6430,0,12,6430,0,47.6208,3720
430000.0,3,1.75,1610,0,8,1310,300,47.7588,2210
225000.0,3,1.75,1460,0,7,1460,0,47.3683,1220
312000.0,5,4.0,2900,0,7,1950,950,47.5003,1360
380000.0,3,1.0,1260,0,7,1260,0,47.7013,1760
222200.0,2,1.0,1210,0,7,1210,0,47.4402,1620
1438890.0,5,3.5,3420,0,10,3420,0,47.5736,1900
329950.0,4,2.5,2120,0,7,2120,0,47.3795,2370
995000.0,3,2.5,2460,0,10,2460,0,47.6999,2410
929950.0,3,3.5,3790,0,11,3790,0,47.5525,3620
692000.0,4,2.5,2350,0,10,2350,0,47.6411,2700
402000.0,2,1.0,620,0,6,620,0,47.6655,1290
510000.0,3,1.75,1920,0,7,1340,580,47.6052,2540
249000.0,3,1.0,1050,0,7,1050,0,47.4043,1050
244900.0,3,1.5,1360,0,7,1360,0,47.4143,1360
289900.0,3,1.0,1180,0,6,1180,0,47.4947,1180
552500.0,4,1.0,1560,0,7,1170,390,47.5093,1570
760000.0,4,2.5,3300,0,8,3300,0,47.7657,3030
440000.0,2,2.75,1100,0,7,750,350,47.6405,2090
286000.0,3,1.75,1770,0,7,1090,680,47.4997,1520
260000.0,3,1.0,1200,0,6,800,400,47.519,940
355000.0,2,2.25,1330,0,8,1330,0,47.7689,1390
318000.0,3,1.75,1570,0,8,1570,0,47.3365,2120
255000.0,2,1.0,1610,0,7,1610,0,47.5095,2100
139000.0,3,1.0,1100,0,7,1100,0,47.3003,1530
485000.0,4,2.25,1810,0,7,1810,0,47.7319,1460
549950.0,3,1.75,2930,0,8,2440,490,47.6991,2700
588000.0,3,1.5,1780,0,8,1780,0,47.662,1380
975000.0,3,2.5,3050,0,8,1950,1100,47.6772,1890
402000.0,3,2.0,1540,0,8,1540,0,47.5479,1540
245000.0,3,1.0,1380,0,7,1380,0,47.5131,1200
445000.0,3,1.75,1890,3,8,1890,0,47.4137,1890
195000.0,3,1.75,1570,0,7,1570,0,47.2016,1650
385000.0,5,2.0,2540,0,7,1480,1060,47.7754,2000
450000.0,3,1.5,1520,0,7,1000,520,47.5659,1520
1090000.0,4,2.5,2780,0,9,2780,0,47.666,1160
396675.0,2,1.0,1730,0,6,1730,0,47.5357,1180
242000.0,5,2.25,2340,0,7,1170,1170,47.448,1650
380000.0,3,1.75,1300,0,6,1300,0,47.4996,1300
496000.0,2,1.0,1420,0,7,1420,0,47.68,1810
399950.0,3,2.5,1470,0,7,1470,0,47.723,1400
895000.0,4,2.5,2850,0,9,2850,0,47.6747,2440
690000.0,3,2.0,2360,3,8,1560,800,47.5433,2000
270000.0,3,1.5,1610,0,7,1610,0,47.7527,1610
349900.0,3,2.0,2420,0,7,1210,1210,47.4511,2650
454280.0,3,2.5,1470,0,8,1170,300,47.5464,1470
390000.0,3,2.5,1410,0,6,1410,0,47.7432,1410
275000.0,3,1.75,1840,0,8,1840,0,47.3124,2170
300000.0,4,2.5,2450,0,8,2450,0,47.3093,2410
700000.0,3,1.75,1500,0,7,850,650,47.6474,1700
520000.0,3,1.75,2080,0,7,1280,800,47.6883,1680
715000.0,3,2.5,2770,0,9,2770,0,47.6495,3010
404000.0,3,2.5,2370,0,8,2370,0,47.3515,2370
490500.0,3,2.0,3000,0,7,1970,1030,47.7599,2280
1485000.0,6,2.75,4430,3,10,2680,1750,47.5462,3530
557800.0,4,1.75,1550,0,7,1550,0,47.6567,1550
571000.0,4,2.25,2290,2,8,1550,740,47.4434,2320
410000.0,4,2.5,2560,0,9,2560,0,47.3533,3010
225000.0,3,1.5,1240,0,7,1240,0,47.5294,1670
700000.0,4,2.5,2590,0,9,2590,0,47.7047,2660
500000.0,3,1.0,1370,0,7,1370,0,47.6857,1590
536500.0,2,2.0,1360,0,7,680,680,47.6727,1440
330000.0,3,2.5,2060,0,8,1600,460,47.184,2050
249950.0,3,1.75,1120,0,7,1120,0,47.3659,1710
249000.0,4,1.75,1630,0,7,1630,0,47.4538,1390
249000.0,3,1.75,1590,0,6,1590,0,47.3769,1110
780000.0,4,1.75,2480,0,7,1390,1090,47.584,2440
1200000.0,4,2.5,2700,0,9,2700,0,47.6725,1810
434500.0,3,1.75,1930,0,7,1110,820,47.735,1870
590000.0,4,2.0,2490,0,8,2490,0,47.2725,1910
417200.0,2,1.0,1000,0,6,1000,0,47.6742,1490
649990.0,4,2.25,2130,0,9,2130,0,47.6408,2590
506000.0,2,1.0,1060,0,7,960,100,47.6721,1570
348000.0,3,2.5,1730,0,7,1730,0,47.4317,1730
301000.0,4,2.5,2810,0,9,2810,0,47.4045,2810
427550.0,2,1.0,880,0,7,880,0,47.6848,1150
361000.0,3,1.0,1040,0,7,1040,0,47.7444,1880
460000.0,2,2.5,1830,0,7,930,900,47.701,1260
958000.0,4,3.5,1800,2,8,1800,0,47.625,1700
445000.0,5,1.75,2460,0,7,1340,1120,47.5445,1410
373000.0,3,2.5,1670,0,7,1670,0,47.7623,1510
525000.0,4,2.25,2660,0,8,1750,910,47.7351,1890
364988.0,3,2.5,2850,0,9,2850,0,47.2848,2850
324000.0,2,1.0,820,0,7,820,0,47.7256,1410
625000.0,4,3.0,2350,0,8,1490,860,47.5514,2020
237500.0,3,1.75,1480,0,7,1480,0,47.1967,1130
429300.0,6,2.25,2930,0,8,1730,1200,47.7188,1730
155000.0,3,1.0,1250,0,7,1030,220,47.5292,1130
614000.0,4,2.75,2760,2,8,1780,980,47.7248,2720
650000.0,3,2.5,2380,0,9,2380,0,47.7194,2590
625000.0,3,2.0,1730,0,7,1730,0,47.5825,2470
587100.0,3,2.25,1670,0,8,1670,0,47.6921,2130
380000.0,4,2.5,2150,0,8,2150,0,47.3117,2410
479500.0,2,1.0,930,0,6,730,200,47.5598,1970
382888.0,1,1.0,620,0,6,620,0,47.6746,980
540000.0,4,4.25,1960,0,7,1960,0,47.5849,1920
691000.0,4,2.75,2550,0,8,1700,850,47.6477,2550
760500.0,3,2.0,1990,0,7,1130,860,47.6572,1710
685000.0,4,2.5,3550,0,9,3550,0,47.5431,3550
199129.0,3,1.0,860,0,6,860,0,47.295,1290
335000.0,3,3.0,2031,0,9,2031,0,47.3058,2390
305100.0,3,2.0,1590,0,8,1590,0,47.4365,2780
830000.0,4,2.25,3010,0,9,3010,0,47.6387,2480
810000.0,3,2.5,2610,0,10,2610,0,47.5535,3140
500000.0,3,2.25,1440,0,8,1180,260,47.6225,1440
490000.0,3,1.75,1920,2,7,960,960,47.5583,1190
490000.0,2,1.75,1670,0,7,1670,0,47.5862,1340
272000.0,4,1.75,1390,0,7,1030,360,47.4128,1800
280000.0,3,2.25,2140,0,7,2140,0,47.3913,1890
233000.0,3,1.0,1250,0,7,1250,0,47.7474,1490
275000.0,3,1.0,1080,0,7,1080,0,47.7579,1200
375000.0,3,3.25,2760,2,9,2110,650,47.3895,2030
445000.0,3,2.75,2180,0,8,2180,0,47.776,2190
437500.0,3,2.5,1260,0,8,1260,0,47.6706,1360
426250.0,4,1.0,1610,0,7,1510,100,47.5261,1430
358000.0,3,1.5,2450,0,7,2450,0,47.5317,1560
1175000.0,4,3.5,4150,0,11,4150,0,47.6746,3330
305000.0,2,1.0,960,0,5,960,0,47.5322,1620
415000.0,2,1.75,1340,0,8,1340,0,47.7182,1350
520000.0,11,3.0,3000,0,7,2400,600,47.556,1420
733000.0,4,3.5,3080,0,9,3080,0,47.6007,2950
411500.0,3,1.0,1130,0,7,1130,0,47.7362,1570
540000.0,3,1.75,2280,0,6,1760,520,47.7096,1850
270500.0,3,1.5,1952,0,7,1652,300,47.3715,1400
422250.0,2,1.5,1280,0,8,1200,80,47.6741,1390
655000.0,5,3.25,3690,0,9,3690,0,47.7672,2290
1200000.0,5,3.25,4610,3,11,3310,1300,47.5373,4042
550000.0,3,2.5,2920,0,9,2920,0,47.2492,2360
460000.0,2,2.25,1230,0,8,1020,210,47.6191,1270
159075.0,4,1.5,1580,0,6,790,790,47.4971,1320
470000.0,2,1.0,1220,0,6,1220,0,47.6801,1580
235000.0,2,1.0,1020,0,6,1020,0,47.5558,1530
309950.0,2,1.5,1510,0,7,1510,0,47.4419,1590
433000.0,4,1.75,1830,0,7,1010,820,47.5728,1910
895000.0,3,2.5,2750,3,8,1650,1100,47.5644,2490
291000.0,3,1.5,1860,0,7,1140,720,47.3796,2170
835000.0,3,2.5,2720,0,9,2720,0,47.6371,2760
640000.0,2,1.0,1360,0,7,1200,160,47.6372,1540
438000.0,3,2.25,2340,0,8,1340,1000,47.5715,2340
540000.0,4,2.5,2600,0,8,2600,0,47.4865,2830
325000.0,4,2.5,2090,0,7,1090,1000,47.4962,1260
380000.0,4,1.75,2260,0,7,1360,900,47.5122,1410
510000.0,2,1.0,1390,0,7,930,460,47.6696,1710
380000.0,4,2.5,2300,0,8,2300,0,47.3497,2320
825000.0,4,2.5,2810,0,8,1710,1100,47.5657,2800
880000.0,4,3.25,4060,0,9,4060,0,47.7615,3100
1800000.0,3,3.0,2790,4,10,2370,420,47.5466,3140
790000.0,3,1.0,1290,0,7,1290,0,47.6951,1630
287000.0,2,1.5,720,0,6,720,0,47.5225,790
509000.0,3,3.0,2130,0,7,1570,560,47.5451,1638
270000.0,3,2.25,1750,0,7,1350,400,47.4571,2020
210000.0,3,2.0,960,0,6,960,0,47.4852,1460
415000.0,3,1.0,1570,0,8,1570,0,47.7686,2010
550000.0,3,2.5,3070,3,9,1720,1350,47.3716,2020
1250000.0,4,2.5,2920,3,10,2030,890,47.6406,3790
499950.0,3,1.0,1870,0,7,1120,750,47.5771,1650
659000.0,3,1.5,1540,0,8,1540,0,47.6138,1590
265000.0,2,1.5,1440,0,7,1440,0,47.7698,1440
492000.0,4,3.75,2810,2,8,2070,740,47.4861,2370
715000.0,4,2.5,2450,0,8,1250,1200,47.5731,2450
175000.0,2,1.0,1330,0,6,1330,0,47.4824,1210
975000.0,4,3.5,3130,0,9,2430,700,47.5932,3200
306950.0,1,1.0,730,0,5,730,0,47.6992,1630
630000.0,4,2.0,2480,0,7,1470,1010,47.5686,1500
367500.0,3,1.0,1270,0,7,1270,0,47.5351,1780
699950.0,3,3.25,2230,1,8,1430,800,47.53,2070
1000000.0,3,3.0,2880,0,9,2220,660,47.6155,1910
285000.0,4,2.5,2434,0,8,2434,0,47.2874,2434
215000.0,2,1.5,1120,0,7,1000,120,47.534,1560
1050000.0,4,2.5,4080,0,11,4080,0,47.5188,3520
1370000.0,4,2.75,3720,4,10,1960,1760,47.5627,2900
235000.0,3,1.0,1430,0,6,1010,420,47.4783,1290
604000.0,3,2.0,1560,0,7,790,770,47.6587,1450
750000.0,3,1.75,1700,0,8,1460,240,47.6534,2010
800000.0,4,2.25,2510,0,9,2200,310,47.5973,3110
580000.0,5,2.0,2600,0,6,1400,1200,47.6691,1700
350000.0,1,1.0,790,0,6,790,0,47.5677,1070
353750.0,4,2.0,1710,0,7,1320,390,47.4544,1880
1100000.0,5,2.75,2660,4,8,1470,1190,47.5667,3280
465000.0,4,2.0,1470,0,7,1470,0,47.6316,1460
568000.0,3,2.0,2350,0,8,1780,570,47.5516,1700
1005000.0,5,2.0,2440,0,8,2440,0,47.6242,1640
213500.0,3,1.5,1150,0,7,1150,0,47.4931,1630
250000.0,3,2.5,1510,0,7,1030,480,47.758,1490
357000.0,2,1.0,870,0,7,870,0,47.5274,930
425000.0,2,2.0,1280,0,8,1280,0,47.5501,1470
571000.0,3,2.5,2600,0,9,2600,0,47.7387,2660
588000.0,3,2.25,2030,0,7,1190,840,47.6939,1950
275000.0,4,1.5,1930,0,7,1930,0,47.345,1580
565000.0,3,2.75,3210,1,10,3210,0,47.3357,2870
460000.0,3,1.75,1970,0,7,1370,600,47.7603,1880
603500.0,4,2.5,4060,4,9,2150,1910,47.7678,2750
490600.0,3,2.5,3316,0,9,3316,0,47.3036,3000
1010000.0,2,2.0,1460,2,6,1460,0,47.6857,2554
500000.0,4,2.0,2100,0,7,2100,0,47.7239,1720
249000.0,4,2.25,1830,0,7,1830,0,47.367,1830
235000.0,3,2.0,1530,0,7,1530,0,47.4529,1960
410000.0,4,2.0,1490,0,6,1490,0,47.712,2040
370000.0,2,1.0,860,0,7,860,0,47.5697,1130
360000.0,5,2.5,2130,0,7,1330,800,47.5071,1840
1406890.0,5,2.25,3580,0,9,3580,0,47.5364,3390
298000.0,4,2.5,2420,0,8,2420,0,47.3687,1880
485000.0,4,2.25,1900,0,8,1370,530,47.5033,2030
400000.0,3,1.75,1330,0,7,1330,0,47.5538,1950
580000.0,3,2.5,2150,0,8,2150,0,47.5893,2280
355000.0,2,2.5,1370,0,8,1080,290,47.7055,1340
650000.0,3,2.5,2430,0,9,2430,0,47.744,2720
261490.0,4,1.0,1640,2,6,1220,420,47.4894,1060
347000.0,3,1.0,1010,0,7,1010,0,47.7225,1120
485000.0,3,1.0,1500,0,7,1370,130,47.6689,1500
601000.0,3,2.5,1740,0,9,1180,560,47.644,1740
380000.0,3,3.25,2090,0,8,1510,580,47.3097,2690
565000.0,3,3.0,1850,0,9,1850,0,47.6286,2390
750000.0,3,2.5,2790,0,9,2790,0,47.673,2900
291000.0,3,2.25,1480,0,7,1190,290,47.3037,1830
560000.0,3,2.5,2280,0,9,2280,0,47.5688,2330
725000.0,4,2.25,3180,0,10,3180,0,47.6313,2840
539000.0,3,2.0,2350,0,7,2350,0,47.6527,2300
470000.0,5,3.25,3910,0,9,2710,1200,47.3766,2650
264950.0,2,1.0,770,0,6,770,0,47.7606,1060
200000.0,4,1.5,1780,0,6,1080,700,47.3124,1750
453500.0,5,2.5,2300,0,7,1170,1130,47.4739,2280
811000.0,2,2.5,2510,0,9,2510,0,47.6832,2440
425000.0,3,3.25,1410,0,8,1410,0,47.698,1410
1530000.0,4,2.25,4250,2,9,2380,1870,47.5453,3460
562000.0,4,2.75,2560,0,8,1860,700,47.7511,1990
281000.0,3,2.5,1760,0,8,1760,0,47.2672,1920
270000.0,3,2.25,2100,0,8,2100,0,47.3833,2730
205950.0,3,1.0,1490,0,6,1490,0,47.306,1200
310000.0,2,1.0,870,0,6,870,0,47.52,990
350000.0,3,1.75,1260,0,8,1260,0,47.5476,1410
843500.0,4,2.0,2630,0,8,2630,0,47.639,2670
370000.0,4,2.0,1950,0,6,1160,790,47.5372,1720
279000.0,4,2.0,2200,0,7,1100,1100,47.464,1790
408000.0,3,1.75,1600,0,7,1600,0,47.4129,1780
392000.0,3,1.0,1230,0,7,1230,0,47.5553,1510
455000.0,2,1.0,1030,0,6,1030,0,47.6585,1550
310000.0,2,1.5,1040,0,7,870,170,47.4222,1760
323500.0,3,3.0,2240,0,7,2240,0,47.4886,1650
364500.0,3,1.0,1600,2,6,800,800,47.5686,1640
280000.0,4,2.0,2190,0,7,1180,1010,47.2702,2160
289900.0,3,1.75,1899,0,7,1899,0,47.3987,2000
585000.0,3,1.0,1870,0,7,1580,290,47.6674,1640
269000.0,3,2.5,1730,0,7,1360,370,47.3588,1730
280000.0,3,2.25,1860,0,7,1860,0,47.3864,1530
287000.0,3,1.75,1940,0,7,1290,650,47.4361,1900
183000.0,2,1.0,670,0,6,670,0,47.5387,850
309000.0,3,1.0,1820,0,7,1040,780,47.505,1820
920000.0,4,2.5,3810,0,10,3810,0,47.6006,3310
815241.0,5,2.25,2060,0,8,2060,0,47.66,1740
405000.0,3,1.75,1520,0,7,1140,380,47.7358,1910
525000.0,5,3.5,3450,3,9,3450,0,47.2123,2570
150000.0,2,1.0,830,0,6,830,0,47.5293,1100
240000.0,4,1.75,1880,0,7,1020,860,47.2633,1560
698000.0,4,2.25,2200,0,7,1300,900,47.6845,2320
440000.0,3,2.0,1800,0,8,1800,0,47.557,2400
204000.0,3,1.0,1200,0,6,1200,0,47.4162,1200
875000.0,3,2.0,2220,2,7,1220,1000,47.6426,1800
650000.0,3,1.5,1380,0,7,1380,0,47.5866,1590
392500.0,3,1.0,1660,0,7,1660,0,47.7485,1230
400000.0,4,1.0,2320,0,6,1310,1010,47.573,1750
653000.0,3,2.25,2800,0,8,1420,1380,47.5716,2140
452000.0,4,1.0,1210,0,6,1210,0,47.6872,1540
345000.0,4,2.5,2331,0,8,2331,0,47.4444,2441
350000.0,4,1.75,1820,2,7,1320,500,47.5053,1820
650000.0,4,2.5,2860,0,8,2860,0,47.745,2290
525000.0,5,3.0,2750,0,7,1750,1000,47.6845,1900
840000.0,5,3.0,2750,0,7,1750,1000,47.6845,1900
1325000.0,3,2.5,2280,3,9,2280,0,47.6574,2200
259950.0,4,2.0,1610,0,7,1610,0,47.3085,1960
998000.0,5,3.5,3760,0,10,3150,610,47.5605,3550
1070000.0,3,3.0,2940,0,9,2230,710,47.6641,1580
1910000.0,4,3.0,4460,0,10,3140,1320,47.6342,3130
190500.0,3,1.5,1110,0,8,940,170,47.5929,1380
465000.0,3,2.25,2560,0,9,1280,1280,47.4655,2760
370000.0,3,1.0,1060,2,6,1060,0,47.7712,2190
290000.0,6,4.5,2810,0,8,2010,800,47.4045,1940
350000.0,3,1.75,1380,0,7,930,450,47.6841,1320
740000.0,3,1.75,1380,0,7,930,450,47.6841,1320
460000.0,3,1.75,2560,0,7,1970,590,47.7668,1970
290000.0,3,1.0,1010,0,7,1010,0,47.4483,1370
475000.0,3,1.5,1790,3,7,1790,0,47.2309,1970
214000.0,3,2.5,1600,0,7,1600,0,47.3314,1600
455000.0,2,1.0,910,0,6,910,0,47.7153,1520
275000.0,3,2.5,2497,0,8,2497,0,47.2873,2434
305000.0,3,1.5,1800,0,7,1800,0,47.333,1490
449000.0,5,2.5,2570,0,7,1470,1100,47.3013,1990
366000.0,3,2.5,1320,0,6,660,660,47.5327,1190
348000.0,3,2.5,1670,0,7,1670,0,47.4799,2560
515000.0,4,2.5,2800,0,8,2800,0,47.776,1880
950000.0,4,2.5,3360,0,9,3360,0,47.6534,3400
815000.0,3,2.5,2590,0,8,2590,0,47.6139,2590
199950.0,3,3.0,1530,0,8,1530,0,47.3746,1530
386000.0,3,2.0,1330,0,7,1330,0,47.7251,1590
273000.0,3,2.25,2160,0,8,2160,0,47.3622,2000
284000.0,4,2.5,1830,0,8,1830,0,47.4184,1830
399950.0,3,1.0,1470,0,7,1070,400,47.7013,1440
285000.0,3,1.75,1150,0,5,590,560,47.6973,1150
315000.0,3,2.5,1790,0,7,1790,0,47.3841,1610
250000.0,3,1.0,1700,0,7,1120,580,47.5114,1700
290000.0,4,2.0,1630,0,7,1630,0,47.3658,1320
725000.0,4,2.5,3420,0,9,3420,0,47.7745,2940
410000.0,3,2.0,1650,0,7,1650,0,47.7145,1940
855000.0,4,2.5,2810,0,9,2810,0,47.5941,3330
399900.0,4,2.5,2710,0,8,2710,0,47.379,2520
852600.0,4,2.5,3320,0,9,2650,670,47.554,2700
235000.0,2,1.0,720,0,6,720,0,47.551,920
230950.0,2,1.0,930,0,6,930,0,47.6567,1240
230000.0,3,2.25,1490,0,7,1490,0,47.3648,1510
404763.0,3,2.5,1690,0,8,1150,540,47.5521,1690
245000.0,3,2.5,1720,0,7,1720,0,47.4034,1720
188000.0,3,1.5,1140,0,7,1140,0,47.2093,1600
626100.0,4,2.5,2280,0,8,2280,0,47.5719,2240
428750.0,3,1.0,1100,0,7,900,200,47.6872,1170
522000.0,4,2.25,1800,0,8,1360,440,47.692,2370
684000.0,4,2.5,2500,0,8,2500,0,47.6915,1900
1065500.0,3,2.25,2950,2,8,1520,1430,47.5257,2130
611206.0,1,1.0,1940,3,8,1940,0,47.5782,2560
350000.0,2,1.0,1280,0,7,1140,140,47.5258,1050
894000.0,4,2.5,3800,0,9,3800,0,47.6734,3170
420000.0,2,1.0,930,0,7,930,0,47.6952,1770
400000.0,5,2.0,1930,0,7,1020,910,47.7743,2040
675000.0,3,3.0,2980,0,10,1820,1160,47.7318,2570
426000.0,4,2.5,2800,0,8,2800,0,47.3521,3740
750000.0,4,2.25,3190,0,10,2300,890,47.6323,2990
368000.0,3,1.75,1710,0,7,1710,0,47.7391,1890
342000.0,3,1.0,1980,0,6,1120,860,47.5291,1180
700000.0,3,1.75,1910,0,7,1080,830,47.6844,1750
848750.0,6,3.75,3160,0,8,3160,0,47.6748,1740
720000.0,3,2.0,1590,0,7,1320,270,47.6864,1620
525000.0,4,2.25,1890,0,8,1890,0,47.6328,1940
397900.0,3,2.75,2500,0,7,1580,920,47.3414,2060
405000.0,3,2.0,1740,0,7,1230,510,47.7397,1740
392800.0,3,2.0,1080,0,7,1080,0,47.6955,1220
394999.0,3,1.5,1730,0,7,1330,400,47.7365,1780
340000.0,3,2.5,2480,0,7,2480,0,47.4387,3220
482500.0,3,2.25,1450,0,7,980,470,47.6184,1510
812500.0,4,2.5,2750,0,10,2750,0,47.5426,3160
450000.0,3,2.5,2820,1,8,1410,1410,47.7609,1540
398000.0,3,1.75,1830,0,7,1830,0,47.7754,1860
1075000.0,2,3.25,1550,3,8,1550,0,47.5684,2710
540000.0,2,2.0,1640,2,7,840,800,47.666,1780
275000.0,4,2.0,1720,0,6,860,860,47.5299,1720
780000.0,5,2.0,2880,0,8,2880,0,47.5861,1720
225000.0,3,1.5,1220,0,7,1220,0,47.5038,1880
503045.0,3,3.0,1560,0,9,1560,0,47.6929,1610
249000.0,2,2.0,1090,0,7,1090,0,47.7526,1078
569950.0,4,1.0,1140,2,7,1140,0,47.6795,1630
450000.0,2,2.25,1040,0,8,1040,0,47.6692,1264
1099500.0,4,2.0,2580,0,9,1300,1280,47.6514,2300
700000.0,4,2.5,2310,0,7,1490,820,47.6889,1580
454000.0,3,2.5,1590,0,7,1590,0,47.61,1940
555000.0,3,1.75,1270,0,7,1270,0,47.6706,1700
214000.0,3,1.5,1240,0,6,1240,0,47.3683,1060
590000.0,3,2.5,2210,0,8,2210,0,47.5715,2340
459900.0,3,1.75,2340,0,8,1510,830,47.4846,2060
205000.0,3,1.5,1420,0,7,920,500,47.4192,1400
390000.0,3,1.75,1430,2,7,1140,290,47.4964,1310
970500.0,3,2.75,2470,0,8,2470,0,47.5651,2290
790000.0,3,2.5,2390,0,8,2390,0,47.3389,1850
320000.0,3,1.0,1120,0,7,1120,0,47.7575,1300
552500.0,3,2.25,2700,0,8,1760,940,47.6074,1580
1050000.0,3,3.0,3490,0,9,3170,320,47.6394,2840
230000.0,3,1.0,1640,0,7,1640,0,47.455,1340
680000.0,3,1.75,1620,0,7,1110,510,47.6393,2100
985000.0,3,1.75,1670,0,8,1670,0,47.635,2100
375000.0,4,2.5,1870,0,8,1870,0,47.4314,2020
431000.0,2,1.5,1300,0,6,1300,0,47.5937,1480
463000.0,3,2.5,2190,0,8,2190,0,47.7321,2400
350000.0,3,1.75,1320,0,7,1320,0,47.7267,1310
485000.0,3,1.0,1250,0,7,1250,0,47.6342,1430
355000.0,4,1.75,2040,0,7,1360,680,47.3107,2310
603500.0,3,1.75,2140,0,7,1070,1070,47.6993,2280
860000.0,5,1.75,2510,0,8,2010,500,47.5798,2240
259875.0,5,2.5,2200,0,7,2200,0,47.3675,1850
685000.0,4,2.5,2170,0,7,1220,950,47.6078,2010
382500.0,4,2.5,2980,0,8,2980,0,47.378,2980
490000.0,3,1.0,1180,0,7,1180,0,47.6779,1320
229000.0,3,2.0,1540,0,6,1540,0,47.7372,1490
430000.0,3,2.0,1540,0,6,1540,0,47.7372,1490
580000.0,5,2.5,3110,0,8,1720,1390,47.6301,2550
510000.0,3,1.75,1370,0,8,1370,0,47.6982,1180
489990.0,5,2.25,2440,0,8,2440,0,47.3762,2670
440000.0,3,2.25,1760,0,7,1330,430,47.6579,1150
479950.0,3,2.5,2810,0,9,1750,1060,47.4461,2810
806000.0,4,2.5,2500,0,10,2500,0,47.6778,3680
875000.0,4,2.5,3220,0,10,3220,0,47.7311,3220
710800.0,3,2.5,2880,0,10,2880,0,47.766,3190
565000.0,3,2.5,2700,0,8,2700,0,47.5376,2740
359999.0,5,3.0,2680,0,7,1870,810,47.3279,1860
625000.0,3,1.75,1780,0,7,920,860,47.6827,1360
349950.0,3,2.5,2240,0,8,2240,0,47.3485,2190
415000.0,4,2.0,1610,0,7,1610,0,47.5327,1450
435000.0,2,2.0,1440,0,9,960,480,47.5592,1440
225000.0,3,1.75,1550,0,7,1550,0,47.5093,1080
770000.0,3,1.75,1720,0,9,1720,0,47.6157,2120
340000.0,3,1.75,1740,0,7,1740,0,47.7717,1810
965000.0,5,2.75,3280,0,9,2050,1230,47.5504,3060
667000.0,3,2.75,2216,0,9,2216,0,47.3164,2216
250000.0,1,1.0,1100,0,6,820,280,47.4653,1100
397990.0,3,1.0,1180,0,7,1180,0,47.7153,1540
535000.0,3,1.75,2020,0,7,1370,650,47.7487,1500
265950.0,3,1.5,1150,0,6,1150,0,47.4927,1160
258000.0,3,1.75,2090,0,6,1200,890,47.3764,1420
505500.0,3,2.5,1300,0,8,1300,0,47.6704,1320
455000.0,5,2.5,2240,0,7,1340,900,47.7198,1820
1348000.0,5,3.25,3540,2,10,2000,1540,47.6643,2820
600000.0,4,2.25,2840,0,8,1780,1060,47.7505,2290
329800.0,4,2.5,2080,0,8,2080,0,47.2627,2580
222000.0,2,1.0,1550,0,6,1550,0,47.4315,1188
450000.0,4,2.5,1900,0,7,1900,0,47.6167,2040
952000.0,3,3.5,2760,0,9,2120,640,47.6529,1950
625000.0,4,2.0,1410,0,8,1410,0,47.6385,1240
226800.0,2,1.0,1240,0,7,1240,0,47.3714,1660
1205000.0,5,4.25,4420,0,11,3510,910,47.5262,4220
350000.0,4,2.75,3390,0,7,1970,1420,47.3954,2530
395000.0,3,1.75,1400,0,7,1400,0,47.7659,1630
285000.0,5,3.0,2110,0,7,1670,440,47.5449,2110
553000.0,3,1.0,1310,0,7,1310,0,47.6065,2150
254000.0,3,1.0,1270,0,7,1270,0,47.4599,1700
348140.0,2,1.5,2060,0,6,1190,870,47.515,1430
354950.0,4,2.75,2530,0,8,1280,1250,47.313,2280
706000.0,3,2.75,1900,0,7,1410,490,47.6697,1350
499000.0,4,2.5,2910,0,7,2910,0,47.5402,2320
427500.0,3,1.5,1900,0,7,1300,600,47.4199,2080
439000.0,5,3.5,2880,3,8,1980,900,47.4874,2120
545000.0,4,2.5,2820,0,9,2820,0,47.3415,3330
842000.0,3,1.0,1620,0,7,1620,0,47.659,1880
685000.0,4,2.5,3320,0,9,3320,0,47.6504,3170
665000.0,4,3.5,3770,0,9,3770,0,47.3552,3380
255000.0,2,1.0,1200,2,6,1200,0,47.4039,1660
565000.0,5,2.25,2130,2,8,1240,890,47.6586,1830
274000.0,5,1.75,1950,0,7,1050,900,47.3381,1660
260000.0,3,2.0,1920,0,7,1510,410,47.3092,1920
581000.0,4,2.0,2510,0,7,1280,1230,47.7005,1220
625000.0,3,1.5,1990,4,7,1990,0,47.3449,2100
220000.0,3,1.0,1230,0,7,1230,0,47.3266,1230
765000.0,3,2.25,3190,2,9,3190,0,47.5477,3190
1325000.0,6,4.25,5720,0,10,4170,1550,47.5464,4300
700000.0,8,2.5,2280,0,7,1210,1070,47.6675,1610
351000.0,4,1.0,1550,0,6,1550,0,47.6229,1210
413565.0,3,2.5,1690,0,8,1150,540,47.5524,1690
363000.0,3,3.25,1651,0,8,1341,310,47.7076,1650
679000.0,4,1.75,2260,0,8,1690,570,47.5528,3080
473000.0,2,1.75,1510,0,8,1510,0,47.7136,1640
585888.0,3,2.0,1490,0,7,1490,0,47.6697,1700
405000.0,4,2.5,2220,0,7,2220,0,47.4902,1840
650000.0,3,1.75,2800,4,8,1400,1400,47.3554,3270
415000.0,4,2.5,2210,0,7,1210,1000,47.4039,2270
575000.0,3,2.0,2150,0,8,1080,1070,47.6814,2130
220000.0,3,2.25,1400,0,7,1140,260,47.349,1970
610000.0,4,3.0,2450,0,8,1580,870,47.5694,2530
499950.0,3,1.0,980,0,7,760,220,47.692,1390
883000.0,4,2.5,2800,0,9,2170,630,47.6215,1430
436000.0,2,1.0,1240,2,7,1240,0,47.7326,2790
320000.0,3,2.5,1610,0,8,1240,370,47.5257,1270
425000.0,3,1.75,1510,0,7,1240,270,47.4851,2290
204700.0,4,2.0,1670,0,7,1670,0,47.3406,1640
384000.0,6,3.0,2320,0,7,1200,1120,47.5552,1160
314000.0,3,2.75,1900,0,7,1900,0,47.402,1620
535000.0,3,2.5,2390,0,9,2390,0,47.7379,2390
568000.0,4,1.75,2110,0,8,2110,0,47.657,2110
426000.0,4,1.5,1470,0,7,810,660,47.7,1290
675000.0,4,2.75,2670,3,8,1630,1040,47.5131,2400
380000.0,4,2.5,2540,0,8,1870,670,47.4608,2290
685000.0,3,2.5,3450,0,8,2970,480,47.5605,1880
429000.0,3,2.0,1700,0,7,1700,0,47.4164,2480
799000.0,4,1.5,1810,0,7,1500,310,47.7273,860
318500.0,5,1.75,1550,0,7,1030,520,47.5503,1550
925000.0,3,3.25,4110,0,9,2630,1480,47.5506,2640
420000.0,3,1.5,2080,0,7,1300,780,47.5322,1860
570000.0,2,1.0,1100,0,7,1100,0,47.6388,1590
1052500.0,4,2.75,3950,0,8,3950,0,47.5489,2350
333000.0,3,1.0,1250,0,7,1250,0,47.503,1350
1360000.0,2,1.75,2620,4,8,2120,500,47.7142,1830
660000.0,3,2.5,2290,0,9,2290,0,47.641,2260
350000.0,6,4.5,3500,0,7,3500,0,47.7351,1550
682500.0,6,4.5,3500,0,7,3500,0,47.7351,1550
399990.0,5,2.75,1690,0,7,970,720,47.5312,1240
860000.0,5,3.25,4500,4,8,3000,1500,47.7262,2780
216180.0,2,1.0,1120,0,6,1120,0,47.4871,2180
300000.0,4,2.25,1740,0,8,1740,0,47.463,1680
145000.0,3,1.0,1010,0,7,1010,0,47.3762,1150
255000.0,3,1.0,1010,0,7,1010,0,47.3762,1150
250000.0,3,1.75,1200,0,6,1200,0,47.4236,2150
245000.0,3,1.0,1020,0,7,1020,0,47.4465,1290
445000.0,3,1.75,1850,0,8,1850,0,47.6602,1970
562000.0,3,1.5,1830,0,7,1830,0,47.6017,1310
501000.0,4,1.0,2070,0,7,1160,910,47.632,1730
190000.0,3,1.75,1160,0,6,1160,0,47.5064,1110
862500.0,4,2.75,3280,0,10,3280,0,47.7073,3490
1085000.0,5,2.5,2340,0,10,2340,0,47.5764,2350
575000.0,5,3.0,3690,2,9,2690,1000,47.3908,2590
250000.0,1,1.0,720,0,6,720,0,47.2893,1860
310000.0,7,1.5,2660,0,7,2660,0,47.4644,1710
1400000.0,5,3.25,4300,3,10,2910,1390,47.5717,2780
284850.0,3,1.5,1590,1,7,1090,500,47.3488,1950
570000.0,4,2.5,2590,0,9,2590,0,47.7378,2110
304000.0,3,1.75,1720,2,7,1000,720,47.4999,1690
560000.0,4,2.5,1790,2,8,1240,550,47.5344,1790
325000.0,3,1.0,1590,1,7,1090,500,47.4013,1540
557510.0,4,2.0,1580,2,7,1580,0,47.5454,1580
305000.0,4,2.25,2580,0,9,1620,960,47.3122,2140
320000.0,5,1.0,1740,0,5,1740,0,47.4809,2760
455000.0,5,2.25,3470,0,8,2790,680,47.3342,2020
383001.0,3,1.0,1180,0,7,1180,0,47.7267,1700
545000.0,3,1.75,1700,0,6,1700,0,47.4704,1100
487500.0,2,1.0,1190,0,7,1190,0,47.5717,1600
345000.0,5,2.5,2450,0,8,2450,0,47.3572,1940
583000.0,6,2.75,2630,0,8,1650,980,47.6309,2250
534950.0,3,2.25,2130,0,8,2130,0,47.6471,2130
403504.0,4,1.0,1060,0,6,950,110,47.6562,1790
500000.0,3,1.75,1480,0,7,1480,0,47.6858,1480
319502.0,3,1.75,1610,0,7,1610,0,47.3778,1930
525000.0,4,2.75,2440,0,8,1750,690,47.5547,1920
563000.0,4,3.0,3100,0,8,2400,700,47.7466,2000
898500.0,4,2.75,2890,0,8,1990,900,47.6768,1080
651000.0,3,2.5,3240,0,10,3240,0,47.327,2090
450000.0,4,2.75,2900,0,7,2040,860,47.5563,1340
665000.0,4,2.25,2650,0,8,1610,1040,47.5624,2290
825000.0,4,2.5,2560,0,8,1610,950,47.6885,1760
200000.0,3,1.0,1150,0,6,1150,0,47.3101,1310
295000.0,3,2.0,1760,0,7,1760,0,47.3838,2590
748000.0,4,2.5,3220,0,10,3220,0,47.7043,2720
580000.0,3,2.5,3200,0,9,2660,540,47.5717,3200
275000.0,3,1.0,1250,0,6,1250,0,47.4226,1500
196000.0,3,1.0,1000,0,6,1000,0,47.3056,1020
235750.0,2,1.0,740,0,6,740,0,47.5036,1390
315000.0,3,2.25,2170,0,8,2170,0,47.4562,2080
338000.0,4,2.5,2370,0,8,2370,0,47.3473,2200
353000.0,4,2.5,2300,0,8,2300,0,47.3516,2390
235000.0,3,1.75,1400,0,7,1400,0,47.2074,1400
569999.0,3,2.5,3080,0,9,3080,0,47.3726,2780
505000.0,4,2.25,2350,0,8,2350,0,47.7732,2090
1234000.0,4,3.0,2660,0,8,1820,840,47.6258,2350
299000.0,2,1.75,1250,0,7,1250,0,47.2802,1910
240000.0,3,2.0,1100,0,7,1100,0,47.3878,1620
1955000.0,3,1.75,3330,4,8,1940,1390,47.5287,3730
1265000.0,4,3.25,3640,2,9,1960,1680,47.6145,1940
405000.0,2,1.75,1350,0,7,1350,0,47.6934,1370
304000.0,4,2.0,1310,0,7,1310,0,47.7572,1320
272000.0,4,2.25,1800,0,7,1800,0,47.3498,1810
412000.0,2,1.0,1260,0,6,690,570,47.6899,1250
698000.0,4,2.5,2990,0,9,2990,0,47.5623,3160
400000.0,2,1.0,1140,0,7,1140,0,47.5323,1230
305000.0,3,2.5,2100,0,8,2100,0,47.4314,2180
585000.0,4,2.0,2400,0,7,2400,0,47.6947,1830
190000.0,2,1.5,1400,0,7,960,440,47.2915,1450
760000.0,4,2.5,2990,0,10,2990,0,47.5601,3250
570000.0,3,1.75,1930,0,8,1930,0,47.7692,1930
144000.0,3,1.0,980,0,6,980,0,47.4411,1140
139000.0,2,1.0,690,0,5,690,0,47.4953,1140
525000.0,4,1.5,1430,0,7,1130,300,47.6942,1570
293000.0,1,1.0,1110,0,6,1110,0,47.7322,1230
267100.0,2,2.5,1250,0,7,1030,220,47.5243,1250
1500000.0,4,3.25,3470,0,10,2830,640,47.6845,3090
240000.0,3,2.25,1500,0,7,1500,0,47.3719,1530
975000.0,3,2.5,2530,4,9,2530,0,47.5465,2380
279950.0,5,1.75,2150,0,7,1460,690,47.3952,1710
405000.0,3,1.75,1260,0,7,1260,0,47.7296,1360
400000.0,3,2.5,2740,4,9,2740,0,47.3581,2500
225000.0,3,1.0,960,0,5,960,0,47.497,1150
250000.0,3,1.0,1520,0,7,1120,400,47.3784,1740
272950.0,3,2.25,1570,0,7,1180,390,47.1937,1570
625000.0,5,1.0,3240,0,9,3240,0,47.523,3240
670000.0,3,1.75,1280,0,7,1280,0,47.6362,2010
1065000.0,3,2.5,2130,0,9,2130,0,47.6389,1970
540000.0,3,1.75,1970,0,8,1420,550,47.7602,2140
525000.0,3,2.5,2990,0,9,2990,0,47.4928,2790
425000.0,2,1.0,1160,0,7,1160,0,47.7244,1440
465500.0,3,1.75,1890,0,7,1290,600,47.5557,1440
443500.0,3,2.5,2170,0,7,2170,0,47.5403,2440
350000.0,4,2.25,1570,3,7,1570,0,47.1808,1700
850000.0,3,2.5,3260,0,9,3260,0,47.737,2520
205000.0,3,2.25,1250,0,8,1250,0,47.7098,1250
315000.0,4,2.5,1940,0,8,1140,800,47.4157,1920
470000.0,3,2.5,2150,0,8,2150,0,47.5085,2490
1100000.0,4,2.25,3310,4,9,1660,1650,47.5603,3450
340000.0,3,1.75,3400,0,7,2050,1350,47.6458,2320
310000.0,4,2.5,2660,0,8,1740,920,47.3334,2280
305000.0,3,1.0,950,0,7,950,0,47.7543,1240
307150.0,3,1.5,1480,0,7,1480,0,47.4993,1450
729032.0,4,2.5,2840,0,9,1780,1060,47.6388,2840
750000.0,5,2.5,3240,1,8,2020,1220,47.5858,2730
289000.0,4,2.5,1961,0,7,1961,0,47.3507,1961
480000.0,3,1.0,1100,0,7,1100,0,47.6883,1560
529000.0,3,1.75,1500,0,8,1500,0,47.6722,1920
585000.0,3,1.75,1480,0,7,1140,340,47.6567,1810
704000.0,4,2.75,2510,0,8,2050,460,47.6278,2200
607000.0,4,2.0,1490,0,7,1490,0,47.6744,1510
580000.0,3,2.25,2190,0,8,1810,380,47.6883,2190
875000.0,5,2.5,2530,0,8,2530,0,47.5622,2480
610000.0,4,2.5,2440,0,8,1560,880,47.5614,2260
230000.0,3,0.75,1040,0,6,1040,0,47.7639,1410
510000.0,4,2.25,2450,0,8,2450,0,47.7603,2450
733000.0,4,2.5,2210,0,7,1370,840,47.6637,1970
169100.0,3,2.0,1050,0,7,1050,0,47.3206,1690
250000.0,3,2.0,1050,0,7,1050,0,47.3206,1690
500000.0,4,2.25,2730,0,8,2730,0,47.5913,2730
700000.0,2,1.0,1620,4,8,1320,300,47.5264,1820
379000.0,4,2.75,2410,0,8,2410,0,47.4244,2300
650000.0,4,2.5,3420,0,9,3420,0,47.3608,3340
412133.0,2,1.0,920,0,7,920,0,47.6903,1560
480000.0,4,2.25,2330,0,8,1740,590,47.718,2330
650000.0,3,1.75,1940,0,7,1940,0,47.5833,2720
505000.0,2,2.5,1900,0,8,1900,0,47.7175,1350
931088.0,4,2.5,3510,0,9,1930,1580,47.5963,2730
570000.0,4,1.75,1860,0,8,1860,0,47.626,1860
475000.0,3,1.0,1380,0,6,1380,0,47.57,1790
240000.0,6,1.75,2210,0,7,1310,900,47.4594,1850
462000.0,4,2.5,2640,0,8,1590,1050,47.4258,2390
1115000.0,3,2.5,4530,2,8,3220,1310,47.4567,3100
243000.0,3,1.0,1500,0,6,1500,0,47.4845,1730
660000.0,4,2.25,2010,0,8,2010,0,47.5956,1930
1190000.0,2,1.75,2080,4,8,1040,1040,47.7134,2030
1680000.0,4,4.25,5584,0,11,5584,0,47.6113,5030
6885000.0,6,7.75,9890,4,13,8860,1030,47.6305,4540
368000.0,3,2.5,2080,0,7,2080,0,47.53,2080
811500.0,5,4.25,3970,0,9,2860,1110,47.5402,3480
275000.0,2,1.0,770,0,6,770,0,47.7406,770
650000.0,4,2.5,2500,0,9,2500,0,47.6922,2680
485000.0,3,2.0,2410,0,7,2410,0,47.4154,1900
425000.0,3,2.5,1340,0,7,1340,0,47.6366,2520
530000.0,3,2.5,2640,0,8,1550,1090,47.5875,2120
657000.0,4,1.75,2740,2,8,1370,1370,47.5445,2740
315000.0,4,2.75,1580,0,7,1080,500,47.7368,1740
273000.0,4,1.5,2180,0,6,1280,900,47.3187,2420
550000.0,3,2.75,1960,0,8,1240,720,47.5582,2040
347000.0,2,2.25,1560,0,8,1270,290,47.5482,1560
525000.0,5,2.75,2440,0,7,1240,1200,47.7283,1780
490000.0,3,1.5,990,0,8,840,150,47.6236,1350
500000.0,3,2.25,2210,0,8,2210,0,47.7175,1450
585000.0,3,2.75,3080,0,9,3080,0,47.4826,3080
926500.0,4,2.75,2900,2,9,1750,1150,47.7004,2900
465000.0,1,1.0,1020,0,7,1020,0,47.6361,1670
200000.0,4,2.0,1900,0,7,1900,0,47.2114,1280
1680000.0,6,4.75,5770,3,12,4500,1270,47.5512,4470
220500.0,2,1.0,990,0,6,990,0,47.4145,2090
329000.0,2,1.0,990,0,6,990,0,47.4145,2090
715000.0,3,4.0,2080,4,8,2080,0,47.6598,2080
780000.0,3,4.0,2080,4,8,2080,0,47.6598,2080
410000.0,2,1.0,1480,0,7,1050,430,47.6842,1310
778100.0,2,1.0,1480,0,7,1050,430,47.6842,1310
406000.0,3,1.0,1090,0,7,1090,0,47.7429,1570
665000.0,4,2.5,2800,0,8,1660,1140,47.6809,2580
305000.0,2,1.0,1000,0,7,1000,0,47.7444,1620
265000.0,3,2.5,1640,0,7,1640,0,47.3505,1850
485000.0,4,1.0,1620,0,7,1620,0,47.6696,1760
600000.0,3,2.5,2460,0,9,1860,600,47.4824,2870
510000.0,2,1.5,1860,0,7,1060,800,47.5573,1710
195000.0,2,1.0,1080,0,8,1080,0,47.3792,1090
432500.0,3,1.75,1980,0,7,1270,710,47.6911,1400
490000.0,3,1.75,1510,0,7,1220,290,47.6226,1950
270000.0,3,2.5,1690,0,7,1690,0,47.3498,1410
370000.0,2,1.5,1010,0,7,1010,0,47.6374,1480
327500.0,3,2.5,2090,0,8,2090,0,47.4084,2090
826000.0,2,1.0,1060,0,7,1060,0,47.6739,1730
510000.0,3,1.75,1750,0,7,1750,0,47.3264,1170
587750.0,2,1.0,890,0,7,890,0,47.6876,1330
449228.0,5,2.5,3020,0,8,1650,1370,47.5897,2930
565000.0,3,2.5,2030,0,9,2030,0,47.3942,1870
660000.0,4,2.5,3170,0,9,3170,0,47.4475,3250
400000.0,5,2.75,2470,0,8,1250,1220,47.4496,2140
612500.0,4,2.0,2060,0,7,1030,1030,47.6992,1280
560000.0,4,1.75,2120,0,7,1060,1060,47.5506,1410
727000.0,3,2.25,2180,0,8,1520,660,47.6412,1850
224000.0,4,3.0,2300,0,7,2300,0,47.2943,940
1080000.0,4,2.5,4200,0,11,4200,0,47.7108,3540
439000.0,3,2.25,1480,0,7,1220,260,47.7288,1660
335000.0,3,1.5,2240,0,7,1480,760,47.3043,1920
779000.0,4,1.5,2740,0,8,1370,1370,47.6523,2160
452000.0,5,1.75,1830,0,6,1830,0,47.4881,2010
775000.0,4,3.0,2000,0,7,2000,0,47.6762,1670
235000.0,3,1.75,1380,0,7,1380,0,47.3121,1380
370000.0,3,1.75,1620,0,7,1620,0,47.2875,2190
790000.0,4,3.0,3180,0,9,3180,0,47.6371,3110
903000.0,2,1.5,1140,0,6,1140,0,47.6142,2020
209950.0,3,1.0,970,0,6,970,0,47.3044,970
309000.0,3,2.5,1780,0,7,1780,0,47.3772,1670
440000.0,3,1.75,2240,0,7,1120,1120,47.7303,1710
571500.0,4,2.25,2810,0,8,1860,950,47.2993,2020
514000.0,2,1.0,920,0,7,920,0,47.6711,1300
323000.0,3,1.75,1830,1,7,1200,630,47.5087,1830
290000.0,2,1.75,1560,0,8,1560,0,47.3776,2050
2575000.0,4,4.25,5540,1,11,4280,1260,47.6071,3570
1362500.0,3,2.0,2310,0,10,2310,0,47.6381,2950
551000.0,4,1.5,1470,0,7,1470,0,47.6769,1470
960000.0,4,2.5,3430,2,10,3430,0,47.6426,3700
720000.0,5,2.5,2900,0,9,2900,0,47.5442,2910
218000.0,3,1.75,1850,0,8,1320,530,47.2975,1940
334950.0,4,2.5,2190,0,8,2190,0,47.3718,2040
605000.0,4,2.25,2510,0,9,2510,0,47.6153,2510
825000.0,4,3.25,3200,0,9,2390,810,47.664,1830
268500.0,4,1.75,1670,0,8,1670,0,47.3193,1720
230000.0,3,1.75,1010,0,7,1010,0,47.3828,1320
1335000.0,4,4.0,5050,0,10,3260,1790,47.5269,3370
245500.0,2,1.5,1430,0,7,1430,0,47.441,1430
440000.0,3,2.25,1880,0,7,1280,600,47.7077,1820
571500.0,4,2.75,2180,0,8,2180,0,47.5702,2060
182500.0,3,2.25,1830,0,7,1830,0,47.2734,1670
217000.0,2,1.0,970,0,6,970,0,47.5297,1020
335000.0,2,1.5,1170,0,6,1170,0,47.5318,1170
501000.0,2,1.0,1010,0,7,1010,0,47.6846,1680
339950.0,3,2.5,2140,0,8,1290,850,47.5053,2090
340000.0,3,1.75,2230,0,8,1630,600,47.4092,1730
582500.0,2,1.0,1140,0,6,1140,0,47.6948,2940
298800.0,2,1.0,860,0,6,860,0,47.735,1180
317500.0,6,1.75,2540,0,8,1340,1200,47.4414,1900
598000.0,4,2.5,2420,2,7,1550,870,47.5671,1740
375000.0,2,2.25,1640,0,8,1640,0,47.7154,1640
465000.0,4,2.25,2550,2,9,2550,0,47.5296,2550
551870.0,3,2.5,2507,0,8,2507,0,47.2867,1520
295000.0,3,2.5,1920,0,8,1920,0,47.2659,2310
263500.0,4,1.75,2210,0,8,1640,570,47.3268,2070
1095000.0,4,4.0,3530,0,8,2630,900,47.6402,2340
300000.0,2,1.0,1100,0,6,1100,0,47.5296,980
780000.0,4,1.0,3390,0,8,2190,1200,47.5824,2030
325000.0,3,1.5,1590,0,7,1590,0,47.5201,1590
370000.0,2,1.0,820,0,7,820,0,47.5478,1640
715000.0,4,2.5,2370,0,8,1660,710,47.6383,2480
356000.0,4,2.0,1600,0,7,1600,0,47.4713,1260
329950.0,4,1.75,1740,0,8,1740,0,47.4483,1680
490000.0,3,2.25,1470,0,8,1080,390,47.6762,1640
429000.0,3,3.25,1410,0,8,1410,0,47.6981,1410
510000.0,4,2.5,1620,0,7,1620,0,47.6255,1480
550000.0,3,2.5,2360,0,7,2360,0,47.6825,2290
467500.0,3,1.0,1830,0,7,1830,0,47.7139,1670
615000.0,5,2.0,2130,0,7,1270,860,47.575,1710
325000.0,2,1.0,990,0,6,990,0,47.7669,1300
219950.0,2,1.0,1010,0,6,1010,0,47.488,1200
950000.0,3,1.0,1720,0,7,1720,0,47.5905,3200
925000.0,3,1.0,1630,0,8,1630,0,47.6351,1710
251200.0,4,1.5,1310,0,7,1060,250,47.425,1260
215000.0,3,1.5,1610,0,6,1610,0,47.3632,1060
245000.0,3,2.0,1850,0,7,1180,670,47.3109,1790
259000.0,3,1.75,1270,0,6,980,290,47.5495,1270
349950.0,4,1.5,1420,0,7,1420,0,47.5518,1560
1565000.0,5,4.5,5220,0,11,5220,0,47.7666,4190
600000.0,2,1.0,1410,0,7,1020,390,47.6883,1300
405000.0,2,1.5,1170,0,8,1170,0,47.6719,1290
625000.0,3,2.5,1860,0,8,1860,0,47.6775,1530
430000.0,4,1.0,1620,0,7,1620,0,47.5654,2190
533000.0,3,3.0,1280,0,8,1280,0,47.6569,1300
1050000.0,4,2.5,2750,0,10,2750,0,47.6595,2750
230000.0,3,1.75,1420,0,5,710,710,47.4928,1960
275000.0,4,1.75,2000,0,7,1010,990,47.374,1490
403000.0,2,1.0,1100,0,7,1100,0,47.5738,1240
550388.0,3,3.0,1720,2,7,1720,0,47.4936,2740
415500.0,3,1.5,1240,0,7,1240,0,47.607,1640
913000.0,3,1.75,2170,0,7,1110,1060,47.6546,1890
334998.0,2,1.0,1800,0,6,900,900,47.5508,1570
201500.0,3,1.0,1160,0,7,1160,0,47.3831,1480
820000.0,3,2.5,3030,0,10,3030,0,47.664,3370
371000.0,3,1.0,890,0,7,890,0,47.71,1630
229950.0,4,2.5,2150,0,7,1240,910,47.3942,1610
344900.0,4,2.5,2150,0,7,1240,910,47.3942,1610
840000.0,3,2.5,2060,0,8,2060,0,47.6961,1240
285000.0,3,1.5,1380,0,7,1380,0,47.3204,1600
475000.0,4,2.25,1800,0,7,1230,570,47.7717,2260
420000.0,2,1.0,1460,0,6,1460,0,47.4617,1460
685000.0,3,2.0,2210,2,7,1710,500,47.6754,1920
879000.0,4,3.0,3590,0,10,3590,0,47.7557,2790
197200.0,3,1.0,1140,0,6,990,150,47.4824,1300
529950.0,3,1.0,1240,0,7,1240,0,47.6755,1240
1090000.0,4,2.5,4340,0,11,4340,0,47.6805,2720
792000.0,3,1.5,1570,0,8,1570,0,47.6358,2070
262000.0,3,2.5,1680,0,7,1680,0,47.314,1680
353900.0,3,1.75,1560,0,6,780,780,47.5272,1320
380000.0,1,1.5,1200,0,7,1200,0,47.7205,1480
305000.0,3,2.5,1690,0,7,1690,0,47.3564,1830
440000.0,4,2.0,2310,0,7,1430,880,47.5471,1630
1008000.0,4,3.5,2650,0,9,2060,590,47.6735,1470
549900.0,5,3.0,3610,0,8,3610,0,47.3534,3610
678500.0,4,3.0,2620,0,8,2620,0,47.4239,2060
270000.0,3,2.25,1760,0,7,1160,600,47.4501,1290
430000.0,3,1.0,940,0,7,940,0,47.7169,1920
1925000.0,5,4.25,4830,2,11,3710,1120,47.5789,4470
790500.0,4,2.75,3350,0,9,3350,0,47.6849,3625
447450.0,3,2.25,1570,0,8,1570,0,47.7332,1620
375000.0,3,2.0,2240,0,7,1630,610,47.6191,1470
565000.0,4,2.0,1950,0,7,1950,0,47.6332,1920
400000.0,2,1.0,1010,2,6,810,200,47.5728,1580
246000.0,3,1.5,1630,0,8,1300,330,47.3155,1960
329922.0,3,1.75,1420,0,7,1100,320,47.7398,1460
1249000.0,5,3.25,3950,0,10,2100,1850,47.6451,3860
375000.0,3,1.0,1210,0,6,1210,0,47.7125,1260
385000.0,3,1.75,1890,0,7,1230,660,47.7327,1380
591500.0,4,2.5,1690,0,7,1140,550,47.6825,1600
255000.0,4,2.0,2560,0,7,1350,1210,47.3326,1790
275000.0,3,1.5,1350,0,7,1350,0,47.4805,1510
800000.0,4,2.75,3120,0,9,3120,0,47.594,3200
327000.0,2,1.0,1140,0,7,1140,0,47.73,1320
355000.0,4,1.5,2230,1,7,1220,1010,47.4409,2170
310000.0,2,1.0,1050,0,6,780,270,47.7598,1340
869000.0,5,3.25,4180,0,8,2880,1300,47.5488,3170
272000.0,3,2.0,1200,0,7,1200,0,47.5031,1190
665000.0,5,2.25,3320,0,9,3320,0,47.4862,1580
225000.0,3,2.5,1590,0,7,1590,0,47.3493,1750
375000.0,3,2.5,2750,0,9,2750,0,47.3732,2700
375500.0,3,1.5,1530,0,8,1530,0,47.7691,2150
550000.0,3,1.75,1570,0,7,920,650,47.565,1570
248000.0,3,1.0,1470,0,7,1220,250,47.5276,1470
546940.0,3,1.0,1470,0,7,1220,250,47.5276,1470
680000.0,4,3.0,3150,0,9,3150,0,47.5968,3150
350000.0,4,2.5,2380,0,8,2380,0,47.3662,2170
593000.0,2,2.5,2000,1,8,1810,190,47.5788,1970
390000.0,2,1.0,1140,0,7,1140,0,47.7278,1260
297000.0,3,1.0,1340,0,7,1340,0,47.4443,1660
355000.0,2,1.0,1450,0,7,1450,0,47.4689,1440
309900.0,3,2.5,2020,0,7,2020,0,47.2597,1680
257000.0,3,2.25,1810,0,7,1810,0,47.3476,1720
1698000.0,4,3.0,3600,0,9,3600,0,47.6257,2620
300000.0,3,2.0,1260,0,7,1260,0,47.6821,1590
500000.0,3,2.0,1560,0,8,1560,0,47.605,1560
900000.0,8,4.0,4020,0,8,2010,2010,47.6732,1560
695000.0,4,3.0,3150,0,9,3150,0,47.5974,2970
213400.0,4,2.5,1680,0,7,1680,0,47.3867,1680
425000.0,2,1.0,1320,0,7,1020,300,47.6433,1620
420000.0,3,3.0,2700,0,9,1570,1130,47.4446,2260
411000.0,1,1.0,1080,0,7,1080,0,47.6603,1620
762500.0,4,2.25,3130,0,9,3130,0,47.6683,3130
569950.0,5,4.5,4850,0,10,4850,0,47.3181,1640
258000.0,4,1.0,1220,0,6,1220,0,47.4792,1460
499000.0,3,2.25,1780,0,8,1780,0,47.5495,1770
310000.0,3,1.0,1250,0,7,1250,0,47.4894,1520
398500.0,2,2.5,1780,0,8,1350,430,47.6962,1390
250600.0,4,2.5,1930,0,7,1120,810,47.3261,1830
352000.0,4,2.5,2470,0,7,1420,1050,47.3792,1670
600000.0,2,1.0,1180,1,7,940,240,47.6313,2700
645000.0,3,1.0,2270,0,7,1170,1100,47.688,1860
291500.0,4,2.5,1770,0,7,1770,0,47.3503,2080
350000.0,4,1.75,2250,0,8,2150,100,47.3789,2150
279000.0,3,2.5,1540,0,7,1080,460,47.3102,1220
320000.0,2,1.0,820,0,6,820,0,47.6976,1370
495000.0,2,2.0,1580,0,8,1580,0,47.7174,1560
490000.0,4,2.5,2430,0,7,1450,980,47.6164,2000
770000.0,5,1.5,2160,2,8,2160,0,47.6645,1450
215000.0,3,1.75,1770,0,8,1770,0,47.3204,2300
665000.0,3,3.5,3580,0,9,3580,0,47.4239,2880
423500.0,3,2.25,1890,0,7,1190,700,47.73,1660
850000.0,3,3.0,1910,0,9,1910,0,47.6572,1280
155000.0,2,1.0,910,0,6,910,0,47.5328,1070
505000.0,3,2.25,1460,0,7,1460,0,47.6316,1850
780000.0,3,3.5,3310,0,9,3310,0,47.5553,3310
165000.0,3,1.5,1630,0,7,1630,0,47.3611,1620
707000.0,2,2.5,2130,0,8,1330,800,47.6573,1750
497000.0,3,2.5,1220,0,8,1220,0,47.6909,1220
349170.0,4,1.75,1670,2,7,1070,600,47.5056,1660
287000.0,4,1.5,1300,0,7,1300,0,47.4899,1730
2375000.0,4,2.5,3220,0,10,3220,0,47.5692,4200
645000.0,4,2.5,2430,0,8,1670,760,47.6202,2140
238000.0,5,2.25,2240,0,7,2240,0,47.4249,2180
328000.0,5,2.25,2240,0,7,2240,0,47.4249,2180
365000.0,2,1.5,790,0,8,700,90,47.651,1370
380000.0,3,1.0,1380,0,7,1380,0,47.7407,1360
525000.0,4,1.5,1680,0,7,1680,0,47.6806,1830
402000.0,4,2.25,2000,0,7,1650,350,47.6769,2000
308000.0,2,1.0,1680,0,7,860,820,47.7618,1590
405000.0,3,2.5,1960,0,7,1960,0,47.5415,2320
808000.0,3,1.75,2590,0,8,2590,0,47.7539,2340
875000.0,4,3.5,3790,0,9,3790,0,47.6956,3370
860000.0,3,2.5,2370,0,8,2370,0,47.6148,2590
367500.0,4,2.25,1930,0,8,1300,630,47.7626,1930
604000.0,6,3.5,2580,0,8,1290,1290,47.6796,2020
230000.0,2,0.75,890,0,6,890,0,47.4922,1270
435000.0,4,2.75,2160,0,7,1410,750,47.7261,2060
347500.0,4,2.5,1970,0,7,1970,0,47.3576,1970
525000.0,4,1.75,1570,2,7,1030,540,47.671,1560
280000.0,2,1.5,1480,0,7,1480,0,47.5008,1520
490000.0,2,1.5,1480,0,7,1480,0,47.5008,1520
265000.0,4,1.75,1430,0,6,1430,0,47.494,1030
645000.0,4,2.25,2720,0,8,2000,720,47.5851,2720
390000.0,3,2.25,2420,0,8,1750,670,47.4422,2040
267500.0,3,2.5,1400,0,7,1120,280,47.3788,1530
1275000.0,4,3.5,5844,1,11,5844,0,47.3293,3413
404000.0,4,1.75,1840,0,7,960,880,47.6074,1840
380000.0,3,2.25,2530,0,8,2530,0,47.3742,2480
812500.0,4,2.75,2810,0,9,1810,1000,47.5626,2710
265000.0,3,1.0,1020,0,7,1020,0,47.4974,1070
480000.0,5,2.75,2550,0,8,1390,1160,47.5388,2450
264000.0,1,1.0,710,0,6,710,0,47.7328,900
1350000.0,5,3.0,5530,2,10,5530,0,47.7352,3800
550000.0,4,1.75,2150,0,7,1110,1040,47.6812,2040
615000.0,2,1.5,880,0,7,880,0,47.6144,1220
464000.0,3,1.75,1630,0,8,1630,0,47.7742,2260
365000.0,3,1.0,1380,0,8,1380,0,47.334,2350
490000.0,4,2.25,2800,0,8,1680,1120,47.7448,2260
280927.0,4,2.25,2070,0,8,2070,0,47.3615,2080
282613.0,2,1.0,830,0,6,830,0,47.7466,1340
675000.0,3,2.25,2770,0,10,2770,0,47.7464,3290
575550.0,4,2.5,2060,0,8,1440,620,47.7272,2280
259900.0,3,2.0,1490,0,7,1490,0,47.3686,1540
450000.0,4,2.25,2120,0,8,2120,0,47.4885,2150
487500.0,4,2.5,2810,0,9,2810,0,47.5019,2850
275000.0,4,2.25,2400,0,7,2400,0,47.2866,1610
305000.0,3,2.5,2460,0,8,2460,0,47.372,2740
395000.0,3,1.75,2030,2,8,2030,0,47.2618,2570
215000.0,3,1.0,880,2,6,880,0,47.1963,1020
410000.0,3,2.0,1320,0,7,1320,0,47.5752,1620
440000.0,4,2.5,2160,0,7,1390,770,47.7754,2190
1160000.0,4,3.5,4190,2,11,4190,0,47.5518,3300
500000.0,4,2.0,2280,0,7,2280,0,47.7132,1100
961000.0,5,2.75,2590,0,8,2590,0,47.6667,1390
825000.0,4,2.25,2770,0,9,2770,0,47.5628,3010
734000.0,3,1.75,2145,0,8,2145,0,47.6875,1140
490000.0,4,4.25,4480,0,7,3680,800,47.373,2190
175000.0,4,2.5,1780,0,7,1780,0,47.3828,1630
190000.0,1,1.0,720,0,6,720,0,47.5303,1240
305000.0,4,2.25,2050,0,7,2050,0,47.3215,1620
1300000.0,3,1.0,2040,3,8,1680,360,47.7028,2300
417000.0,2,1.0,920,0,6,920,0,47.5452,1510
275000.0,2,1.0,680,0,5,680,0,47.6901,1070
661000.0,3,2.5,1940,0,8,1940,0,47.6786,2070
435000.0,4,2.75,2230,0,8,1320,910,47.7269,2100
788000.0,5,2.25,2910,1,8,1910,1000,47.5871,2400
1795000.0,5,3.25,5270,1,10,4010,1260,47.5536,3550
408000.0,5,3.25,2820,0,7,2320,500,47.5357,1560
570000.0,2,1.0,1790,0,8,1490,300,47.5926,1458
1540000.0,5,3.25,2920,1,9,2120,800,47.6712,2470
400000.0,2,1.0,840,0,7,840,0,47.5247,1630
247000.0,3,1.75,1820,0,8,1820,0,47.3074,2210
453000.0,3,1.75,1550,0,7,1100,450,47.7071,1560
235000.0,2,1.0,1270,0,6,650,620,47.5351,1270
675000.0,4,1.75,2460,3,7,1620,840,47.5601,1760
516200.0,3,2.0,2110,0,6,1080,1030,47.5521,1170
650000.0,1,1.0,920,0,6,920,0,47.448,1746
257100.0,3,1.5,1500,0,7,1000,500,47.2043,1490
457000.0,2,2.0,1440,0,8,1440,0,47.7217,1510
540000.0,3,1.75,1610,0,7,1060,550,47.6774,1610
268000.0,3,1.75,1970,0,8,1970,0,47.3619,1970
300000.0,3,1.0,1150,0,7,1150,0,47.6246,1350
380000.0,2,2.5,2110,0,8,1590,520,47.4137,1960
725000.0,3,2.5,3580,0,9,3580,0,47.4026,3090
249000.0,3,1.0,1000,0,7,1000,0,47.3167,2450
274000.0,5,1.0,1680,0,7,1400,280,47.7523,1680
1780000.0,4,3.25,3950,0,10,3950,0,47.5877,3000
396500.0,3,1.75,2390,0,8,1350,1040,47.7244,1710
460000.0,2,1.5,1820,0,7,1240,580,47.7513,1400
277000.0,3,1.0,1100,0,7,1100,0,47.5162,1570
449500.0,6,4.0,2280,0,7,1270,1010,47.5556,1760
785950.0,4,3.0,2530,0,7,1540,990,47.6287,1640
545000.0,3,2.5,1940,2,8,1440,500,47.7142,2830
244000.0,3,2.0,1360,0,7,1360,0,47.2574,1390
165000.0,3,2.5,1660,0,7,1660,0,47.3763,1740
435000.0,2,1.0,800,0,7,800,0,47.6751,1410
642000.0,3,2.5,2670,0,10,2670,0,47.6359,2740
340000.0,3,2.5,1720,0,7,1720,0,47.4319,1720
730000.0,4,2.5,3550,0,9,3550,0,47.7503,3350
563250.0,3,1.75,1370,0,7,800,570,47.6157,2270
675000.0,5,2.5,2820,0,8,2820,0,47.5794,2820
620000.0,3,1.5,1620,0,8,1280,340,47.6948,1880
275000.0,2,2.0,1290,0,7,950,340,47.5346,1290
270000.0,3,1.0,1830,0,7,1830,0,47.7439,2150
325000.0,4,2.5,2040,0,8,2040,0,47.3337,2420
476100.0,4,2.5,1850,0,7,1600,250,47.5529,1770
700000.0,2,1.0,1300,0,8,1300,0,47.6366,2420
220000.0,4,2.0,1620,0,7,1620,0,47.3629,1500
236000.0,3,1.75,1560,0,7,1560,0,47.2917,1730
790000.0,3,2.5,2600,0,9,1700,900,47.6833,2380
350000.0,3,1.0,2010,0,7,1210,800,47.5515,2460
130000.0,2,1.0,780,0,6,780,0,47.513,780
283200.0,4,2.5,1982,0,8,1982,0,47.3636,2340
273000.0,3,1.0,1500,0,6,890,610,47.5365,1210
599000.0,5,2.25,2460,0,8,1330,1130,47.6651,2460
460000.0,4,2.5,2680,3,8,1510,1170,47.337,2680
1157200.0,4,4.25,5860,0,10,4910,950,47.7245,3320
385000.0,4,1.75,1720,0,7,860,860,47.726,1790
264250.0,3,1.0,1420,0,6,1420,0,47.4949,1290
608000.0,3,2.5,1760,0,8,1640,120,47.6473,1760
450000.0,3,2.5,2790,0,9,2790,0,47.3487,2550
1755000.0,3,2.0,2360,0,9,2360,0,47.6317,2260
339950.0,5,2.0,1890,0,7,1890,0,47.5018,1170
760000.0,6,3.75,3810,0,8,3810,0,47.694,1830
350000.0,2,1.0,1160,0,7,860,300,47.7007,1664
541500.0,3,1.75,2320,2,8,2320,0,47.3121,2400
730000.0,6,2.75,3280,0,7,1910,1370,47.5914,2550
215000.0,3,1.0,980,0,6,980,0,47.5308,1840
420000.0,3,2.0,1640,0,7,1640,0,47.5812,1680
655000.0,4,2.25,2060,0,8,1440,620,47.5605,2180
240000.0,3,2.5,1500,0,7,1500,0,47.4015,1610
730000.0,4,2.0,2360,0,7,1260,1100,47.6534,1720
390000.0,4,1.5,1940,0,7,1940,0,47.6892,1380
473000.0,3,1.0,1280,0,7,1280,0,47.5716,1240
698000.0,4,3.5,3630,0,10,3630,0,47.5189,1620
511000.0,3,2.5,1820,0,9,1820,0,47.7355,2720
358000.0,2,1.5,960,0,7,960,0,47.6183,1290
499990.0,3,1.75,1630,0,7,1060,570,47.5983,1630
322000.0,4,2.25,1940,0,7,1360,580,47.4253,1940
201000.0,3,1.0,980,0,7,980,0,47.4136,1580
765000.0,4,2.5,3140,1,9,2570,570,47.4363,2530
920000.0,4,2.75,2880,0,9,1710,1170,47.5874,1640
360000.0,4,2.0,1650,0,7,860,790,47.7765,1410
297300.0,3,1.75,1980,0,8,1980,0,47.2602,2080
399000.0,3,1.0,860,0,6,860,0,47.6815,2136
400000.0,3,1.0,1430,0,7,1430,0,47.7181,1720
230000.0,3,1.75,1260,0,6,1260,0,47.4752,1190
290000.0,3,1.0,960,0,7,960,0,47.5539,970
323800.0,3,2.5,2060,0,8,2060,0,47.2923,2250
574500.0,4,1.5,1430,0,9,1430,0,47.7014,1220
505000.0,3,2.25,1670,0,8,1220,450,47.6474,1670
372500.0,2,1.0,880,0,7,880,0,47.7332,1450
425000.0,3,1.5,1300,0,7,1300,0,47.6686,1590
446250.0,3,2.5,2380,0,9,2380,0,47.4525,2400
330000.0,2,0.75,520,0,4,520,0,47.326,1170
608095.0,3,2.5,2680,1,9,2680,0,47.7031,2840
550000.0,3,2.5,2140,0,8,1320,820,47.5602,1980
265000.0,4,2.5,1820,0,7,1820,0,47.3553,2120
399888.0,4,2.25,1820,0,7,1320,500,47.723,1550
430000.0,2,1.0,1050,0,7,850,200,47.6764,1080
554990.0,3,2.5,2100,0,8,2100,0,47.7508,2250
359950.0,3,2.5,2210,0,8,2210,0,47.35,2250
405000.0,2,1.0,860,0,6,860,0,47.675,1300
280000.0,2,1.0,870,0,7,870,0,47.7243,1370
479950.0,4,2.25,2570,0,8,2570,0,47.4507,2210
575000.0,5,1.75,2980,0,9,2230,750,47.4908,2860
392000.0,4,2.25,2360,0,8,2360,0,47.4403,2160
760500.0,4,2.25,2310,0,9,2310,0,47.7506,3930
435000.0,3,2.5,2300,0,8,2300,0,47.7447,3020
1565000.0,4,2.75,2810,0,10,2810,0,47.6159,2810
261000.0,4,1.5,2040,0,7,1190,850,47.4557,1960
1482500.0,3,2.25,3290,0,9,2730,560,47.6582,2340
853800.0,7,4.0,2960,0,9,1950,1010,47.5835,1970
657500.0,3,2.5,2670,0,9,2670,0,47.6272,2490
331950.0,4,2.5,2530,2,8,2010,520,47.2654,2140
514000.0,3,1.75,1720,1,8,1220,500,47.5399,1900
496000.0,3,3.5,3090,2,9,2020,1070,47.3541,2180
1093000.0,4,2.5,3930,0,11,3930,0,47.7209,3930
195700.0,3,1.0,1120,0,7,1120,0,47.3638,1690
1395710.0,4,2.25,3960,2,9,2630,1330,47.6317,3850
1175000.0,4,3.25,4060,0,10,4060,0,47.7213,4170
643403.0,3,2.5,2350,0,9,2350,0,47.6156,2320
357000.0,4,2.5,2380,0,7,2380,0,47.3982,2310
865000.0,3,1.75,1480,0,7,1040,440,47.638,2170
905000.0,3,2.5,2930,0,10,2930,0,47.6335,2730
265000.0,3,1.5,1290,0,6,1290,0,47.4227,1300
535000.0,2,2.5,2730,0,9,2730,0,47.512,3220
450000.0,3,1.0,1290,0,6,790,500,47.6951,1220
460500.0,4,2.5,2170,0,8,2170,0,47.5057,2170
315000.0,4,1.75,1850,0,7,1140,710,47.4877,2210
607500.0,4,2.5,2110,0,8,1270,840,47.6431,2140
432000.0,2,1.0,960,0,7,960,0,47.661,1290
1695000.0,3,4.0,3910,2,10,2610,1300,47.6393,2890
479000.0,4,2.5,2590,0,8,2590,0,47.3883,2410
475000.0,5,2.75,3080,0,9,3080,0,47.4501,3080
415000.0,3,1.0,1630,0,7,1630,0,47.7293,1480
450000.0,2,1.0,910,0,6,910,0,47.683,1480
1140000.0,3,2.5,2780,1,8,2110,670,47.5844,3150
430000.0,5,3.0,3880,0,7,3880,0,47.4806,2620
296000.0,3,1.75,1360,0,7,960,400,47.4351,1830
303000.0,4,2.25,2560,0,7,1790,770,47.34,1920
641000.0,4,2.5,2600,0,8,2600,0,47.5971,2910
280000.0,3,2.25,1220,0,7,790,430,47.6952,1870
260750.0,3,2.0,1560,0,7,1260,300,47.341,1570
601000.0,4,2.5,2080,0,8,2080,0,47.5978,2170
255000.0,3,1.5,1490,0,6,1490,0,47.4683,1330
555000.0,4,2.75,2020,0,8,1420,600,47.6373,2190
865000.0,3,1.5,1530,0,8,1530,0,47.6354,2050
1388000.0,4,2.5,3450,0,9,2180,1270,47.5969,3770
315000.0,3,2.25,1400,0,7,1140,260,47.3029,1680
200000.0,2,1.0,1730,0,7,1380,350,47.2956,1310
357000.0,3,1.0,1370,0,7,1370,0,47.7195,1550
390000.0,2,1.5,1050,0,8,960,90,47.6029,1470
462000.0,5,1.75,2840,0,7,2210,630,47.764,2000
174500.0,2,1.0,1010,0,7,1010,0,47.4166,1580
305000.0,2,1.0,1210,0,6,1210,0,47.7225,1150
449000.0,5,1.75,1720,0,8,1150,570,47.7365,1750
260000.0,3,2.0,2710,0,6,2710,0,47.5188,850
751000.0,4,2.5,3110,0,9,3110,0,47.701,3200
370037.0,2,1.0,1250,0,7,1250,0,47.7284,1130
229950.0,3,1.75,1900,0,7,1900,0,47.2769,1610
349000.0,3,1.75,1740,0,8,1330,410,47.4451,2010
348000.0,4,2.5,2070,0,8,2070,0,47.4498,1900
1220000.0,3,3.25,3030,2,9,2220,810,47.5978,2040
510000.0,4,3.0,3610,0,10,3610,0,47.2911,3568
265000.0,3,1.5,1520,0,7,1040,480,47.2907,1440
1250000.0,3,2.75,2780,2,10,2780,0,47.6569,2820
937500.0,4,4.0,5545,0,11,3605,1940,47.676,3420
485000.0,3,1.75,2590,0,8,1590,1000,47.7739,2590
489000.0,4,1.0,1150,0,7,1150,0,47.6806,1220
400000.0,2,1.0,920,0,7,920,0,47.5569,1190
638000.0,3,2.5,2110,0,9,2110,0,47.665,2540
440000.0,3,1.75,1170,0,7,1170,0,47.6849,1870
305000.0,6,2.0,1900,0,7,1200,700,47.7037,1900
649950.0,6,2.0,1900,0,7,1200,700,47.7037,1900
680000.0,4,2.5,3290,0,9,3290,0,47.5961,3210
629000.0,4,2.5,2660,0,9,2660,0,47.4911,3060
555000.0,3,2.5,2160,0,8,2160,0,47.5751,2160
669000.0,4,2.75,2700,0,8,2700,0,47.7628,2810
272000.0,3,2.5,1980,0,8,1980,0,47.2642,2150
270000.0,4,2.25,2600,0,7,1600,1000,47.4881,1770
215000.0,3,1.0,1280,0,6,1280,0,47.3262,1230
690000.0,3,1.5,1710,0,7,1180,530,47.5393,2590
256000.0,4,1.75,1270,2,7,1270,0,47.5051,1800
255000.0,3,2.25,1890,0,7,1100,790,47.4121,1520
550000.0,7,4.0,3440,0,7,3440,0,47.6981,1420
410000.0,3,1.0,1190,0,7,1190,0,47.5131,1280
410000.0,2,1.0,1030,0,7,1030,0,47.5311,1890
259000.0,3,1.75,1240,0,7,1240,0,47.4728,1570
292000.0,3,1.0,1730,0,7,1030,700,47.5024,1610
1648000.0,4,3.5,4610,2,11,4610,0,47.6508,2340
518000.0,5,1.0,1590,0,7,1190,400,47.5752,1590
485000.0,3,2.5,1760,0,8,1760,0,47.5764,1760
259500.0,3,2.0,1330,0,7,1330,0,47.3128,1660
354000.0,4,2.5,2340,0,8,2340,0,47.3773,2420
999950.0,3,2.25,3740,0,8,2330,1410,47.6354,2680
464500.0,3,1.75,1150,0,7,1150,0,47.5531,1350
300000.0,3,2.5,1750,0,7,1750,0,47.3605,1890
1080000.0,3,2.75,3890,1,8,3260,630,47.5445,2490
309950.0,4,2.5,1770,0,7,1770,0,47.2877,1780
315000.0,3,1.0,1160,0,7,1160,0,47.5651,1340
499950.0,3,1.0,1440,0,7,1440,0,47.6898,2010
780000.0,4,2.0,2600,2,8,1400,1200,47.637,2050
885000.0,3,3.25,2640,2,8,1960,680,47.5374,3690
500000.0,2,1.0,1010,0,7,1010,0,47.6224,1770
329000.0,3,2.0,1840,2,8,1840,0,47.3512,1790
246000.0,4,1.75,1720,0,7,1020,700,47.4669,1720
405000.0,3,1.5,1280,0,7,1280,0,47.6922,1510
349000.0,4,1.75,1700,0,7,1120,580,47.4801,1560
374950.0,4,2.5,1980,0,8,1980,0,47.4038,2300
306000.0,3,2.0,1160,0,7,1160,0,47.7279,1870
416000.0,4,1.75,1980,0,7,990,990,47.6226,1520
560000.0,3,2.5,1960,0,8,1960,0,47.5315,2450
260000.0,3,1.5,1270,0,7,1150,120,47.7576,1990
306500.0,3,2.25,2060,0,8,1560,500,47.2752,2080
299950.0,3,1.75,1980,0,7,1480,500,47.4474,1520
265500.0,3,2.5,1450,0,8,1450,0,47.2576,2410
219000.0,3,1.5,1200,0,7,1200,0,47.268,1200
365000.0,3,1.75,1830,0,8,1230,600,47.7427,1840
499000.0,3,2.0,2090,0,7,2090,0,47.3497,1890
366000.0,3,1.75,1510,0,7,1510,0,47.7243,1460
514950.0,3,2.25,1310,0,8,1310,0,47.6987,1330
875000.0,4,2.75,3790,0,10,3790,0,47.5976,3750
831000.0,3,2.25,2240,0,8,2240,0,47.5937,2240
689900.0,4,3.25,2740,0,9,2060,680,47.5346,3030
315000.0,3,2.5,1660,0,7,1660,0,47.3812,2010
355000.0,0,0.0,2460,0,8,2460,0,47.4095,2520
336500.0,3,1.0,1480,0,7,970,510,47.7757,2020
1100000.0,3,2.75,2640,0,8,1750,890,47.6332,1920
375000.0,6,2.0,1900,0,7,1170,730,47.762,2090
289275.0,3,2.0,2860,0,9,1700,1160,47.7718,1460
455000.0,4,3.5,3440,0,8,3440,0,47.4077,1660
505000.0,3,1.75,1640,2,8,1640,0,47.7145,2790
450000.0,3,1.0,1450,0,7,1450,0,47.5607,1340
567500.0,3,2.5,2300,0,8,2300,0,47.5369,2580
265000.0,3,1.5,1460,0,7,1460,0,47.4402,1580
340000.0,3,2.0,1570,0,8,1570,0,47.6965,1640
375000.0,3,2.0,1540,0,6,1540,0,47.7403,1730
920000.0,6,3.0,3300,0,8,2200,1100,47.6557,1420
850000.0,4,2.25,2130,0,9,2130,0,47.5358,2380
202000.0,3,1.0,1010,0,7,1010,0,47.3244,1230
725000.0,4,3.0,2420,0,9,2420,0,47.7267,3100
900000.0,3,3.25,3870,0,10,3150,720,47.5589,3590
680200.0,2,1.5,1960,0,8,1210,750,47.6849,2060
216500.0,3,1.0,1170,0,6,1170,0,47.2109,1280
325000.0,3,1.5,1890,0,7,1890,0,47.3454,1510
675000.0,3,2.5,2250,0,9,2250,0,47.6651,2390
435000.0,2,0.75,750,1,4,750,0,47.6985,3020
263500.0,3,1.75,1610,0,7,1050,560,47.3429,1550
550000.0,4,2.25,2590,0,8,2590,0,47.769,2670
875000.0,3,2.5,2520,1,9,2520,0,47.5671,2250
246600.0,4,1.0,1340,0,7,1340,0,47.3313,1120
337000.0,3,2.25,1460,0,8,1460,0,47.7145,1490
240000.0,3,1.75,1380,0,7,1380,0,47.3628,1530
490000.0,3,1.75,1510,0,8,1510,0,47.5931,2660
510000.0,5,2.5,2510,0,7,1260,1250,47.4576,2460
305000.0,3,1.0,910,0,7,910,0,47.726,1480
350000.0,3,2.5,1970,0,7,1970,0,47.7453,1970
284200.0,3,1.75,1540,0,7,1070,470,47.4973,2510
357000.0,4,2.5,1980,0,7,1980,0,47.3675,1610
854000.0,4,2.75,3150,0,10,2480,670,47.7302,3150
1175000.0,4,2.5,4700,0,10,4700,0,47.5878,2870
1000000.0,3,2.25,2300,0,8,1150,1150,47.6322,2200
616500.0,4,2.25,1880,0,8,1760,120,47.6864,1880
750000.0,4,2.75,2640,0,7,1840,800,47.6783,1690
650000.0,6,4.5,3900,0,8,2870,1030,47.6612,2080
275000.0,4,2.25,2670,0,8,1420,1250,47.3792,2190
540000.0,4,1.75,1840,0,7,920,920,47.6681,1660
225000.0,3,1.0,1120,0,6,1120,0,47.2886,1240
845000.0,4,2.5,2970,0,10,2970,0,47.562,2740
490000.0,3,2.25,1410,0,6,1410,0,47.523,1220
753000.0,4,2.5,3060,0,9,3060,0,47.5521,2930
475000.0,3,1.75,2490,0,7,1290,1200,47.726,1610
124000.0,1,0.75,840,0,6,840,0,47.4756,1560
224000.0,1,0.75,840,0,6,840,0,47.4756,1560
485000.0,2,1.0,1130,0,7,1130,0,47.6862,1470
230000.0,4,1.75,1850,0,6,1270,580,47.4923,1270
372000.0,4,2.75,2330,0,7,1800,530,47.4193,1480
306000.0,4,2.5,1880,0,7,1880,0,47.3584,1760
905000.0,4,3.5,2980,0,9,2340,640,47.6768,1810
440000.0,4,1.0,1440,0,7,1040,400,47.571,1320
280000.0,3,1.75,1630,0,7,1100,530,47.3605,1630
435000.0,3,2.5,1778,0,7,1778,0,47.6811,2840
425000.0,3,2.5,1930,0,8,1930,0,47.5791,1770
204950.0,2,0.75,1130,0,7,1130,0,47.4526,1550
670000.0,2,1.75,1650,0,7,1000,650,47.6871,2530
475000.0,2,1.0,820,0,7,820,0,47.6623,1370
352000.0,5,2.5,2900,0,7,1450,1450,47.4935,1600
575000.0,4,1.75,2330,2,7,1260,1070,47.6148,2270
1730000.0,4,3.5,4440,2,10,3240,1200,47.5472,4240
491000.0,3,2.0,1660,3,8,1660,0,47.5552,2440
750000.0,4,2.5,3020,0,9,3020,0,47.5982,3100
830000.0,4,2.5,1850,0,8,1430,420,47.6535,2090
1140000.0,6,3.75,5960,4,10,3900,2060,47.5398,3860
137124.0,3,1.0,960,0,6,960,0,47.4676,1100
225000.0,4,1.0,1150,0,6,1150,0,47.562,840
732600.0,4,2.5,2130,0,7,1230,900,47.605,2130
818000.0,4,2.25,2460,0,8,2460,0,47.548,2460
431000.0,3,2.25,2360,0,9,2360,0,47.3856,2720
304000.0,2,2.25,1320,0,7,1320,0,47.7039,1330
650000.0,5,2.0,1910,0,7,1010,900,47.6236,1230
450000.0,2,2.0,1610,0,8,1610,0,47.6644,1750
269000.0,4,1.0,1610,0,7,1610,0,47.5104,1610
875000.0,3,1.0,1160,0,7,1160,0,47.6391,2390
890000.0,4,2.25,2870,0,8,1480,1390,47.5787,2930
565000.0,4,2.5,2280,0,8,2280,0,47.7568,2140
448175.0,2,2.0,1370,0,8,1150,220,47.6021,1370
235000.0,0,0.0,1470,0,7,1470,0,47.5265,1060
680000.0,5,3.0,2970,0,9,2970,0,47.5973,2970
629000.0,3,1.75,1460,4,8,1120,340,47.3311,1970
494000.0,3,3.5,1570,0,8,1330,240,47.652,1610
1100000.0,4,3.0,2880,0,9,1920,960,47.6448,2110
450000.0,5,2.5,1900,0,7,1190,710,47.7096,1940
330000.0,3,1.75,2020,0,8,1320,700,47.4706,1940
960000.0,4,2.5,3110,3,10,3110,0,47.5623,3110
360000.0,4,2.5,2390,0,9,2390,0,47.3385,2590
378000.0,3,2.5,2150,0,8,2150,0,47.3515,2150
499950.0,3,1.75,1340,0,7,1090,250,47.5427,1550
450000.0,3,2.5,1990,0,7,1990,0,47.7477,2310
523500.0,2,2.0,1600,0,7,800,800,47.5691,1520
600000.0,3,2.5,2680,0,9,2680,0,47.7655,2520
290000.0,3,2.5,2080,0,8,2080,0,47.3737,2190
176000.0,3,3.25,1340,0,7,1340,0,47.3779,1670
885000.0,3,2.0,2590,0,7,1790,800,47.635,2440
483000.0,2,1.75,1240,0,7,1240,0,47.6689,1800
240000.0,3,1.0,1310,0,7,1310,0,47.3739,1650
720000.0,4,2.25,2530,1,8,1530,1000,47.6985,2240
311000.0,4,2.5,1780,0,7,1780,0,47.4455,1990
332500.0,3,2.0,1600,0,7,1600,0,47.5177,2440
164950.0,3,1.75,1570,0,7,1080,490,47.4608,1250
371000.0,3,1.75,1570,0,7,1080,490,47.4608,1250
264500.0,3,1.75,1650,0,7,1650,0,47.3926,1650
1738000.0,4,2.25,2920,0,9,2260,660,47.638,4510
503000.0,2,1.0,870,2,6,870,0,47.6697,1750
738000.0,4,2.5,2830,0,9,2170,660,47.6952,1880
393000.0,2,1.0,980,0,7,980,0,47.6858,1260
280000.0,2,1.0,990,0,7,990,0,47.5013,1730
260000.0,4,2.5,2360,2,8,1530,830,47.3367,2580
505000.0,2,1.0,1000,2,7,1000,0,47.5659,1940
241000.0,3,1.5,1660,0,7,1120,540,47.353,1900
530000.0,3,1.75,1520,0,7,1520,0,47.667,2040
713000.0,1,1.0,1180,2,8,840,340,47.5561,1420
487000.0,3,1.75,1770,0,7,1770,0,47.7289,1680
128000.0,2,1.0,980,0,6,980,0,47.3674,980
210500.0,3,1.0,1840,0,7,1040,800,47.3979,2040
420000.0,3,2.5,1810,0,7,1210,600,47.5067,1770
679000.0,3,2.5,1780,0,8,1780,0,47.6809,1690
784950.0,4,2.75,2840,0,9,2840,0,47.7097,2880
352000.0,4,2.5,2650,0,9,2650,0,47.3325,2650
386000.0,3,1.5,1270,0,7,1080,190,47.6526,1360
335000.0,3,1.75,1260,0,7,1260,0,47.5114,1540
472500.0,3,2.0,1750,0,7,1490,260,47.5887,2450
599950.0,5,2.25,2680,0,8,1340,1340,47.7422,2220
963990.0,4,3.25,3830,0,9,3830,0,47.685,3830
735000.0,3,2.0,1610,2,8,1610,0,47.5969,2540
858450.0,3,4.25,3840,0,10,3840,0,47.6347,3230
665000.0,5,2.75,2670,0,7,1800,870,47.6711,2460
290000.0,3,2.5,2000,0,7,2000,0,47.3508,2000
250000.0,2,1.0,860,0,7,860,0,47.5263,980
192500.0,3,1.75,1420,0,7,1420,0,47.3555,1690
350000.0,4,2.0,2060,2,8,2060,0,47.4404,1950
518000.0,4,2.5,2790,0,8,2790,0,47.4891,2590
563000.0,4,1.0,1410,0,7,1410,0,47.6606,1040
375000.0,4,3.0,2420,0,7,2420,0,47.4693,2420
400000.0,3,2.5,1460,0,8,1460,0,47.698,1430
240000.0,5,1.75,2460,0,7,1230,1230,47.3305,1990
317500.0,2,1.0,1000,0,6,1000,0,47.6088,1940
1315000.0,5,4.0,4420,0,10,2740,1680,47.6468,3720
234000.0,3,1.0,1240,0,6,1240,0,47.4303,1990
645000.0,3,2.5,1740,0,9,1740,0,47.6264,2540
649000.0,2,1.0,1280,0,7,1200,80,47.6762,1860
605000.0,4,2.5,2520,0,8,2520,0,47.5399,2580
337900.0,3,3.5,1500,0,7,1500,0,47.7034,1500
535000.0,3,2.75,2490,0,8,2290,200,47.6098,1880
325000.0,4,1.0,1530,0,7,1130,400,47.5507,1540
429950.0,4,2.25,1740,0,8,1740,0,47.5132,1680
775000.0,3,2.5,3550,0,9,3550,0,47.7292,3270
650000.0,2,1.0,1280,0,7,1280,0,47.6339,2460
1200000.0,4,2.25,2320,0,8,2320,0,47.5762,2740
275000.0,2,1.0,1140,0,5,1140,0,47.7497,2200
575000.0,4,3.5,3930,0,9,3930,0,47.7412,2740
540000.0,3,2.5,2370,0,7,1640,730,47.7634,2170
640000.0,3,1.75,2340,0,7,1170,1170,47.5759,1360
275000.0,3,1.5,1240,0,7,1240,0,47.4469,1670
672800.0,4,2.5,2740,0,9,2740,0,47.6095,2760
495000.0,4,2.25,1940,0,7,1430,510,47.5942,1460
820000.0,3,2.5,2950,0,10,2950,0,47.7316,3810
475000.0,4,2.75,1980,0,7,1980,0,47.7707,2080
1275000.0,4,2.0,2850,4,10,1450,1400,47.6995,2810
380000.0,3,1.0,1160,0,7,1160,0,47.7419,1160
397500.0,3,2.0,2130,0,8,2130,0,47.4396,2580
352000.0,5,2.5,2420,2,7,1620,800,47.532,2210
893880.0,6,2.5,2820,0,8,1430,1390,47.565,2070
635000.0,5,3.25,3710,0,8,2510,1200,47.6101,1720
420000.0,3,2.25,1770,0,7,1770,0,47.7166,1650
503000.0,3,2.0,1260,0,7,750,510,47.6748,1710
689000.0,2,1.75,2330,2,7,1220,1110,47.4899,2560
749500.0,4,2.75,2490,0,7,1610,880,47.6551,1420
1150000.0,6,3.75,4090,0,9,3100,990,47.6408,2980
563500.0,4,2.5,2800,0,8,2800,0,47.7392,2810
480000.0,4,3.0,2440,0,8,1890,550,47.7649,2380
374950.0,4,3.0,2540,1,9,1620,920,47.3204,2540
308950.0,3,2.5,1600,0,7,1600,0,47.3675,1760
445000.0,4,2.75,2680,0,7,1340,1340,47.542,1240
237200.0,3,1.5,1220,0,7,1220,0,47.3642,1220
453500.0,3,1.75,1550,0,7,1550,0,47.72,1050
616500.0,3,2.0,2080,0,7,1040,1040,47.6886,1620
1250000.0,5,5.0,5000,0,10,5000,0,47.6012,3030
396000.0,1,1.0,630,0,5,630,0,47.6923,1390
210000.0,3,1.0,1070,0,6,1070,0,47.5015,1050
539000.0,2,1.75,1900,0,7,1200,700,47.5689,1370
605000.0,3,2.5,2960,0,8,2960,0,47.4358,2740
437500.0,3,2.0,1490,0,6,1490,0,47.6933,1500
215000.0,3,1.5,1500,0,7,1500,0,47.3926,1790
440000.0,4,2.5,2410,0,7,2410,0,47.5326,2410
525000.0,3,1.0,2000,0,7,1680,320,47.711,2000
319900.0,3,1.5,1140,0,7,840,300,47.4755,1200
335000.0,3,1.0,1120,0,7,1120,0,47.7551,1120
485000.0,3,2.25,2900,0,9,2900,0,47.4013,2510
359999.0,4,2.25,3220,0,8,3220,0,47.3188,2570
799000.0,5,2.75,2500,3,8,2500,0,47.5938,1700
280000.0,3,2.25,1610,0,7,1610,0,47.4517,1720
1050000.0,4,2.75,2250,0,8,1500,750,47.6382,1970
290000.0,1,2.0,1240,0,6,1240,0,47.4778,1030
235000.0,2,2.25,1660,0,7,1660,0,47.4333,1620
495000.0,3,1.75,2080,0,7,1040,1040,47.6853,1000
290000.0,3,2.25,1880,0,8,1880,0,47.3631,2180
230000.0,4,1.5,1050,0,7,1050,0,47.4151,1390
234000.0,3,1.75,1480,0,7,1480,0,47.3126,1800
597400.0,4,2.5,2420,0,7,2420,0,47.6874,2280
370000.0,4,2.5,2190,0,7,1110,1080,47.4712,1820
755000.0,4,2.5,2660,0,9,2660,0,47.6972,2890
342000.0,3,2.5,2430,0,7,2430,0,47.3718,3040
497000.0,2,1.0,770,0,7,770,0,47.6102,960
835000.0,3,1.0,3060,0,8,3060,0,47.5656,1880
730000.0,4,2.75,2920,0,9,2920,0,47.5646,2920
655000.0,3,1.0,1370,0,7,1070,300,47.6421,2410
205000.0,3,2.5,1870,0,8,1870,0,47.3739,1580
632750.0,4,2.0,1800,0,7,1800,0,47.6388,1950
330000.0,5,3.0,2100,0,7,1250,850,47.4866,2100
527500.0,5,2.25,2530,0,7,2530,0,47.6117,2020
716500.0,4,2.5,3290,0,9,3290,0,47.5981,3100
388500.0,4,2.5,1890,0,7,1890,0,47.5415,2060
530000.0,3,1.75,1680,0,7,1680,0,47.6028,1880
419000.0,3,2.5,2170,0,8,2170,0,47.4819,2610
385000.0,3,1.75,1200,0,7,1200,0,47.6979,1200
655000.0,4,2.5,2990,0,8,2990,0,47.6119,3110
1695000.0,4,2.75,3770,2,9,3070,700,47.5849,3000
279000.0,2,1.0,1020,0,7,1020,0,47.4206,1930
262000.0,3,1.5,1700,0,7,1100,600,47.3209,1700
533000.0,4,1.0,1550,0,7,1550,0,47.6824,1320
640000.0,3,1.75,1680,2,8,1680,0,47.7212,1880
285000.0,3,2.25,1680,0,7,1680,0,47.3025,1820
458400.0,4,2.5,1910,0,8,1910,0,47.7581,1910
620000.0,5,3.25,3160,0,7,2190,970,47.7238,2200
465000.0,3,1.5,2020,0,6,1190,830,47.6641,2370
690000.0,4,3.75,3210,0,8,3210,0,47.7268,2350
462500.0,3,2.25,2350,0,7,1390,960,47.7417,2350
369950.0,4,2.5,1910,0,8,1910,0,47.381,2210
124500.0,2,1.0,840,0,5,840,0,47.264,1100
950000.0,4,2.25,2620,0,9,2620,0,47.6117,2370
418000.0,4,1.5,1220,0,7,1220,0,47.6205,1350
160000.0,3,1.0,1060,0,6,1060,0,47.305,1060
457000.0,4,2.5,2200,0,8,1500,700,47.7711,2280
530000.0,2,1.75,2120,0,6,1130,990,47.5304,1220
385000.0,3,1.0,1250,0,7,1250,0,47.6032,1540
491000.0,3,1.75,1440,0,7,1440,0,47.5996,1440
521000.0,4,2.25,1890,0,8,1890,0,47.6338,1920
255000.0,3,1.0,1140,0,7,1140,0,47.2098,1140
292050.0,5,3.0,2840,0,7,1710,1130,47.5065,2210
326000.0,6,3.0,1880,0,7,1880,0,47.5029,1540
300000.0,2,1.0,750,0,6,750,0,47.5312,930
291600.0,3,1.75,1630,0,7,1330,300,47.4514,1940
435000.0,5,1.5,1720,0,7,1720,0,47.5241,1560
465000.0,3,2.5,1600,0,8,1600,0,47.6903,1390
200000.0,3,2.25,1230,0,7,1230,0,47.3184,1260
238000.0,3,1.5,1610,2,7,1090,520,47.5017,1650
455000.0,4,2.5,1320,0,7,1320,0,47.6007,1550
230000.0,6,3.0,2180,0,7,2180,0,47.3046,2260
808000.0,4,2.25,2190,0,8,1410,780,47.6419,1990
578500.0,3,1.0,1490,0,7,1490,0,47.6549,2290
390000.0,3,2.0,1463,0,7,1463,0,47.6843,1484
517500.0,3,2.5,1800,0,8,1800,0,47.5746,1800
755000.0,4,2.75,2880,0,9,2100,780,47.5843,2110
579500.0,3,1.75,1250,0,7,980,270,47.685,1250
649950.0,3,2.75,1670,0,9,1350,320,47.5764,1520
228000.0,4,1.75,2000,0,7,1100,900,47.5035,1880
665000.0,4,1.75,2280,0,7,1470,810,47.6754,1850
689000.0,4,2.5,2110,0,9,2110,0,47.6374,2180
560000.0,4,2.5,2520,0,8,1440,1080,47.6748,2360
529000.0,3,1.0,1590,0,7,1590,0,47.5355,1780
375000.0,5,2.5,2100,0,8,2100,0,47.4721,1980
325000.0,4,2.75,2090,0,6,2090,0,47.4854,1460
583000.0,4,2.5,3390,2,10,3390,0,47.332,2830
330000.0,2,1.0,790,0,6,790,0,47.7634,2350
262000.0,3,2.5,1970,0,7,1970,0,47.3263,1670
555000.0,4,2.5,2870,0,8,2870,0,47.539,2770
585000.0,2,1.0,1110,0,7,1010,100,47.5632,1410
425590.0,3,2.75,1940,3,8,1770,170,47.5185,1410
235000.0,2,1.0,720,0,6,720,0,47.5534,1510
362362.0,2,1.0,710,0,6,710,0,47.5535,960
252000.0,3,2.0,1370,0,7,1370,0,47.3634,1420
439000.0,4,2.5,2690,0,9,2690,0,47.4343,2890
465000.0,4,2.25,3360,0,9,3360,0,47.3316,2590
249900.0,4,2.0,1500,0,7,1500,0,47.3127,1500
665000.0,2,2.5,2600,0,8,1300,1300,47.5806,2260
370000.0,3,1.75,1160,0,7,1160,0,47.7159,1990
620000.0,2,1.0,1430,0,7,1300,130,47.6415,1750
375000.0,3,1.0,1870,0,8,1720,150,47.7162,1460
552625.0,4,2.0,2560,0,8,1280,1280,47.7169,1830
315500.0,3,1.0,1160,0,7,1160,0,47.7267,1520
620000.0,2,1.75,1680,0,8,1680,0,47.5603,2390
510000.0,4,2.5,2010,0,8,1310,700,47.553,1850
652500.0,4,2.5,2540,0,9,2540,0,47.6694,2560
574000.0,4,2.5,3240,0,8,3240,0,47.6329,2570
430000.0,3,2.5,2670,0,9,2670,0,47.3686,3010
390000.0,3,2.0,1080,0,7,1080,0,47.7143,1120
466500.0,3,1.0,1430,0,7,950,480,47.6847,1430
315000.0,2,2.25,1290,0,7,1290,0,47.6803,1360
220000.0,4,1.5,1240,0,7,1240,0,47.3206,1240
325000.0,3,1.75,1840,0,7,1440,400,47.371,1840
365000.0,3,1.0,1120,0,7,1120,0,47.7715,1450
356000.0,3,3.5,2100,0,9,2100,0,47.4687,2400
380000.0,4,1.75,2030,0,8,1610,420,47.7278,1650
579000.0,4,2.25,2030,0,8,2030,0,47.7214,1950
682000.0,2,1.0,890,0,7,890,0,47.6666,1680
499000.0,3,1.75,1750,0,7,1470,280,47.6832,1820
333760.0,3,1.0,1300,0,7,1300,0,47.6937,1300
745000.0,4,2.5,2650,0,11,2650,0,47.5761,3270
380000.0,3,1.75,1750,0,7,1750,0,47.4989,1230
435000.0,3,3.0,1440,2,8,1440,0,47.6525,1440
520000.0,3,2.75,1700,0,7,1060,640,47.6767,1880
965000.0,4,2.5,3920,0,10,3920,0,47.7325,3780
270000.0,3,2.25,1470,0,7,1350,120,47.4968,1540
1100000.0,5,2.75,2520,0,8,2120,400,47.6348,2100
577500.0,3,1.75,2140,0,8,1220,920,47.5722,2250
650000.0,3,1.75,1550,0,7,1250,300,47.6722,1110
1227500.0,4,2.5,3180,0,11,3180,0,47.5372,3130
1900000.0,5,4.25,6510,3,11,3250,3260,47.5758,4480
475000.0,2,2.0,1440,0,7,1440,0,47.6902,1490
200000.0,3,1.0,1150,0,7,1150,0,47.3172,1180
397000.0,4,2.5,2320,0,8,2320,0,47.484,2320
383610.0,3,2.0,1230,0,7,1230,0,47.7548,2110
275000.0,4,2.5,2060,0,7,2060,0,47.3612,1610
840000.0,3,2.0,2783,0,8,2783,0,47.538,1730
365000.0,4,2.5,2140,0,8,2140,0,47.4483,2120
362000.0,3,2.75,1420,0,8,1160,260,47.5477,1420
350000.0,3,1.75,2090,0,7,1390,700,47.5503,1790
200000.0,2,1.75,1320,0,7,1320,0,47.712,1320
299000.0,4,2.5,2300,0,8,1360,940,47.2979,1910
555000.0,4,1.5,3050,0,8,1650,1400,47.5266,2930
1326000.0,3,2.25,2960,3,10,2260,700,47.7035,2960
896000.0,5,2.75,2520,3,8,1570,950,47.528,2760
550000.0,2,1.75,1740,0,8,1280,460,47.6461,1820
324500.0,2,1.0,1300,0,7,1300,0,47.7238,1820
312500.0,3,1.0,1170,0,7,1170,0,47.625,1170
485000.0,4,3.25,1946,1,7,1946,0,47.359,1460
511000.0,2,1.0,1250,0,7,1250,0,47.6945,1250
139500.0,2,1.5,1230,0,7,1230,0,47.3768,1660
464000.0,4,2.5,2180,0,8,2180,0,47.5119,2350
255000.0,3,1.75,1740,0,7,1140,600,47.2968,1690
679975.0,4,2.5,3830,0,8,2900,930,47.5384,3400
624800.0,3,2.0,2250,0,8,1500,750,47.5762,2820
920000.0,3,2.75,2590,0,9,2590,0,47.6145,3410
1365000.0,3,2.5,2090,0,9,2090,0,47.6567,2730
510000.0,3,1.5,2400,0,8,1540,860,47.6888,2380
289659.0,4,2.25,2260,0,7,2260,0,47.4121,1720
585000.0,4,2.5,2910,0,8,2910,0,47.538,2550
555000.0,5,3.0,3640,0,8,3640,0,47.3521,3740
940000.0,4,2.75,3770,2,8,2550,1220,47.5824,2640
460000.0,3,2.0,1600,0,7,1600,0,47.6977,1600
319000.0,3,2.5,2110,0,7,2110,0,47.3935,2100
280000.0,3,2.5,1720,0,7,1720,0,47.4895,1760
250000.0,3,1.0,1100,0,5,1100,0,47.5242,1280
749950.0,4,2.5,2620,0,9,2620,0,47.6272,2260
458000.0,5,2.5,3090,0,8,2990,100,47.7709,2560
465000.0,3,2.5,1890,0,8,1890,0,47.5348,2460
580000.0,3,1.75,1850,0,8,1150,700,47.6871,1450
700000.0,4,2.5,3100,0,10,3100,0,47.7646,3080
350000.0,4,2.5,2506,0,8,2506,0,47.3236,2441
456000.0,4,1.0,1700,0,7,1080,620,47.6955,1700
290000.0,3,2.0,1550,0,7,1550,0,47.3699,1840
475000.0,4,2.75,2200,0,7,1290,910,47.4793,2650
285000.0,3,2.5,1890,0,7,1890,0,47.3613,1980
309000.0,3,1.0,1140,0,7,1140,0,47.4902,1340
860000.0,4,2.0,3740,0,9,3740,0,47.6728,3180
219000.0,3,2.25,1940,0,8,1440,500,47.3565,1880
546500.0,3,2.5,2130,0,8,2130,0,47.6331,1890
338000.0,2,1.0,1470,0,7,770,700,47.5348,1410
505000.0,2,1.0,1070,0,7,1070,0,47.697,1360
340000.0,4,1.75,1680,0,7,840,840,47.6895,1800
678000.0,3,2.25,2730,0,9,2730,0,47.6289,2770
800000.0,3,1.75,1890,0,8,1890,0,47.535,2630
112000.0,1,1.0,1080,0,6,1080,0,47.3075,1210
252000.0,3,1.75,1440,0,6,1440,0,47.3318,1560
335000.0,4,2.75,2540,0,7,1600,940,47.4601,1820
610000.0,3,2.0,2300,0,8,1430,870,47.6075,2140
245000.0,3,2.0,1690,0,7,1360,330,47.2981,1740
493500.0,3,1.75,1800,0,8,1390,410,47.5815,2210
596500.0,4,2.25,1770,0,8,1770,0,47.6904,1880
245000.0,3,2.0,1190,0,6,1190,0,47.5276,1680
333500.0,3,1.75,1320,0,7,1320,0,47.7341,1750
373000.0,3,1.0,1290,0,7,1290,0,47.74,1540
759900.0,4,2.5,3000,0,8,3000,0,47.7066,3000
317000.0,3,2.25,1358,0,7,1358,0,47.7054,1358
670000.0,3,1.5,1220,0,7,1220,0,47.5746,1320
985000.0,2,2.5,2720,4,7,2720,0,47.4499,1870
310000.0,3,1.5,1060,0,6,1060,0,47.5497,1560
750000.0,4,2.5,3020,0,9,2540,480,47.6989,3020
408000.0,3,2.0,1640,0,7,1640,0,47.6829,1070
900000.0,5,3.75,3870,0,10,3870,0,47.6078,3600
460000.0,4,2.25,2860,0,8,1460,1400,47.7655,1730
339000.0,4,2.5,1740,0,7,1740,0,47.5026,1190
660000.0,3,2.0,1140,0,7,1140,0,47.637,1260
449950.0,4,3.0,3290,0,9,3290,0,47.3904,2810
235000.0,3,1.0,1210,0,7,1210,0,47.4984,1210
769000.0,5,2.25,3320,2,9,1900,1420,47.759,2820
428000.0,2,2.0,1350,0,8,1350,0,47.7094,1440
445000.0,3,2.25,1990,0,8,1990,0,47.7579,2180
462000.0,4,2.5,2060,0,7,1220,840,47.7251,1760
775000.0,3,1.0,1460,0,7,1460,0,47.6626,2280
605000.0,4,1.75,2250,0,8,2250,0,47.5922,2050
193500.0,2,1.0,950,0,7,950,0,47.4987,950
389950.0,4,2.5,3140,0,9,3140,0,47.3091,3000
790000.0,4,3.5,3560,0,10,3560,0,47.5828,3660
442000.0,2,1.0,1410,2,7,940,470,47.5531,1450
890000.0,4,2.25,2770,0,8,2770,0,47.543,2300
235000.0,3,1.0,1864,0,7,1864,0,47.285,990
495000.0,4,1.75,1930,2,8,1130,800,47.6935,1850
600000.0,4,2.5,3870,0,10,3870,0,47.3109,2170
1400000.0,3,2.0,2020,3,10,1790,230,47.6388,2580
251000.0,3,2.0,1300,0,7,1300,0,47.368,1300
471000.0,4,2.25,3410,0,8,2410,1000,47.505,2870
597000.0,4,2.5,2370,0,8,2370,0,47.7379,2340
804000.0,5,3.5,2770,0,9,2770,0,47.5628,2520
357000.0,3,1.75,1250,0,7,1250,0,47.7613,2180
419990.0,3,2.5,1690,0,8,1150,540,47.5528,1540
725000.0,4,2.5,3040,0,10,3040,0,47.4872,2990
275000.0,3,2.5,2710,0,7,2710,0,47.3357,2720
445000.0,3,2.25,1190,0,7,1190,0,47.4813,1630
510000.0,3,2.5,2300,0,9,2300,0,47.7369,2480
330000.0,4,1.0,1360,0,7,1360,0,47.7622,1540
270000.0,3,1.0,1500,0,6,750,750,47.5456,1050
495000.0,4,2.0,1610,0,7,1230,380,47.5333,1180
225000.0,4,1.75,1420,0,7,1420,0,47.3121,1420
716528.0,3,1.5,1750,0,7,1050,700,47.6799,1750
260000.0,3,2.5,1510,0,7,1510,0,47.3498,1520
471000.0,4,2.5,2330,0,8,2330,0,47.4836,2430
690000.0,5,3.5,2690,2,8,1930,760,47.5592,2080
548000.0,5,1.5,1700,0,7,1700,0,47.7614,1460
505000.0,3,1.0,1020,0,7,880,140,47.6924,1580
325000.0,3,1.0,1160,0,7,1160,0,47.7263,1220
682000.0,4,2.25,2450,0,8,2450,0,47.5751,2410
605000.0,3,2.25,2010,0,8,2010,0,47.7276,2240
276200.0,2,1.75,1370,0,8,1370,0,47.3794,1370
530000.0,3,1.0,1370,0,7,1370,0,47.6867,1220
245000.0,3,3.0,1990,0,7,1440,550,47.3499,1670
654950.0,4,2.5,2790,0,9,2790,0,47.7674,2890
221900.0,2,1.0,780,0,6,780,0,47.4733,1860
466000.0,4,2.0,2240,2,8,1340,900,47.5096,1930
383150.0,3,2.0,2210,0,8,2210,0,47.265,2570
657100.0,4,1.0,1390,0,7,1050,340,47.6596,1810
539000.0,3,2.0,1800,0,8,1800,0,47.7585,2290
400000.0,6,3.0,3320,0,8,1660,1660,47.2983,2330
215000.0,4,2.5,1960,0,6,980,980,47.2898,1160
489000.0,2,1.0,850,0,7,850,0,47.6875,1450
649000.0,4,2.5,2980,0,10,2980,0,47.5857,3080
700000.0,4,1.75,1980,0,8,1320,660,47.5899,2310
268500.0,2,1.0,790,0,6,790,0,47.7511,1470
515000.0,3,2.5,1800,0,7,1800,0,47.7126,2106
685000.0,4,2.0,2260,0,9,2260,0,47.6124,2650
305000.0,2,1.5,800,0,7,800,0,47.5917,1320
950000.0,4,2.0,2490,2,8,2090,400,47.6557,2910
292500.0,4,2.5,1610,0,7,1610,0,47.3351,1834
270000.0,4,1.75,1850,0,7,1100,750,47.7481,2260
450000.0,4,1.75,1850,0,7,1100,750,47.7481,2260
535000.0,4,1.0,1920,0,7,1920,0,47.6897,1600
550000.0,3,2.5,1740,0,8,1740,0,47.5489,1910
457500.0,3,2.25,1430,0,8,980,450,47.5908,2210
136500.0,3,1.5,1420,0,6,1420,0,47.3076,1200
224097.0,3,1.5,1420,0,6,1420,0,47.3076,1200
254000.0,3,2.5,1560,0,7,1560,0,47.3572,1360
335000.0,4,2.25,2030,0,7,1230,800,47.4596,1830
594950.0,5,2.5,3280,0,9,3280,0,47.475,3360
350000.0,3,1.75,1360,0,8,1360,0,47.4716,1570
169950.0,3,1.0,1180,0,7,1180,0,47.3845,1220
432500.0,3,2.5,1940,0,8,1340,600,47.7471,2080
440000.0,2,1.75,1300,0,7,1300,0,47.6687,1350
233703.0,3,2.25,1650,0,7,1650,0,47.3908,1510
310000.0,3,1.5,1140,0,7,1140,0,47.5701,1150
735000.0,3,2.5,2540,0,10,2540,0,47.6239,2870
730000.0,4,2.75,3440,0,10,3440,0,47.5168,2560
257000.0,3,1.75,1800,0,7,1200,600,47.4932,980
485000.0,2,2.25,1260,0,8,1260,0,47.6531,1330
899000.0,4,2.25,2370,2,8,1440,930,47.7023,3280
279000.0,3,1.0,1520,0,7,1520,0,47.7222,1560
225000.0,4,2.0,1750,0,7,1050,700,47.3164,1640
1355000.0,3,1.5,2680,2,8,1880,800,47.6333,2280
355000.0,3,2.5,1590,0,7,1590,0,47.5309,1590
382500.0,4,1.75,1560,0,7,1560,0,47.7274,2080
324360.0,3,2.5,2000,0,8,2000,0,47.1964,1930
315000.0,3,1.75,2380,0,8,2380,0,47.3143,2320
426000.0,2,1.0,2230,0,7,2230,0,47.7372,1870
395000.0,5,2.5,2820,0,8,2820,0,47.2616,2610
212644.0,3,1.0,1570,0,5,1570,0,47.3531,1330
510000.0,3,3.0,1845,2,8,1845,0,47.5204,2100
85000.0,2,1.0,830,0,6,830,0,47.3813,1160
235000.0,2,1.0,830,0,6,830,0,47.3813,1160
295000.0,4,2.5,2030,0,8,2030,0,47.3542,2030
720001.0,3,2.5,1430,0,7,1430,0,47.6601,1740
313950.0,3,1.0,1510,0,6,860,650,47.6966,1510
415000.0,3,1.0,1510,0,6,860,650,47.6966,1510
305000.0,3,1.75,1610,0,8,1610,0,47.4476,2010
625000.0,3,1.5,1600,0,8,1250,350,47.6122,1540
490000.0,3,1.0,1420,0,7,1420,0,47.5969,1530
269950.0,3,2.0,1660,0,8,1660,0,47.3663,1490
2700000.0,5,4.0,4230,4,8,3230,1000,47.6803,2660
829000.0,4,3.0,3310,0,9,2910,400,47.6594,1440
635000.0,4,2.5,2470,0,7,2470,0,47.5888,2490
217500.0,3,1.0,1040,0,7,1040,0,47.4553,1510
270000.0,4,1.75,1850,0,7,1050,800,47.3413,1450
1245000.0,3,3.0,4610,2,8,2790,1820,47.5854,2160
480000.0,4,2.5,2480,0,8,2480,0,47.7383,2270
575000.0,3,1.75,2130,2,8,1170,960,47.6424,2020
426950.0,4,2.75,2350,0,7,2350,0,47.5098,2014
125000.0,3,1.0,920,0,6,920,0,47.2892,1010
208000.0,3,1.0,920,0,6,920,0,47.2892,1010
325000.0,4,2.0,1780,0,7,900,880,47.4573,1550
597157.0,7,4.0,2690,0,8,2690,0,47.6787,1840
728725.0,4,2.5,3010,2,8,3010,0,47.5539,2140
708000.0,5,2.0,3180,0,8,1910,1270,47.6354,2440
1300000.0,4,3.0,4120,0,11,4120,0,47.5985,4390
405000.0,3,1.0,1280,0,7,1280,0,47.6827,1320
550000.0,4,2.75,1690,0,7,1400,290,47.6814,1820
451000.0,4,2.5,2320,0,7,2320,0,47.5415,2060
540500.0,5,3.75,3090,0,8,3090,0,47.435,2790
1025000.0,5,3.5,5050,2,11,5050,0,47.5863,4570
218000.0,4,1.0,1640,0,7,950,690,47.2974,1360
562000.0,4,2.25,2170,0,8,1540,630,47.672,2040
401500.0,4,2.5,3140,0,8,2280,860,47.4155,1910
196700.0,2,1.0,1090,0,7,1090,0,47.4761,1090
583000.0,3,1.75,1930,0,8,1480,450,47.5624,2320
309900.0,5,2.5,2100,0,7,1400,700,47.3094,2200
485000.0,4,3.0,3110,0,9,3110,0,47.4619,3080
465000.0,3,1.0,930,0,6,930,0,47.5532,1210
595000.0,4,2.25,2050,0,8,2050,0,47.7234,2010
254000.0,3,1.0,1160,0,6,1160,0,47.45,1160
488500.0,3,2.75,1820,0,7,1820,0,47.7481,1950
260000.0,4,2.5,2110,0,8,2110,0,47.4457,2040
166000.0,2,1.0,870,0,6,870,0,47.4955,1350
440000.0,2,1.5,1080,2,6,1080,0,47.7008,2080
375000.0,3,2.0,1260,0,6,1260,0,47.7225,1260
529500.0,2,1.0,900,0,6,780,120,47.6575,1270
338000.0,2,1.0,750,0,6,750,0,47.6995,1470
335620.0,3,2.25,1800,0,8,1340,460,47.3813,2000
464000.0,4,2.25,2220,0,9,1690,530,47.7449,2110
354000.0,2,1.0,1390,0,6,1390,0,47.5232,1290
601000.0,4,3.5,2160,0,8,1660,500,47.6103,1230
285000.0,3,2.25,1840,0,8,1370,470,47.3144,1870
462500.0,2,2.0,1690,0,7,1690,0,47.621,1540
350000.0,4,2.5,2650,0,8,2650,0,47.2739,2340
329000.0,4,1.0,1120,0,7,1120,0,47.7038,1480
312500.0,4,2.5,2500,0,7,1320,1180,47.4292,1460
370000.0,4,2.5,2220,0,7,2220,0,47.4887,2220
399900.0,3,1.75,1260,0,7,1260,0,47.7289,1460
398000.0,3,1.0,1480,0,6,1480,0,47.5498,1200
550500.0,2,1.5,930,2,7,830,100,47.5691,1920
709000.0,3,2.75,2780,0,8,1870,910,47.5632,1700
402000.0,5,2.75,2770,0,7,1700,1070,47.5188,1720
450000.0,3,1.5,1530,0,7,1530,0,47.7467,1800
524000.0,3,2.25,2140,0,8,1440,700,47.6949,2060
800000.0,4,2.75,4600,4,10,2400,2200,47.4626,3740
185000.0,4,1.0,1760,0,7,1230,530,47.4288,1180
365000.0,4,1.0,1760,0,7,1230,530,47.4288,1180
925000.0,4,2.5,3110,0,9,3110,0,47.6833,2850
714000.0,3,1.75,2260,0,8,1520,740,47.5982,2530
495000.0,3,2.0,1460,0,7,1460,0,47.6644,1620
535000.0,3,2.25,2050,0,7,1230,820,47.7258,1760
880000.0,4,2.5,2340,0,8,2340,0,47.5715,2650
150000.0,3,1.5,1230,0,6,1230,0,47.4878,850
554500.0,3,2.25,1880,0,8,1420,460,47.6396,2060
520000.0,3,1.75,1280,0,7,1280,0,47.6871,980
839990.0,4,2.75,3660,0,9,3660,0,47.6845,3625
500000.0,3,2.5,1650,0,7,1650,0,47.683,1650
305000.0,2,1.0,1960,0,6,1960,0,47.2681,1650
247800.0,3,2.5,1580,0,7,1580,0,47.5418,1610
344200.0,4,2.5,2490,0,8,2490,0,47.3875,2690
459950.0,4,2.5,2000,0,8,2000,0,47.7557,2040
229900.0,4,1.75,1550,0,7,1550,0,47.3583,1500
750000.0,4,2.25,2820,1,8,1950,870,47.5881,2890
509000.0,4,2.5,2600,0,9,1840,760,47.7446,2250
680000.0,4,1.0,2200,4,8,1640,560,47.7473,3250
661500.0,5,2.5,2500,0,7,1490,1010,47.6964,1960
370000.0,2,1.0,1270,0,7,1270,0,47.5552,1140
785000.0,4,2.75,2900,0,8,2410,490,47.6431,2620
355000.0,2,1.0,840,0,7,840,0,47.5707,1250
446000.0,4,2.0,1940,0,7,970,970,47.6948,960
830000.0,5,3.5,3490,0,8,3490,0,47.6707,3070
324000.0,3,2.5,1940,0,8,1940,0,47.3654,1940
500000.0,4,2.25,2490,0,8,2490,0,47.7547,2030
745000.0,3,1.0,1390,0,7,1390,0,47.6071,2290
1197000.0,4,2.5,3940,0,8,2620,1320,47.6374,1790
385000.0,2,2.5,1760,0,8,1130,630,47.7335,1760
565000.0,3,2.25,2560,0,8,1510,1050,47.7124,1980
465000.0,4,2.5,2300,0,8,1420,880,47.7671,2010
401000.0,3,3.25,1770,0,8,1770,0,47.7186,1860
385000.0,3,1.75,2310,0,8,1630,680,47.3637,2350
395000.0,3,2.5,2310,0,8,2310,0,47.4512,2230
245000.0,5,1.5,2000,0,6,2000,0,47.4945,960
500000.0,3,2.0,1540,0,7,890,650,47.6103,1540
334000.0,5,1.75,2590,0,7,1750,840,47.435,1820
550000.0,3,1.0,980,0,7,980,0,47.5908,2100
216000.0,3,1.0,1730,0,7,1180,550,47.3644,1830
340500.0,3,2.5,3070,0,8,2510,560,47.5007,2220
375000.0,4,2.25,2100,0,8,2100,0,47.4698,2000
600000.0,3,2.75,2080,3,8,1580,500,47.3632,2175
375000.0,4,1.75,1890,0,7,1250,640,47.7576,1870
536500.0,4,1.75,2000,0,7,1450,550,47.5659,1430
599900.0,3,3.0,3030,0,8,1760,1270,47.4694,2810
750000.0,2,1.5,1110,0,7,1110,0,47.6382,1670
355000.0,3,1.0,1650,0,7,1170,480,47.7695,1690
590000.0,3,2.0,1410,0,7,910,500,47.6826,1330
680000.0,2,1.0,2140,0,7,1070,1070,47.651,1560
429000.0,3,2.5,1860,0,8,1860,0,47.5062,2420
581000.0,2,1.0,1170,0,7,1170,0,47.6784,1560
463800.0,3,1.5,980,0,7,980,0,47.6923,1470
2983000.0,5,5.5,7400,3,13,6290,1110,47.5431,6110
443000.0,5,1.75,1650,0,8,1650,0,47.5955,1740
276200.0,3,2.5,1480,0,7,1180,300,47.3124,1690
630000.0,5,3.5,4060,0,9,2960,1100,47.757,1730
570000.0,3,1.75,1370,0,7,1370,0,47.6714,1560
979700.0,4,2.25,2480,2,10,2380,100,47.6392,3030
730000.0,4,2.5,2030,0,8,1730,300,47.6753,1980
268450.0,5,2.25,2200,0,7,1100,1100,47.3263,1780
490000.0,3,1.75,1770,0,7,1270,500,47.7354,1690
808000.0,3,2.5,2550,3,8,1750,800,47.6992,2180
350000.0,3,1.0,1250,0,7,1250,0,47.7622,1660
695000.0,4,1.75,2390,2,8,1390,1000,47.6956,2210
1228000.0,4,2.5,5730,4,11,4280,1450,47.6052,3310
309950.0,1,1.0,1120,0,7,1120,0,47.5123,2330
134000.0,3,1.0,1270,0,6,650,620,47.4961,1200
645500.0,4,2.5,2390,0,10,2390,0,47.5598,2630
750000.0,3,2.0,1760,0,7,1540,220,47.6479,1760
1399000.0,3,2.5,2560,0,9,2110,450,47.632,2690
344900.0,4,1.75,1820,0,7,1100,720,47.7545,1700
601450.0,2,3.25,1840,0,8,1840,0,47.6595,1910
575000.0,4,2.0,1810,0,8,1700,110,47.6132,1470
405000.0,3,1.75,2470,1,7,1570,900,47.3996,2600
518000.0,4,2.75,2520,0,9,2520,0,47.7344,2330
265000.0,2,1.0,1600,0,7,1600,0,47.7411,1580
180000.0,3,1.0,1280,0,6,1280,0,47.3686,1060
285000.0,3,2.5,1590,0,7,1590,0,47.33,1580
433000.0,3,2.75,2000,0,7,1000,1000,47.4531,1440
399000.0,3,1.75,1780,0,8,1350,430,47.474,2180
565000.0,3,2.5,1700,0,7,1700,0,47.6688,1700
406500.0,3,1.5,1970,0,7,1970,0,47.4703,2240
420000.0,4,1.75,1940,0,7,1090,850,47.5774,1700
965000.0,4,3.5,3290,0,8,2290,1000,47.6788,1790
1375000.0,4,3.5,3500,0,10,2460,1040,47.6848,3160
353950.0,5,2.25,3260,0,8,3260,0,47.314,2070
847700.0,5,3.25,4230,0,10,3860,370,47.5503,2980
185000.0,5,1.0,1590,0,6,1090,500,47.5075,1370
269000.0,2,1.5,1010,0,7,1010,0,47.498,1290
422800.0,3,1.75,1820,0,7,1340,480,47.734,1900
379950.0,2,1.0,870,0,7,870,0,47.5465,1240
525000.0,3,2.0,1620,0,7,1200,420,47.7288,1540
810000.0,4,3.5,3980,2,9,3980,0,47.5574,2220
209950.0,4,1.0,1630,0,6,1630,0,47.3052,1190
439950.0,3,2.0,1230,0,8,1010,220,47.6661,1610
554820.0,4,2.0,3510,2,8,2210,1300,47.4466,2530
359000.0,4,2.5,2160,0,7,2160,0,47.4819,2160
242500.0,3,1.0,1020,0,6,1020,0,47.741,1160
330000.0,3,1.75,1590,0,7,1590,0,47.7617,1600
740000.0,3,2.25,3440,3,10,2190,1250,47.547,3470
630000.0,5,1.0,3020,0,7,3020,0,47.6025,1350
750000.0,3,1.75,2280,3,8,1360,920,47.6985,2280
695000.0,4,2.5,2790,0,9,2790,0,47.6087,2790
109000.0,2,0.5,580,0,5,580,0,47.5135,1570
389000.0,3,1.5,2030,0,7,1080,950,47.4713,2210
447000.0,2,1.0,850,0,6,850,0,47.6684,1630
1200000.0,3,2.0,2480,0,7,2480,0,47.6759,2400
315000.0,3,1.75,1010,0,7,1010,0,47.77,1080
640000.0,3,2.5,2420,0,10,2420,0,47.5595,2500
570000.0,3,2.25,2180,0,9,2180,0,47.6215,2300
495000.0,3,2.75,1830,0,8,1830,0,47.4377,1530
449500.0,5,2.75,2040,0,7,1200,840,47.7289,1530
1084500.0,4,2.75,2640,0,9,1840,800,47.6619,2010
294950.0,2,1.0,1060,0,7,1060,0,47.7414,1530
170500.0,3,1.0,1640,0,7,1040,600,47.3947,2080
312000.0,4,1.0,1190,0,6,1190,0,47.5281,1060
350000.0,3,2.5,2180,0,8,2180,0,47.2688,2090
690000.0,4,2.5,2120,0,9,2120,0,47.5654,2140
375000.0,4,2.5,2210,0,7,2210,0,47.4323,1770
575000.0,4,2.5,2510,0,9,2510,0,47.7699,2600
646000.0,4,2.25,2500,0,8,1600,900,47.5615,2290
239950.0,3,2.5,1560,0,7,1560,0,47.2653,1510
400000.0,5,2.5,2510,0,7,1710,800,47.5422,1270
455000.0,4,1.75,3060,0,8,3060,0,47.744,2180
240000.0,3,2.0,1310,0,7,1310,0,47.3694,1310
3400000.0,4,4.0,4260,0,11,3280,980,47.638,4260
695000.0,3,2.0,2500,0,7,1680,820,47.6813,1550
304950.0,2,1.0,670,0,6,670,0,47.5151,710
650000.0,3,1.75,1840,2,8,1140,700,47.6462,1670
402500.0,3,1.75,1480,0,7,1480,0,47.6966,1480
482000.0,3,2.5,2420,0,7,2420,0,47.5361,2420
655000.0,3,2.0,1820,0,7,1120,700,47.6717,1920
577000.0,5,2.75,1940,0,7,1940,0,47.6704,1940
350000.0,3,2.5,1630,0,7,1630,0,47.4738,1660
415000.0,4,2.25,2520,2,8,1680,840,47.3202,2300
396400.0,4,2.5,2120,0,7,2120,0,47.701,2000
654300.0,3,2.5,2490,0,9,2490,0,47.625,2870
774950.0,4,2.5,3410,0,10,3410,0,47.3602,3350
855000.0,4,2.0,2380,2,8,2380,0,47.5682,2112
1145000.0,3,2.5,2490,0,8,1670,820,47.6403,2310
330000.0,2,2.5,1240,0,7,1240,0,47.5634,1520
290000.0,4,2.25,1900,0,7,1400,500,47.3582,1700
519500.0,3,3.0,2390,0,8,2390,0,47.4545,1540
450000.0,3,1.75,1810,0,7,1400,410,47.7143,1934
3120000.0,3,3.5,4490,4,12,4490,0,47.6997,2710
265000.0,3,1.0,1620,0,7,1620,0,47.5136,2070
359000.0,4,2.5,2640,0,8,2640,0,47.3124,2150
2000000.0,4,3.75,2870,3,10,2510,360,47.6291,2870
1050000.0,4,2.5,3250,2,8,2030,1220,47.6326,2970
402500.0,2,1.0,800,0,6,800,0,47.6588,1310
450000.0,3,1.75,1360,0,7,1360,0,47.6071,1570
262500.0,5,2.25,1950,0,7,1130,820,47.3179,1670
285000.0,4,2.25,1970,0,8,1970,0,47.3132,1790
290000.0,3,2.5,2020,0,7,2020,0,47.4659,2170
752500.0,2,2.5,2280,0,8,2280,0,47.7065,1640
820000.0,4,2.75,3540,0,10,3540,0,47.5945,3540
292000.0,3,2.5,1560,0,8,1560,0,47.4909,1310
213000.0,2,1.0,750,2,6,750,0,47.475,1430
400000.0,4,3.0,2240,0,7,2240,0,47.5124,1060
202000.0,1,0.75,590,0,6,590,0,47.5181,980
484000.0,1,0.0,690,0,7,690,0,47.6429,1690
617450.0,3,2.0,1580,0,7,1080,500,47.6328,1650
250000.0,3,1.0,1040,0,7,1040,0,47.4711,1170
405000.0,5,1.75,1880,0,7,960,920,47.7182,1580
325000.0,2,1.0,1070,0,7,1070,0,47.4734,1300
301350.0,3,3.0,1860,0,7,1040,820,47.5035,1490
425000.0,2,1.75,1550,0,7,1050,500,47.5436,1370
460000.0,3,1.0,1860,0,8,1470,390,47.5327,1770
938000.0,3,2.5,3090,2,10,3090,0,47.5492,3410
348000.0,3,1.75,1720,0,8,1320,400,47.44,2200
435000.0,2,1.0,1260,0,7,1260,0,47.687,1720
227950.0,3,1.5,1120,0,7,1120,0,47.4105,1790
425000.0,2,1.0,1250,0,6,900,350,47.6908,1520
550000.0,3,2.0,1810,0,7,1810,0,47.6859,1518
347500.0,3,2.5,1890,0,8,1890,0,47.3967,2000
397000.0,4,1.75,2020,0,7,1620,400,47.577,1870
410000.0,4,1.75,1790,0,7,1490,300,47.522,1870
780000.0,3,3.5,3190,0,10,3190,0,47.6348,3230
1350000.0,4,3.25,3030,0,9,2700,330,47.6394,1890
476000.0,3,2.25,1630,0,7,1630,0,47.6785,1690
390000.0,3,1.75,1180,0,7,1180,0,47.7426,2780
226500.0,3,2.0,1560,0,7,1560,0,47.3355,1560
495000.0,3,2.0,1340,0,7,1340,0,47.6793,1370
1500000.0,5,3.25,2590,2,9,2590,0,47.545,2780
385000.0,3,1.0,1020,0,6,880,140,47.5436,1800
535950.0,3,2.5,2370,0,9,2370,0,47.54,2990
910000.0,4,2.5,3170,0,10,3170,0,47.6903,3360
465000.0,2,1.0,1120,0,7,1120,0,47.6567,1620
495000.0,3,1.75,1440,0,8,1440,0,47.6276,2190
250000.0,4,2.0,2170,0,6,1470,700,47.3046,1030
1225000.0,4,2.25,3490,0,10,2280,1210,47.6424,2540
400000.0,4,2.25,1970,0,7,1970,0,47.7223,1880
715000.0,4,2.5,2780,0,10,2780,0,47.6374,2980
342000.0,3,2.0,2250,0,8,2250,0,47.2684,1970
420000.0,4,1.75,1340,0,7,1340,0,47.5382,1980
148226.0,3,1.0,1400,0,7,1400,0,47.3123,1600
313000.0,3,1.0,1510,0,7,1010,500,47.4808,1510
150000.0,3,1.0,1320,0,7,1320,0,47.3697,1320
150000.0,2,1.0,820,0,7,820,0,47.5119,1670
230000.0,2,1.0,1080,0,6,1080,0,47.459,1200
389100.0,2,1.0,840,0,7,840,0,47.5489,1340
645000.0,4,2.25,2070,0,8,1360,710,47.6678,2180
310000.0,3,1.0,1520,0,7,990,530,47.4164,1500
351358.0,2,1.75,1210,0,8,1210,0,47.5526,1540
1700000.0,5,2.75,3810,0,10,3810,0,47.6039,2110
1565000.0,4,3.5,5370,0,10,5370,0,47.6003,3780
850000.0,3,2.0,1540,0,8,1540,0,47.6343,2970
470000.0,4,2.5,2310,0,9,2310,0,47.7351,2410
770000.0,3,2.25,1870,0,8,1870,0,47.6537,1690
366000.0,3,1.75,1840,0,8,1340,500,47.474,1940
545000.0,3,2.5,2060,0,8,2060,0,47.567,2230
205000.0,3,1.0,1010,0,7,1010,0,47.2761,1550
405000.0,2,1.0,1020,0,7,1020,0,47.7257,1430
467000.0,4,2.5,2220,0,7,1270,950,47.7428,2220
392500.0,2,1.0,1050,0,7,1050,0,47.5736,1650
901000.0,4,2.75,3030,3,9,2360,670,47.7019,3030
500000.0,3,1.75,1800,0,7,1300,500,47.7264,1800
384950.0,3,2.5,1860,0,7,1860,0,47.776,1870
1700000.0,4,3.5,4070,0,11,4070,0,47.478,3020
245000.0,2,1.0,860,0,7,860,0,47.7503,1100
1165000.0,4,2.25,3080,0,9,3080,0,47.5344,2480
184500.0,3,1.5,1280,0,6,1280,0,47.334,1150
269000.0,2,2.0,1540,0,8,1540,0,47.319,1590
570000.0,3,2.5,1530,0,8,1530,0,47.6181,1530
850000.0,4,1.75,2350,0,8,2350,0,47.5392,2240
209000.0,3,1.0,920,0,6,920,0,47.3647,920
327000.0,4,1.75,1840,0,5,1840,0,47.5209,2160
369500.0,3,1.5,1650,0,7,1100,550,47.7303,1650
440000.0,3,1.75,1760,0,7,1230,530,47.7287,1590
947500.0,4,2.25,3290,0,10,3290,0,47.5639,3170
510000.0,2,1.0,1270,0,7,1270,0,47.6059,2140
385000.0,3,2.0,1600,0,7,930,670,47.7466,1590
370000.0,5,3.0,2670,0,8,1400,1270,47.3211,1890
660000.0,4,1.5,1960,2,7,1960,0,47.6797,1960
729000.0,3,4.25,3300,2,9,2520,780,47.3979,2130
440000.0,3,1.75,2000,0,8,2000,0,47.5882,1820
445000.0,4,2.5,2360,0,8,2360,0,47.369,1730
460000.0,2,1.0,1430,0,7,1430,0,47.7023,2320
516000.0,3,3.0,2330,0,9,1300,1030,47.5982,2330
343888.0,4,2.5,2060,0,7,2060,0,47.4365,2060
500000.0,4,1.75,2240,0,7,2240,0,47.6294,1540
465000.0,5,1.75,2330,1,8,1330,1000,47.4959,2330
302000.0,5,2.25,2180,0,7,2180,0,47.3651,1880
195000.0,2,1.0,1280,0,6,1280,0,47.3007,1020
640000.0,3,2.5,2140,0,8,2140,0,47.6314,2310
502000.0,6,2.5,2890,0,8,1630,1260,47.5886,2730
360000.0,3,2.5,1480,0,8,1480,0,47.7732,1650
290500.0,4,2.5,1680,0,7,1680,0,47.494,1420
248000.0,4,3.0,2163,0,7,2163,0,47.2734,1700
433000.0,4,2.5,2280,0,7,2280,0,47.5115,2280
480000.0,2,1.0,820,0,7,820,0,47.6249,1290
410000.0,3,1.0,1330,0,7,1120,210,47.7211,1920
309950.0,4,2.75,2310,0,7,2310,0,47.3614,1980
253000.0,3,2.0,1290,0,7,1290,0,47.3658,1290
280000.0,3,1.75,1630,0,7,1630,0,47.4863,2090
440000.0,3,1.0,1410,0,7,1410,0,47.6782,1330
333000.0,5,1.75,1240,0,7,1240,0,47.5738,1600
759950.0,3,2.5,3100,0,9,3100,0,47.5882,2250
345000.0,3,2.25,2020,0,7,2020,0,47.4487,1460
350000.0,4,2.5,2500,0,8,2500,0,47.3454,2500
198000.0,2,1.0,790,0,7,790,0,47.459,1430
730000.0,3,1.75,2040,0,7,1340,700,47.5923,2120
266200.0,3,1.5,1430,0,7,1430,0,47.4737,1590
1060000.0,4,2.5,2250,0,8,2250,0,47.5645,2660
95000.0,2,1.0,1070,0,6,1070,0,47.4338,1360
430000.0,3,1.75,1300,0,8,1300,0,47.6236,1700
650000.0,4,2.25,2560,0,7,2560,0,47.7261,1860
379900.0,3,2.5,2190,0,8,2190,0,47.3506,2300
325000.0,2,1.5,940,0,7,860,80,47.7178,1302
455000.0,4,2.25,1740,0,7,1170,570,47.6079,1980
392000.0,4,3.75,2220,0,6,1330,890,47.5574,1490
373000.0,3,1.75,1310,0,7,1310,0,47.7319,1530
951250.0,5,3.0,2710,2,8,1910,800,47.6505,2060
502000.0,3,2.0,1300,0,7,1300,0,47.5736,1520
362500.0,3,2.0,1940,0,7,1940,0,47.4252,1860
525000.0,2,1.0,1080,3,7,1080,0,47.6667,1790
580000.0,4,2.5,2110,0,7,1420,690,47.6964,1890
278000.0,3,2.25,1590,0,7,1170,420,47.4291,1590
422500.0,2,1.0,910,0,7,910,0,47.5536,1450
783200.0,4,2.0,1590,2,7,990,600,47.637,2190
715000.0,4,2.5,3290,0,9,3290,0,47.5994,3240
472217.0,3,2.5,2010,0,8,1390,620,47.5523,1690
244615.0,3,2.5,2060,0,7,2060,0,47.3909,2060
385000.0,3,1.75,1560,0,6,780,780,47.7183,1320
549995.0,3,1.0,1120,0,7,1120,0,47.6712,1300
959900.0,4,3.75,3550,0,11,3550,0,47.5888,4340
510000.0,6,4.5,3300,0,8,3300,0,47.6798,2470
367000.0,3,1.75,2000,3,7,1200,800,47.3579,1580
375000.0,5,3.0,2680,0,8,1810,870,47.4401,1860
500000.0,2,2.25,1290,0,8,1290,0,47.6719,1350
489000.0,2,2.25,1290,0,8,1290,0,47.6719,1350
340000.0,3,2.0,1150,0,7,800,350,47.5552,1060
562000.0,3,1.75,1880,0,7,940,940,47.5793,1930
489950.0,3,2.5,2400,0,9,2400,0,47.7362,2980
652000.0,3,2.25,1920,0,8,1560,360,47.6341,2040
472000.0,4,3.25,4350,0,8,2870,1480,47.3747,2490
333000.0,4,2.5,1910,0,6,1910,0,47.4918,2590
560000.0,3,1.5,2000,0,8,2000,0,47.7061,1890
799000.0,4,3.5,3290,4,10,2220,1070,47.355,2990
860000.0,5,2.25,3480,0,8,3480,0,47.5585,3130
449500.0,4,2.5,2410,0,9,2410,0,47.3109,2780
692500.0,4,3.0,2820,0,10,2820,0,47.5826,2770
925000.0,4,1.75,2710,0,9,1430,1280,47.561,2640
267500.0,3,2.25,2080,0,7,1550,530,47.4198,2080
396800.0,4,2.5,2200,0,8,2200,0,47.7338,2480
220000.0,4,1.5,1180,0,7,1180,0,47.2966,1800
892500.0,3,1.75,2120,1,9,1720,400,47.7665,2240
455500.0,3,2.0,1460,0,7,1460,0,47.6771,1690
743000.0,3,1.75,2110,0,8,2110,0,47.5402,2560
338000.0,4,1.5,1790,0,6,1790,0,47.7501,1660
332000.0,3,1.75,1340,0,7,1340,0,47.5021,1370
563225.0,3,1.0,2460,0,7,1370,1090,47.6268,1680
1150000.0,4,3.5,3760,0,11,3760,0,47.7255,3360
645000.0,2,1.0,1240,0,7,1000,240,47.6634,1480
739000.0,3,2.5,2750,0,9,2560,190,47.693,2370
435000.0,3,2.5,2530,0,9,2530,0,47.7345,2450
995000.0,3,2.25,3200,0,9,2650,550,47.638,2400
520000.0,4,2.75,2020,0,7,1350,670,47.7145,1690
400000.0,4,2.5,3030,0,7,2030,1000,47.2953,2600
440000.0,3,1.75,2350,0,7,1510,840,47.7307,2190
440000.0,3,1.5,1690,0,7,1230,460,47.6955,1690
738000.0,3,1.0,1280,0,7,1280,0,47.6545,2020
250000.0,3,1.5,1170,0,7,1170,0,47.7612,2220
338150.0,4,2.25,2700,0,8,2700,0,47.2087,2420
425000.0,3,2.25,1800,0,7,1280,520,47.7584,1960
883000.0,4,2.5,3670,0,10,3670,0,47.6211,2900
510000.0,3,2.0,2350,0,7,2350,0,47.6609,2270
950000.0,4,1.75,3100,1,9,3100,0,47.5847,3480
435000.0,3,1.0,1120,0,7,1120,0,47.567,1720
415000.0,5,1.5,1900,0,7,1130,770,47.7226,1690
439000.0,2,2.5,1350,0,9,870,480,47.5591,1440
295832.0,5,1.0,1410,0,7,960,450,47.4207,1400
285000.0,3,1.75,1560,0,7,1560,0,47.4088,1550
350000.0,3,1.5,1090,0,7,1090,0,47.703,1540
489000.0,2,2.75,1465,0,7,1050,415,47.621,1480
304500.0,3,2.25,1790,0,7,1390,400,47.3536,1810
288000.0,3,1.5,1300,0,7,1300,0,47.4568,1770
417000.0,3,1.75,1920,0,8,1440,480,47.7606,1820
615000.0,3,3.0,1420,0,8,1040,380,47.6408,1500
730000.0,5,3.5,3760,3,9,2820,940,47.7398,3000
178500.0,2,1.0,930,0,8,930,0,47.3822,1160
300000.0,4,2.0,1580,0,7,1050,530,47.4091,1710
415000.0,4,2.5,2170,3,7,1350,820,47.5073,1880
452500.0,3,1.75,2040,0,8,2040,0,47.4155,2280
1010000.0,4,2.75,3430,4,11,3430,0,47.5364,4080
653000.0,4,2.5,2160,0,9,2160,0,47.5659,2300
715000.0,4,2.25,2060,0,8,1360,700,47.6496,2060
541000.0,3,1.75,1410,0,7,1410,0,47.6695,1820
245000.0,4,1.5,1850,0,7,1850,0,47.3714,1730
547000.0,2,1.0,1370,0,7,1370,0,47.719,1610
750000.0,5,2.75,3330,0,10,1740,1590,47.6318,2780
575000.0,5,2.5,1970,0,8,1570,400,47.7412,1970
216000.0,3,1.75,1310,0,6,1310,0,47.3156,2622
443000.0,3,1.75,1640,0,6,1640,0,47.7061,1580
257700.0,4,2.25,1600,0,7,1600,0,47.3784,1530
278000.0,3,1.0,1230,0,7,1230,0,47.4657,1230
300000.0,3,2.5,2240,0,7,2240,0,47.3364,2619
269100.0,3,2.5,2190,0,8,2190,0,47.2617,2190
402500.0,3,1.0,990,0,7,990,0,47.7648,1820
306888.0,2,1.5,1010,0,7,1010,0,47.5128,1210
795000.0,4,2.5,2920,0,10,2920,0,47.6196,2840
525000.0,4,2.5,2310,0,9,2310,0,47.5197,2310
1050000.0,3,2.5,3470,3,10,2560,910,47.5319,3590
452000.0,2,1.0,1220,0,6,880,340,47.5647,1220
350000.0,3,2.25,1550,0,7,1550,0,47.737,1740
410000.0,4,2.5,2070,0,8,2070,0,47.4915,1250
595000.0,3,1.75,2060,0,7,1180,880,47.6389,1730
499000.0,3,2.5,1690,0,7,1690,0,47.6795,2330
340000.0,4,2.5,2550,0,8,2550,0,47.2614,2550
1065000.0,5,3.25,3370,0,10,3370,0,47.6906,2040
460000.0,4,3.0,2230,0,8,2230,0,47.3577,2060
345000.0,4,2.5,2382,0,8,2382,0,47.2793,2382
280500.0,3,2.25,1620,0,7,1620,0,47.3566,1470
704000.0,3,1.0,1140,0,7,1140,0,47.6822,1800
545000.0,3,2.5,2140,0,8,2140,0,47.4786,2380
335000.0,3,1.5,1900,0,7,1900,0,47.5091,1410
1325000.0,4,3.0,3370,3,10,1860,1510,47.6773,2730
420000.0,3,2.75,2300,0,7,1430,870,47.3293,2070
705000.0,4,2.0,2040,0,7,1160,880,47.6885,2040
274900.0,4,1.75,1840,0,7,1210,630,47.2987,1620
499950.0,4,2.5,2860,0,8,2190,670,47.7735,2860
415250.0,3,1.5,1400,0,7,1400,0,47.7566,1730
222000.0,3,1.0,990,0,7,990,0,47.285,990
375000.0,3,2.0,3120,0,7,2150,970,47.3925,2100
300000.0,3,2.5,1640,0,7,1640,0,47.4016,1850
456700.0,3,1.75,2820,0,7,1540,1280,47.5094,1640
925500.0,3,2.75,1970,3,8,1970,0,47.5374,2140
375000.0,5,2.5,2840,0,8,1470,1370,47.4693,2570
420000.0,3,2.5,2370,2,9,2370,0,47.3803,2450
575000.0,3,2.5,2610,0,8,2610,0,47.7614,2460
335000.0,3,2.0,1340,0,6,670,670,47.5763,1520
428000.0,4,2.0,1300,0,7,1300,0,47.6169,1540
655000.0,4,2.5,3340,0,8,2060,1280,47.7654,2400
738000.0,3,3.0,2630,0,9,2630,0,47.6932,2880
415000.0,5,1.75,1960,0,7,980,980,47.7027,1410
392000.0,3,1.0,1090,0,6,790,300,47.5343,1050
555000.0,2,1.0,1550,0,7,1050,500,47.686,1550
260000.0,3,2.5,1770,0,7,1770,0,47.4339,1550
392500.0,3,1.0,1390,0,6,1390,0,47.567,1350
912000.0,3,2.5,2979,2,11,2979,0,47.5503,3890
135000.0,2,1.0,830,0,6,830,0,47.5057,1170
500000.0,3,2.75,1560,0,7,1400,160,47.7695,2210
238000.0,3,1.5,1360,0,7,1050,310,47.3314,1580
251000.0,4,2.0,1650,0,7,860,790,47.5008,1940
406500.0,2,1.75,1510,0,8,1510,0,47.6647,1740
433495.0,4,2.25,3010,0,9,3010,0,47.3326,2690
265000.0,3,2.25,1510,0,7,1150,360,47.3619,1510
360000.0,3,1.75,1950,0,8,1520,430,47.7187,1950
425000.0,4,1.0,1800,0,7,950,850,47.5729,1290
450000.0,2,2.75,2810,0,7,1510,1300,47.4869,2520
449900.0,3,1.75,1760,0,7,1760,0,47.7708,1400
345000.0,4,2.5,2040,0,8,2040,0,47.5051,2230
612500.0,4,2.0,1690,0,7,1690,0,47.6149,2050
317000.0,3,1.75,1530,0,8,1530,0,47.4435,1850
585000.0,3,1.5,1810,0,8,1310,500,47.6835,1400
455000.0,3,1.75,1180,0,7,1180,0,47.4818,1480
1035000.0,4,4.0,4090,0,11,4090,0,47.7226,4290
497000.0,4,2.25,2250,0,8,2250,0,47.6324,1850
226750.0,3,1.75,1070,0,7,1070,0,47.2803,1520
385000.0,4,2.0,1820,0,7,1220,600,47.7447,1650
205000.0,3,0.75,1080,0,5,1080,0,47.4936,1370
745000.0,4,2.5,2760,0,9,2760,0,47.5845,2810
371000.0,4,2.5,2550,0,8,2550,0,47.3526,2380
545000.0,4,2.5,2080,0,8,2080,0,47.5703,2000
443000.0,3,1.0,1280,0,7,1280,0,47.7321,1390
287000.0,2,1.0,950,0,7,950,0,47.528,1080
194000.0,3,1.0,1050,0,7,1050,0,47.2891,1430
265000.0,3,1.0,1800,0,7,1800,0,47.4922,1230
1135000.0,4,2.75,3840,2,9,2110,1730,47.5606,3500
699950.0,4,3.25,3674,1,9,3674,0,47.4357,3220
433000.0,4,1.0,1710,0,7,1710,0,47.7037,2030
200000.0,2,1.75,910,0,6,910,0,47.3493,1360
289571.0,3,1.5,1340,0,7,1340,0,47.475,1440
440000.0,4,2.75,2340,0,8,1720,620,47.7686,2370
400000.0,3,1.5,1510,0,7,1120,390,47.6119,1700
589000.0,4,2.5,2630,0,8,2630,0,47.5262,1770
850000.0,5,2.25,3100,0,9,3100,0,47.6624,2370
520000.0,3,1.0,940,0,7,940,0,47.6033,1210
555000.0,2,2.25,1370,0,7,1200,170,47.6399,1800
470000.0,3,2.5,2480,0,7,2480,0,47.5297,2480
207000.0,2,1.5,1068,0,7,1068,0,47.753,1078
379750.0,4,2.75,2390,2,8,1620,770,47.3438,2390
709000.0,4,1.75,2170,0,7,1270,900,47.6894,1750
240000.0,3,2.5,1520,0,7,1160,360,47.3186,1580
445500.0,4,1.5,2210,0,8,1650,560,47.4321,1840
1308000.0,5,2.5,3200,3,8,1600,1600,47.6398,2640
210000.0,3,1.5,1160,0,7,1160,0,47.4919,1440
603000.0,4,2.5,2670,0,8,2670,0,47.6066,2820
720000.0,3,2.5,2520,0,10,2520,0,47.6295,2680
92000.0,2,1.0,760,0,5,760,0,47.5045,1040
600000.0,3,1.75,1310,0,7,1310,0,47.6722,1270
725000.0,4,2.5,2750,3,8,1380,1370,47.4938,2460
409950.0,5,2.25,1790,0,7,1270,520,47.7718,1790
515000.0,3,2.5,1790,0,8,1790,0,47.6176,1680
495000.0,4,2.5,2400,0,8,1800,600,47.4485,2440
998000.0,4,2.25,2420,0,9,2420,0,47.5336,2390
630000.0,3,1.75,1710,0,8,1710,0,47.6945,2050
410000.0,3,1.75,2000,0,8,1320,680,47.7734,2000
602000.0,3,2.25,1580,0,8,1580,0,47.5503,2630
750000.0,4,2.75,2310,0,8,1310,1000,47.5515,2820
711600.0,4,3.0,3580,0,10,2370,1210,47.595,2580
1050000.0,4,4.0,4320,0,11,3190,1130,47.5369,4010
700500.0,3,2.5,2560,0,9,2560,0,47.7354,2820
710000.0,4,2.5,3220,1,10,3220,0,47.5326,2650
250000.0,3,2.0,1660,0,7,1010,650,47.3298,1660
350000.0,4,1.75,2420,0,7,1620,800,47.5017,1660
475000.0,7,3.5,2870,0,7,1520,1350,47.7153,1380
200000.0,2,1.0,830,0,6,830,0,47.5604,1150
450000.0,4,2.25,1710,0,7,1040,670,47.719,1780
316000.0,5,2.5,2600,0,7,2600,0,47.4325,2330
310000.0,1,1.0,670,0,5,670,0,47.5342,1050
392000.0,3,1.5,1500,0,7,1500,0,47.4658,1510
521000.0,3,3.25,1460,0,8,1460,0,47.6535,1400
495000.0,2,2.0,1540,0,7,960,580,47.6932,1860
209000.0,3,1.75,1250,0,7,1250,0,47.3364,1340
809950.0,4,2.0,2230,0,9,2230,0,47.5979,2510
400000.0,2,1.75,1800,0,7,1420,380,47.4327,1620
415000.0,4,2.5,2400,0,8,1530,870,47.7749,1710
411000.0,4,2.0,2370,0,8,2370,0,47.2831,2110
825000.0,2,2.0,1830,0,7,1230,600,47.6359,2020
436000.0,3,2.25,1480,0,8,1480,0,47.691,1310
460000.0,4,2.5,2620,0,9,2620,0,47.4357,2760
281000.0,3,1.0,1300,0,6,1300,0,47.524,1020
976000.0,4,1.5,3120,3,8,1660,1460,47.646,2900
485000.0,4,2.5,2400,0,8,2400,0,47.4832,2390
429000.0,3,2.5,1430,0,7,1430,0,47.6258,1480
729000.0,3,2.5,2480,0,9,2480,0,47.5489,2600
625000.0,3,2.5,2280,0,8,2280,0,47.5901,2280
218500.0,3,1.75,1390,0,7,1390,0,47.2766,1550
175000.0,3,1.0,1030,0,7,1030,0,47.3322,1370
442500.0,3,1.0,1120,0,7,1120,0,47.7254,1820
480000.0,3,2.0,1300,0,7,1300,0,47.6728,1670
715500.0,3,2.25,2410,1,8,1540,870,47.6996,2510
432500.0,3,1.75,1470,0,8,1470,0,47.6687,1470
875000.0,5,4.25,4720,0,11,3210,1510,47.6347,3880
605000.0,5,2.75,2910,0,8,2910,0,47.4977,1760
1688000.0,4,4.0,5000,2,12,5000,0,47.55,4560
318000.0,3,2.25,1690,0,7,1090,600,47.4972,1950
311300.0,2,1.0,1000,0,7,1000,0,47.7294,1100
325000.0,5,2.75,2400,0,7,1450,950,47.4683,2400
795000.0,5,3.5,3330,0,9,2610,720,47.5567,2810
558000.0,4,2.25,2060,0,8,1320,740,47.5478,2060
370000.0,4,2.5,3090,0,9,3090,0,47.2902,3610
598850.0,4,2.5,2350,0,8,2350,0,47.6318,2350
515700.0,3,2.5,2180,0,8,2180,0,47.527,2440
458000.0,3,2.5,1870,0,8,1870,0,47.7552,2040
583500.0,3,2.25,3530,0,10,3530,0,47.3823,2960
653750.0,4,2.5,2460,0,9,2460,0,47.7072,2460
299000.0,3,2.5,1650,0,8,1650,0,47.3548,2000
532000.0,5,3.0,3480,0,8,2340,1140,47.4574,2020
819000.0,3,2.75,3176,3,9,2726,450,47.3429,3470
945000.0,4,2.25,2420,4,9,2000,420,47.4884,2400
608700.0,4,2.5,2260,0,9,2260,0,47.643,2400
812000.0,4,2.0,2380,2,8,1310,1070,47.6506,1810
464000.0,5,2.5,3400,0,8,1700,1700,47.7358,1890
950000.0,4,2.5,3770,0,10,3770,0,47.6908,4000
700000.0,4,2.5,2672,0,8,2020,652,47.6955,1720
435000.0,3,1.0,1180,0,7,1060,120,47.6867,1630
229500.0,3,1.5,1810,0,7,1810,0,47.2887,1710
1575000.0,3,3.0,2610,4,8,2610,0,47.4414,2810
265000.0,3,2.25,1450,0,7,1180,270,47.2811,1520
995000.0,2,2.0,1600,0,7,1600,0,47.7344,1950
590000.0,3,2.5,2650,0,8,1680,970,47.7756,2310
740000.0,4,2.75,2490,2,9,1490,1000,47.7206,2640
360000.0,2,0.75,850,2,6,550,300,47.5588,2500
548500.0,4,2.0,1820,0,7,1300,520,47.5161,1770
599000.0,3,1.75,1960,0,7,1090,870,47.6746,1960
615000.0,3,1.75,2350,0,8,1800,550,47.6095,2040
292000.0,3,1.75,1320,0,7,1320,0,47.4838,1070
899000.0,4,2.5,3720,0,10,3720,0,47.6651,3220
500000.0,3,1.5,2210,0,7,1030,1180,47.5434,1750
580000.0,3,2.5,1910,0,8,1910,0,47.6213,2230
580000.0,4,2.5,2840,0,9,2840,0,47.7386,2790
594000.0,3,1.0,1320,0,7,1090,230,47.6674,1700
500000.0,3,2.5,2440,0,7,1420,1020,47.6966,2060
550000.0,4,2.5,2420,0,8,1680,740,47.5748,2160
275000.0,3,1.75,1180,0,8,1180,0,47.3531,1580
390000.0,3,2.25,1820,0,8,1820,0,47.4368,1900
1250000.0,3,3.0,3760,3,10,3060,700,47.5815,2610
250000.0,3,2.25,1560,0,7,1560,0,47.4989,1560
405000.0,2,2.5,1790,0,8,1790,0,47.6606,1700
213950.0,3,1.0,1430,0,6,1430,0,47.3018,1050
232000.0,3,1.5,1390,0,7,1390,0,47.3984,1740
207000.0,3,1.0,990,0,6,990,0,47.293,1060
310000.0,3,1.75,1880,0,8,1880,0,47.3515,2260
540000.0,3,2.5,2520,0,9,2520,0,47.5664,1130
750000.0,4,1.5,2060,2,7,1580,480,47.6857,1160
392500.0,4,2.5,2150,0,8,2150,0,47.5109,1940
305000.0,5,2.5,2500,0,8,1690,810,47.3335,2130
735000.0,3,2.5,2390,0,9,2390,0,47.6617,2360
575000.0,4,2.5,2400,0,8,2400,0,47.6187,2120
175000.0,2,1.0,660,0,6,660,0,47.5664,1000
291000.0,4,2.5,1580,0,7,1580,0,47.3768,1590
791500.0,4,2.5,3250,0,10,3250,0,47.5862,3240
475000.0,3,2.0,1880,0,8,1180,700,47.7497,1780
238950.0,2,1.0,1190,0,7,1190,0,47.5012,1410
470000.0,3,3.5,1280,0,8,1040,240,47.6721,1280
420000.0,4,1.75,2380,0,8,1610,770,47.6262,2540
440000.0,3,2.5,2040,0,8,2040,0,47.4876,2150
656000.0,4,1.75,1440,0,8,1290,150,47.6846,1640
559950.0,3,2.5,2120,0,7,2120,0,47.687,2280
600000.0,2,2.0,990,0,6,990,0,47.604,1650
255000.0,3,1.0,1710,0,7,1710,0,47.2616,1310
210750.0,4,1.5,1840,0,7,1840,0,47.5185,1510
485000.0,4,1.0,1150,0,7,1150,0,47.6368,1890
390000.0,3,2.5,2250,0,8,2250,0,47.3667,2180
405000.0,3,2.5,2460,0,8,1810,650,47.473,1820
462500.0,4,1.0,1540,0,7,1540,0,47.587,1920
435000.0,4,2.25,2210,0,8,1630,580,47.4774,2340
440000.0,3,2.5,1440,0,7,1440,0,47.6818,1560
299950.0,3,1.75,1790,3,9,1790,0,47.3213,2540
440000.0,2,1.5,1120,0,8,1120,0,47.6175,1120
312620.0,3,2.5,1260,0,7,1260,0,47.4442,1430
372500.0,3,1.5,1180,0,7,800,380,47.6337,1280
297262.0,3,2.5,1730,0,8,1730,0,47.2619,1780
735000.0,4,3.0,2250,0,7,1250,1000,47.6045,1960
430000.0,3,1.5,1550,0,7,1550,0,47.7072,1820
241000.0,2,1.75,1070,0,7,1070,0,47.7131,970
201000.0,3,1.0,1460,0,7,1460,0,47.3242,1270
570000.0,2,1.0,1060,0,7,1060,0,47.6731,1770
538000.0,4,1.75,1840,0,7,1220,620,47.6579,1770
729000.0,3,2.5,2440,0,8,2440,0,47.7057,2690
331500.0,4,1.75,1700,0,7,850,850,47.5762,1680
110700.0,2,1.0,680,0,6,680,0,47.469,1340
245000.0,3,2.0,1700,0,7,1700,0,47.2077,1350
427000.0,3,1.75,2000,0,7,1360,640,47.7676,1830
650500.0,4,1.75,2340,0,8,1290,1050,47.6789,1930
335900.0,2,1.0,1120,0,7,1120,0,47.7405,1170
535000.0,2,2.0,1510,0,7,1510,0,47.6415,1470
360000.0,5,2.0,2120,0,6,1080,1040,47.5979,1690
294900.0,3,2.25,1500,0,7,1210,290,47.4632,1600
460000.0,2,1.0,1030,0,7,1030,0,47.6828,1420
1769000.0,4,3.5,5440,0,12,5440,0,47.6605,4830
463000.0,2,1.0,1150,0,7,1150,0,47.6226,1240
332000.0,5,1.5,2420,2,8,1500,920,47.208,1620
199500.0,4,2.0,1750,0,5,1750,0,47.5097,1440
247000.0,4,2.0,1750,0,5,1750,0,47.5097,1440
442500.0,4,2.5,2170,0,8,2170,0,47.7346,2240
600000.0,3,2.0,2540,0,9,2540,0,47.2688,2200
449000.0,3,2.5,1690,0,7,1690,0,47.6768,1690
725000.0,4,1.0,1600,0,7,1600,0,47.6804,1720
215000.0,3,1.0,1060,0,7,1060,0,47.4604,1310
582500.0,2,1.75,1990,0,7,1170,820,47.7,1640
305000.0,4,2.25,2210,0,8,2210,0,47.3634,2300
734000.0,4,2.75,3090,2,8,2340,750,47.3622,2760
300000.0,3,2.0,1050,0,7,1050,0,47.7341,1130
525888.0,5,1.75,2550,0,7,1810,740,47.4845,2170
711000.0,4,2.5,2095,0,8,1295,800,47.5838,1980
360000.0,3,1.75,1520,0,8,1220,300,47.7516,1860
357000.0,5,2.5,2750,0,8,2750,0,47.419,1650
235000.0,3,1.75,1200,0,7,1200,0,47.314,1200
550000.0,3,1.75,1830,1,7,1150,680,47.5511,3380
324000.0,3,1.0,1160,0,7,1160,0,47.7675,1620
420000.0,3,2.0,1750,0,8,1410,340,47.7583,1720
450000.0,4,2.5,2400,0,8,2400,0,47.4881,2400
825000.0,5,3.5,4140,0,9,3030,1110,47.5381,3960
272000.0,4,2.25,2115,0,7,2115,0,47.285,2440
481000.0,3,2.0,2580,0,9,2580,0,47.4561,1920
500000.0,3,1.0,1220,0,7,1060,160,47.6775,1350
448000.0,2,1.5,1630,0,7,890,740,47.6711,1770
480000.0,2,2.0,1350,0,8,1350,0,47.718,1350
475000.0,3,2.5,1690,0,7,1690,0,47.6802,1690
472500.0,2,2.25,1700,0,8,1700,0,47.547,1700
291000.0,4,2.25,1890,0,8,1260,630,47.3275,1890
294000.0,2,1.0,850,0,7,850,0,47.731,1440
1013050.0,4,2.5,2480,0,9,1820,660,47.6344,2910
442500.0,3,2.5,1690,0,7,1690,0,47.6875,1690
170000.0,2,1.0,810,0,6,810,0,47.3286,820
1582500.0,4,2.5,3980,1,10,2480,1500,47.639,3980
665000.0,3,2.25,2580,0,8,1780,800,47.5778,2300
1610000.0,5,4.5,6085,0,11,6085,0,47.6085,4830
675000.0,2,1.75,2140,0,7,1000,1140,47.6284,2250
279900.0,2,1.75,1360,0,6,1360,0,47.7421,1430
875000.0,4,1.5,1800,0,8,1800,0,47.6605,1800
571000.0,3,2.5,1920,0,8,1920,0,47.5538,2190
320000.0,3,1.0,860,0,7,860,0,47.7062,880
525000.0,3,2.5,2340,0,9,2340,0,47.3988,2630
1650000.0,8,2.75,4040,0,9,2020,2020,47.634,3670
137900.0,3,1.75,1160,0,6,580,580,47.503,1730
440000.0,3,2.25,1680,0,8,1680,0,47.4669,1910
360000.0,3,1.0,1280,0,7,640,640,47.6163,1280
271000.0,4,1.5,1800,0,7,1800,0,47.4664,1370
465000.0,6,3.25,4250,3,10,2150,2100,47.34,3370
280000.0,4,2.5,2400,0,8,2400,0,47.3358,2230
283000.0,2,1.0,940,0,5,940,0,47.698,1490
411500.0,3,1.0,1110,0,7,1110,0,47.6979,1440
282000.0,3,2.25,2420,0,8,1370,1050,47.3112,2150
535000.0,3,2.5,1850,0,9,1790,60,47.6475,1770
554729.0,4,2.5,2020,0,9,1730,290,47.6503,1620
868000.0,4,2.5,2020,0,9,1730,290,47.6503,1620
427000.0,3,2.5,1830,0,8,1520,310,47.4553,2100
455000.0,4,1.75,1920,0,7,960,960,47.7137,1850
595000.0,2,1.75,1280,0,7,1280,0,47.6553,1950
400000.0,4,2.5,3130,0,8,3130,0,47.3446,2470
770000.0,4,2.5,3920,0,10,3920,0,47.5658,3639
742500.0,4,2.75,3100,0,8,2000,1100,47.6158,2130
1250000.0,4,2.5,3220,0,9,1680,1540,47.5697,2990
375000.0,3,2.0,1670,0,8,1670,0,47.4873,2130
1557600.0,4,2.5,2700,0,9,2700,0,47.6463,3790
545000.0,4,2.0,5461,0,9,3265,2196,47.3557,1940
1050000.0,4,3.25,4400,0,11,4400,0,47.5868,4440
1565000.0,3,1.75,2190,0,9,2190,0,47.64,2850
178000.0,4,1.5,1200,0,6,1200,0,47.3024,1200
262500.0,3,1.75,1470,0,7,1470,0,47.4192,1770
730000.0,3,1.75,1650,0,8,1650,0,47.6743,1630
395000.0,5,1.75,1840,2,8,1360,480,47.4508,2250
355000.0,3,1.0,1210,0,6,1210,0,47.6214,990
299990.0,3,2.5,1870,0,8,1870,0,47.2925,2150
1125000.0,4,3.25,3890,0,9,3150,740,47.4125,2180
425000.0,4,2.25,2660,0,8,2660,0,47.4722,2090
349000.0,2,1.0,1150,0,7,1150,0,47.7215,1150
554950.0,4,1.75,1740,0,7,870,870,47.5758,1210
326000.0,6,3.0,2580,0,7,1880,700,47.5549,1510
580000.0,4,1.75,1720,0,8,1420,300,47.6506,2210
699000.0,3,2.5,2740,1,10,1510,1230,47.5585,2840
757000.0,3,2.75,2610,0,7,1630,980,47.6632,2570
335000.0,3,1.75,1400,0,7,1400,0,47.7312,1310
660000.0,3,2.0,2570,0,9,1970,600,47.7318,3070
540000.0,4,2.75,2830,0,8,2830,0,47.4868,2830
320000.0,5,2.25,2630,0,8,2630,0,47.3619,1880
280000.0,3,2.5,1580,0,7,1580,0,47.4431,1650
324000.0,3,2.0,1540,3,7,1540,0,47.495,1570
300000.0,3,1.0,2120,0,7,1060,1060,47.4869,1010
360000.0,3,1.75,1830,0,7,1830,0,47.741,1480
600000.0,3,2.5,2260,0,10,2260,0,47.641,2740
950000.0,4,1.75,2500,0,8,1500,1000,47.5345,3750
599950.0,3,3.25,1830,0,8,1830,0,47.6945,1830
190000.0,4,1.0,1190,0,6,890,300,47.5305,1140
350000.0,4,1.75,2310,0,7,1780,530,47.731,2090
522000.0,3,1.0,1230,0,7,1230,0,47.5616,1230
850000.0,3,2.5,2940,0,10,2940,0,47.5418,3090
308000.0,3,1.0,1010,0,7,1010,0,47.5483,1400
1020000.0,6,2.25,2550,0,7,2550,0,47.6785,1480
397500.0,3,1.0,1480,0,7,1480,0,47.6915,1300
186000.0,3,1.75,1460,0,7,1040,420,47.3199,1460
436500.0,5,3.0,3110,0,8,1790,1320,47.7463,3050
710000.0,3,2.0,2140,0,8,1070,1070,47.6902,1470
1378600.0,5,3.25,3450,0,9,1860,1590,47.6133,2310
450000.0,3,2.25,1960,0,7,1960,0,47.6319,1540
375000.0,4,2.75,1890,0,7,980,910,47.5528,1600
315000.0,2,1.0,2080,0,7,1040,1040,47.4858,1920
467500.0,3,1.0,1700,0,7,1700,0,47.5569,1400
330000.0,3,1.0,1140,0,6,1140,0,47.527,1140
665000.0,3,2.5,3136,0,8,3136,0,47.3999,2300
760000.0,4,3.25,2590,0,9,2590,0,47.6259,2590
469000.0,3,1.75,1480,0,8,1000,480,47.5493,1480
408000.0,3,3.0,1500,0,8,1120,380,47.6063,1720
851000.0,3,2.75,2660,4,8,1330,1330,47.5868,2820
410000.0,2,2.0,1350,0,8,1350,0,47.7192,1440
235000.0,2,1.0,860,0,6,860,0,47.5662,950
207100.0,2,1.0,1000,0,6,1000,0,47.4896,980
560000.0,4,2.5,2480,0,7,1510,970,47.7638,1770
903000.0,3,2.75,3860,0,10,3860,0,47.549,2820
998500.0,3,1.75,2140,0,8,1690,450,47.6311,2440
268500.0,4,1.75,1820,0,7,1120,700,47.3743,1810
494950.0,2,1.75,2220,0,8,2220,0,47.7403,2220
1130000.0,4,2.5,2660,0,9,2660,0,47.5894,3290
250000.0,3,2.0,1470,0,6,1470,0,47.3734,1470
449000.0,4,1.75,2350,0,7,1250,1100,47.4816,2180
1225000.0,3,2.25,2980,0,9,2530,450,47.6336,3020
325000.0,4,2.0,1870,0,8,1870,0,47.4619,2270
506000.0,5,3.0,2430,0,7,1370,1060,47.603,1770
751000.0,4,2.5,2790,0,9,2790,0,47.5349,2990
280000.0,3,2.5,1370,0,7,1370,0,47.4469,1580
1120000.0,4,2.25,4470,0,11,4470,0,47.7289,3210
580000.0,3,1.75,2040,0,8,2040,0,47.6536,2260
665000.0,4,2.25,2340,0,8,1700,640,47.6202,1890
450000.0,4,2.5,2520,0,7,2520,0,47.7233,2130
389900.0,4,1.0,1710,0,6,1710,0,47.4497,1940
427000.0,3,1.0,1200,0,7,1200,0,47.6075,1800
265000.0,3,1.75,1330,3,7,1330,0,47.4403,1870
398000.0,3,1.5,1310,0,7,1310,0,47.5879,1310
354000.0,6,3.5,3020,0,7,3020,0,47.498,900
339950.0,4,2.5,2260,0,8,2260,0,47.3642,2260
399000.0,2,1.0,790,0,6,790,0,47.6844,990
325000.0,2,2.0,970,0,7,970,0,47.7223,1540
998800.0,3,2.0,2250,2,9,2250,0,47.7077,2880
350000.0,4,2.5,1530,0,7,1530,0,47.5766,1340
1000000.0,4,1.75,1780,0,9,1780,0,47.6273,2100
561000.0,3,2.5,2120,0,7,2120,0,47.6811,2370
245000.0,2,1.0,1500,0,7,1190,310,47.7186,1420
570000.0,2,1.0,1500,0,7,1190,310,47.7186,1420
845000.0,4,3.0,2390,0,8,1460,930,47.6857,1670
314500.0,4,2.5,2390,0,7,2390,0,47.3289,1900
650000.0,3,1.75,2920,0,8,1620,1300,47.5491,2890
298000.0,2,1.0,850,0,5,850,0,47.4874,910
500000.0,2,1.0,930,0,7,930,0,47.609,1690
870000.0,4,2.5,3340,1,9,2470,870,47.5858,2110
299000.0,2,1.0,710,0,6,710,0,47.5151,710
527000.0,3,2.25,2240,0,7,1440,800,47.7034,1390
420000.0,3,1.0,1060,0,7,1060,0,47.5941,1470
290000.0,3,2.5,2360,0,8,2360,0,47.2114,2360
1662000.0,4,2.75,3520,4,9,1950,1570,47.525,2450
499990.0,3,1.75,1730,0,8,1220,510,47.6478,2020
315000.0,3,1.75,1170,0,6,720,450,47.5306,1130
425000.0,4,2.25,3680,0,9,3680,0,47.3219,2340
630000.0,3,2.5,2900,0,9,2900,0,47.7731,2570
365000.0,3,1.75,1290,0,7,1290,0,47.7329,1340
774000.0,4,2.75,2010,0,8,2010,0,47.6607,1420
368888.0,3,1.5,1490,0,7,1490,0,47.7739,1180
339500.0,4,2.5,1930,0,7,1930,0,47.3644,1640
344950.0,4,1.75,2240,0,7,1120,1120,47.7466,1440
450000.0,3,2.0,2320,0,8,2320,0,47.4519,1610
814950.0,4,2.75,2990,0,9,2990,0,47.7107,2910
299900.0,4,2.5,2200,0,8,2200,0,47.3482,2200
315000.0,3,2.0,1500,0,7,1500,0,47.4484,1500
880000.0,3,1.75,3860,2,9,1930,1930,47.7431,2960
195000.0,3,1.5,1430,0,7,1030,400,47.3644,1190
910000.0,5,2.75,3750,0,9,3750,0,47.6039,3450
540000.0,5,2.5,3100,0,8,3100,0,47.738,2840
306000.0,3,2.5,1870,0,7,1870,0,47.3992,2090
272000.0,4,2.25,2040,0,8,1580,460,47.3169,2130
1295000.0,5,3.5,3700,0,8,2750,950,47.669,2370
450000.0,3,1.75,3150,1,8,2370,780,47.5571,2740
450000.0,3,2.5,1990,0,8,1990,0,47.7347,2290
310000.0,4,1.0,1740,0,7,1740,0,47.7458,1580
530000.0,2,2.25,2080,0,8,1180,900,47.3628,2590
435000.0,4,2.5,2060,0,7,1560,500,47.764,1760
485000.0,3,2.0,1590,0,7,1590,0,47.7762,2160
690000.0,3,1.5,1760,0,8,1760,0,47.6401,1760
305000.0,4,2.5,1620,0,7,1620,0,47.3661,1580
300000.0,3,1.75,1210,0,7,1210,0,47.4572,1670
289950.0,4,3.0,2040,0,8,1490,550,47.3266,2020
575000.0,3,2.5,2270,0,9,2270,0,47.7388,2580
1820000.0,4,4.5,6640,0,12,6640,0,47.7283,4620
219000.0,3,1.5,1060,0,7,1060,0,47.3229,1440
265000.0,4,3.0,1940,0,7,1940,0,47.7381,1310
1105000.0,5,3.25,3070,0,9,2050,1020,47.6742,2070
200000.0,3,1.0,930,0,6,820,110,47.4802,1220
545000.0,4,2.75,2180,3,7,1210,970,47.4961,2240
378000.0,3,2.5,2130,0,8,2130,0,47.4623,2130
388000.0,2,1.75,800,0,6,800,0,47.5559,1090
425000.0,4,2.25,2200,0,7,1250,950,47.753,1750
536000.0,2,1.5,1130,0,8,1030,100,47.6684,1520
1175000.0,3,2.5,1970,4,8,1100,870,47.5495,3030
629950.0,3,2.5,1680,0,9,1120,560,47.6425,1610
465000.0,4,1.75,1470,0,7,980,490,47.7048,1970
545000.0,4,2.25,2390,0,8,2390,0,47.7566,3200
592000.0,4,2.5,2300,0,8,2300,0,47.5794,2170
446000.0,4,2.0,2280,0,7,1140,1140,47.4067,2580
375000.0,3,2.5,1330,0,8,1330,0,47.6836,1330
632500.0,5,2.5,2640,0,7,2640,0,47.6827,2640
459950.0,4,1.75,2430,0,8,1780,650,47.7687,2340
485000.0,4,2.5,2470,0,9,2470,0,47.3064,2990
255000.0,3,1.0,1440,0,7,1440,0,47.4742,1580
251750.0,3,2.0,1320,0,7,1320,0,47.3947,1540
725000.0,3,2.5,2810,0,8,2810,0,47.6077,2860
460000.0,3,3.25,1370,0,8,1370,0,47.6704,1320
625000.0,3,2.5,2000,0,8,1040,960,47.5639,2030
530000.0,3,1.75,1980,0,8,1980,0,47.6398,2120
394950.0,3,2.5,2050,0,8,2050,0,47.4808,2140
324950.0,4,1.75,2320,0,7,1160,1160,47.4909,2130
330000.0,3,2.25,1960,0,7,1750,210,47.5417,1760
220000.0,4,1.75,1910,0,7,1910,0,47.35,1910
685000.0,3,3.25,2030,0,8,2030,0,47.6478,2450
500000.0,3,2.25,2210,2,8,1730,480,47.7729,2390
368000.0,4,2.75,2610,0,7,1360,1250,47.4435,1600
825000.0,3,2.25,2520,0,9,1550,970,47.6704,2520
660000.0,6,1.75,1840,0,7,1060,780,47.6041,1680
253000.0,3,1.75,1570,0,7,1570,0,47.4117,1900
392500.0,4,2.75,2400,0,7,1320,1080,47.3616,2470
605000.0,3,1.75,1930,2,9,1930,0,47.77,2100
215000.0,3,1.0,1160,0,6,1160,0,47.3634,1200
650000.0,4,2.5,2820,0,9,2820,0,47.7255,2440
877500.0,4,2.0,3060,0,8,2040,1020,47.5795,2730
232500.0,3,1.0,1320,0,6,880,440,47.3278,1320
234000.0,2,2.0,1200,0,6,1200,0,47.349,1360
380000.0,3,1.75,1560,0,7,1250,310,47.4016,2000
420000.0,5,2.25,3070,0,9,2730,340,47.3238,1560
399950.0,3,1.0,1040,0,7,1040,0,47.6738,1370
256750.0,3,2.5,1990,0,7,1570,420,47.3939,1920
535000.0,3,2.5,1690,0,8,1690,0,47.5647,1860
515000.0,3,2.0,1810,0,9,1810,0,47.6112,1760
770000.0,4,1.75,2520,0,7,1640,880,47.6317,2110
256000.0,3,2.5,1570,0,7,1090,480,47.3327,1570
489900.0,3,1.0,1680,0,7,1680,0,47.7011,1620
165000.0,3,1.5,1250,0,7,1250,0,47.3678,1250
220000.0,3,1.5,1280,0,7,1280,0,47.3947,1450
575000.0,4,2.5,4620,0,11,4620,0,47.2929,3640
375000.0,3,2.5,1580,0,7,1580,0,47.7611,1510
422250.0,3,1.75,1650,0,8,1300,350,47.7733,1760
420000.0,3,1.75,1660,0,8,1380,280,47.7601,2030
608000.0,4,2.5,2410,0,8,2410,0,47.6329,2350
620000.0,3,2.25,1720,0,7,1450,270,47.6683,1410
850000.0,3,2.5,3120,2,9,1940,1180,47.5507,3240
463000.0,4,2.5,2680,0,8,1340,1340,47.5219,2180
750000.0,5,1.75,2640,4,8,1400,1240,47.5022,2400
1070000.0,3,3.25,3730,0,9,3730,0,47.7246,3730
290000.0,3,2.0,1700,0,7,1700,0,47.3781,1700
525000.0,4,1.75,2280,0,7,1250,1030,47.5655,1640
319000.0,3,2.25,1220,0,7,1220,0,47.7151,1220
592500.0,6,4.5,3500,0,7,3500,0,47.7349,1550
350000.0,3,2.5,2010,0,7,2010,0,47.5069,2010
454900.0,3,1.75,2130,0,8,1430,700,47.5326,2130
272000.0,4,2.25,1800,0,7,1800,0,47.2126,1670
357500.0,3,1.0,1070,0,7,1070,0,47.7012,1540
285000.0,3,1.75,1020,0,6,1020,0,47.5332,1360
280000.0,4,2.0,1600,0,7,1600,0,47.2701,1870
477000.0,4,1.5,1380,0,7,1080,300,47.7093,1770
750000.0,3,2.25,3270,0,10,3270,0,47.5197,3220
595000.0,4,2.5,2100,2,7,1400,700,47.6634,2060
525000.0,3,2.25,2110,0,8,2110,0,47.6915,1340
319000.0,3,1.75,1640,0,7,1640,0,47.3944,1850
225000.0,3,2.0,1320,0,7,1320,0,47.3096,1336
485000.0,4,2.5,2420,0,7,1210,1210,47.7397,1750
341000.0,3,1.0,1390,0,6,1390,0,47.6881,1730
674000.0,3,3.25,2320,0,9,1930,390,47.7132,1700
442250.0,3,2.5,2170,0,8,2170,0,47.4833,2240
591000.0,4,2.25,2710,0,8,2710,0,47.77,2590
276000.0,3,2.0,1450,0,7,1450,0,47.3637,2050
394000.0,3,2.5,1370,0,8,1370,0,47.7139,1630
355000.0,3,2.5,1810,0,7,1070,740,47.7364,1740
260000.0,3,2.5,1420,0,7,1020,400,47.3661,2060
300000.0,3,2.75,2090,0,8,1340,750,47.2741,2150
310000.0,3,2.75,2090,0,8,1340,750,47.2741,2150
209000.0,3,1.0,1330,0,7,1330,0,47.3033,1530
344950.0,3,2.0,1330,0,7,1330,0,47.7322,1330
230000.0,5,2.0,1910,0,6,1110,800,47.4975,1150
336950.0,3,1.75,2310,0,8,1410,900,47.3743,2080
700000.0,3,2.75,2500,0,7,1390,1110,47.7032,2040
230000.0,3,2.0,1310,0,7,1310,0,47.3597,1530
443500.0,4,2.5,2040,0,8,2040,0,47.6458,2410
471000.0,4,2.5,2040,0,8,2040,0,47.6458,2410
595000.0,3,2.25,2400,0,8,1400,1000,47.6901,1720
470000.0,3,1.0,1400,0,7,1400,0,47.681,1400
600000.0,4,1.75,1700,0,8,1700,0,47.651,2430
1381000.0,4,3.75,3160,0,10,3160,0,47.5623,2400
427800.0,3,1.75,1340,2,7,1340,0,47.7268,2090
445000.0,4,2.0,1470,0,7,1470,0,47.631,1760
382000.0,3,1.75,1790,0,7,1790,0,47.7442,1560
577000.0,3,1.5,1560,0,7,1200,360,47.619,1560
427000.0,3,2.5,2620,0,8,2620,0,47.4583,3190
255000.0,3,1.0,1580,0,7,1100,480,47.3676,1600
240000.0,3,1.0,1090,0,6,1090,0,47.6503,1040
1234580.0,5,3.25,3240,4,9,2500,740,47.6792,2740
435000.0,4,1.75,2520,2,7,1260,1260,47.4835,2360
1450000.0,3,1.75,2230,0,9,2230,0,47.6204,2230
425000.0,4,3.0,2430,0,8,2430,0,47.356,2000
393000.0,2,1.0,1020,0,6,1020,0,47.5319,1660
264950.0,4,1.0,1810,0,7,1410,400,47.4935,1250
746500.0,4,2.5,3460,0,10,3460,0,47.637,3140
450000.0,3,1.0,2020,0,7,1170,850,47.7136,1480
229950.0,3,2.0,1410,0,7,1410,0,47.427,1410
425000.0,2,1.0,750,0,6,750,0,47.54,1160
2555000.0,4,2.5,5300,2,10,4570,730,47.661,3890
1400000.0,4,3.5,4380,0,11,4380,0,47.7279,4010
753000.0,3,2.25,2290,0,8,2290,0,47.5545,2120
310000.0,2,1.0,720,0,6,720,0,47.5535,980
395000.0,2,1.0,1200,0,6,600,600,47.5357,1270
725000.0,3,2.5,2620,0,10,2620,0,47.7238,2950
295000.0,4,3.0,2120,0,8,2120,0,47.6214,2260
225000.0,3,1.75,1580,0,7,1580,0,47.317,1280
1699000.0,3,3.25,4160,2,12,3690,470,47.5749,3290
431000.0,3,2.25,1830,0,7,1460,370,47.7286,2330
358500.0,3,2.5,2000,0,8,1360,640,47.3724,2530
595000.0,2,1.0,980,0,6,980,0,47.6366,1690
468000.0,4,2.5,3040,0,7,3040,0,47.7245,2670
260000.0,4,1.0,1740,0,7,1020,720,47.467,1600
375000.0,3,2.0,1450,0,7,1450,0,47.7517,1660
295000.0,3,2.5,1560,0,7,1560,0,47.3838,1560
403900.0,4,2.5,2050,2,8,1690,360,47.398,2190
269950.0,3,1.75,1760,0,7,1460,300,47.2868,1450
640000.0,3,3.5,1740,3,8,1310,430,47.6085,1740
221000.0,3,1.0,910,0,7,910,0,47.4345,1160
255000.0,3,1.75,1700,0,7,1700,0,47.355,1690
300000.0,4,2.5,2620,0,7,2620,0,47.3663,2250
270000.0,3,2.25,1500,0,7,1500,0,47.4597,1750
575000.0,4,1.75,1630,0,7,1160,470,47.5674,1640
246900.0,3,1.5,1370,0,7,1370,0,47.3068,1370
635000.0,2,2.5,1390,0,8,1130,260,47.6228,1400
450000.0,3,2.0,1540,0,7,1540,0,47.721,2060
215000.0,3,1.0,1190,0,7,1190,0,47.3248,1200
785000.0,3,3.5,4500,0,10,4500,0,47.3043,4670
522500.0,4,3.0,2370,0,7,1380,990,47.7258,2100
150000.0,2,1.5,1360,0,7,1360,0,47.2857,1360
199950.0,2,1.75,870,0,6,870,0,47.275,1300
3000000.0,4,4.25,4850,4,10,3850,1000,47.7011,3350
379900.0,3,2.0,3110,0,9,3020,90,47.4343,2150
950000.0,4,2.5,3700,0,11,3700,0,47.5427,3580
865000.0,6,2.75,3500,0,8,2430,1070,47.6842,1430
785000.0,3,1.75,1670,0,8,1670,0,47.5754,1900
245700.0,3,2.25,1640,0,8,1180,460,47.3733,1600
951000.0,3,2.25,3400,1,9,3400,0,47.5435,2510
499950.0,3,1.75,2060,0,7,1030,1030,47.5635,1110
257000.0,3,1.75,1330,0,7,1330,0,47.3126,1650
549000.0,3,2.0,2330,0,7,1580,750,47.6025,1750
1600000.0,3,2.75,3040,0,10,3040,0,47.638,2950
1400000.0,5,3.75,3700,4,9,2900,800,47.6865,2860
619000.0,3,2.0,1990,2,8,1430,560,47.5891,1780
311000.0,5,3.0,2020,0,7,1220,800,47.5482,2130
600000.0,5,2.25,2980,0,9,1580,1400,47.7048,2310
1080000.0,4,3.5,3990,0,10,3990,0,47.5641,3230
436000.0,2,1.0,790,0,6,790,0,47.6149,1520
205000.0,2,1.0,1060,0,6,1060,0,47.5088,1390
514000.0,3,2.25,2260,0,7,1450,810,47.7657,2140
530000.0,2,2.5,1900,0,8,1900,0,47.7029,1510
511000.0,5,2.5,3361,0,10,3361,0,47.3427,3112
2100000.0,4,1.75,3550,0,9,3550,0,47.6236,3000
370000.0,5,2.5,2740,0,8,2740,0,47.4042,2900
500000.0,4,1.75,2040,0,7,1020,1020,47.5507,1440
710000.0,4,2.5,4070,0,10,4070,0,47.4433,4070
270000.0,1,1.0,720,0,7,720,0,47.6928,1580
415000.0,3,1.75,2000,0,8,2000,0,47.7535,2000
1800000.0,5,4.5,4400,0,11,3390,1010,47.6232,2150
236000.0,3,1.75,1300,0,7,1300,0,47.3357,1430
278000.0,2,2.5,1420,0,7,1420,0,47.4871,1500
312000.0,3,2.25,1540,0,7,770,770,47.6942,1680
539000.0,3,2.25,1540,0,7,770,770,47.6942,1680
498000.0,3,3.0,2360,1,7,1780,580,47.7142,1970
857000.0,4,3.0,3720,0,9,3720,0,47.6907,1610
780000.0,3,1.75,1690,0,7,1690,0,47.5897,1950
650000.0,3,2.0,2300,0,8,1150,1150,47.6521,2300
559500.0,4,1.75,1650,0,8,1650,0,47.5688,1850
219950.0,2,1.0,990,0,7,990,0,47.5031,1130
671500.0,4,2.25,2130,0,8,2130,0,47.5589,2170
813000.0,4,2.5,3320,0,10,3320,0,47.6247,3040
182000.0,3,2.25,1960,0,7,1290,670,47.3344,1890
203700.0,2,1.0,770,0,6,770,0,47.7534,1500
740000.0,4,1.75,2010,0,7,2010,0,47.6337,2010
230000.0,2,1.0,800,0,5,800,0,47.4693,1500
128000.0,3,1.0,910,0,7,910,0,47.3432,1490
345000.0,3,1.0,1200,0,7,1200,0,47.7367,1330
663000.0,4,2.5,3570,0,7,3570,0,47.5927,2260
329950.0,3,2.5,1820,0,7,1820,0,47.4575,1860
1047500.0,3,2.25,2930,2,9,2670,260,47.6763,2450
402300.0,3,1.75,1480,0,7,870,610,47.681,1350
492000.0,4,2.5,3305,0,7,2245,1060,47.7563,1620
448000.0,4,2.5,2230,0,7,1650,580,47.4799,2090
273000.0,3,1.0,1560,0,7,1560,0,47.4549,1468
335000.0,3,1.0,1030,0,6,880,150,47.5255,1030
695000.0,3,3.75,2380,0,7,1690,690,47.6374,1990
279000.0,3,1.0,1010,0,6,1010,0,47.766,1010
485000.0,2,1.75,2060,0,7,1030,1030,47.6856,1390
383000.0,4,2.5,2370,0,8,2370,0,47.464,1590
490000.0,4,2.5,2242,0,8,2242,0,47.7443,2242
240000.0,2,1.5,1078,0,7,1078,0,47.7532,1078
285000.0,2,1.0,890,0,7,890,0,47.7118,900
524950.0,3,1.5,2700,0,7,2120,580,47.7348,1830
729000.0,4,2.5,2450,0,8,2450,0,47.7177,2630
460000.0,3,1.75,1420,0,7,1420,0,47.6112,2020
687500.0,3,1.5,1280,0,8,1280,0,47.6174,1540
1168000.0,5,2.75,2910,0,9,1780,1130,47.5696,2880
825000.0,4,2.25,2430,0,8,2430,0,47.5563,2390
314950.0,2,2.5,1860,0,7,1860,0,47.3847,1860
470000.0,3,2.0,1800,0,7,1800,0,47.6935,1970
500000.0,3,1.5,1960,0,7,1020,940,47.5765,1760
313000.0,3,1.5,1550,0,6,1550,0,47.4693,1190
445000.0,2,1.0,840,0,7,840,0,47.684,1310
300000.0,4,1.75,2080,0,8,1330,750,47.3749,1790
619500.0,4,2.5,2210,0,8,1480,730,47.5719,1740
305000.0,3,1.5,1210,0,7,610,600,47.5524,1560
874000.0,3,2.5,1350,0,9,1350,0,47.6265,1640
477500.0,3,2.0,1860,0,8,1860,0,47.5706,1950
700000.0,3,2.0,1940,3,7,1090,850,47.6659,1700
515000.0,4,3.5,3400,0,9,3400,0,47.3559,3190
590000.0,4,2.5,2240,0,8,2240,0,47.7125,2010
205000.0,3,1.75,1170,0,7,1170,0,47.3679,1180
310000.0,3,3.25,3130,0,8,2190,940,47.3078,2350
442500.0,2,2.25,1510,0,7,1510,0,47.6264,1510
1078500.0,4,3.5,3740,2,11,3740,0,47.7375,3750
530000.0,4,2.5,2690,0,8,2690,0,47.3843,1500
343500.0,4,1.75,1760,2,7,1180,580,47.5045,1990
334900.0,4,1.75,2180,0,6,1270,910,47.5487,1400
544300.0,4,1.75,1560,0,7,1560,0,47.6707,1510
370000.0,3,2.5,1780,0,7,1780,0,47.7346,1571
245000.0,3,1.75,1260,0,7,1260,0,47.385,1810
535000.0,4,1.75,1570,0,8,1570,0,47.5405,1570
202000.0,2,1.0,740,0,5,740,0,47.4807,1080
490000.0,4,2.25,2020,0,7,1710,310,47.6867,1590
651500.0,4,1.5,1500,0,7,1420,80,47.6893,1480
270000.0,4,2.5,1670,0,7,1170,500,47.4884,1360
1164000.0,3,3.5,3620,0,10,2920,700,47.5646,3680
289000.0,2,1.5,1010,0,7,860,150,47.5659,1190
240000.0,3,1.5,1460,0,6,1460,0,47.3119,1460
790000.0,3,1.75,1790,2,8,1350,440,47.6366,1960
350000.0,3,2.25,1760,0,7,1760,0,47.7466,1810
246950.0,3,3.5,1790,0,7,1480,310,47.542,1150
400000.0,3,1.0,1050,0,7,1050,0,47.5709,1720
533000.0,4,2.5,2590,0,8,2590,0,47.7599,2500
198400.0,3,1.0,1040,0,7,1040,0,47.3631,1290
495000.0,4,2.5,4060,0,9,2790,1270,47.3694,2810
862000.0,4,2.5,3190,0,11,3190,0,47.713,3420
870000.0,4,2.5,3190,0,11,3190,0,47.713,3420
875000.0,4,1.75,2180,0,9,2180,0,47.5359,2560
317000.0,6,3.5,2120,0,7,2120,0,47.4788,1860
325000.0,4,2.75,2110,0,8,2110,0,47.3877,2100
615000.0,2,1.5,1210,0,6,1210,0,47.6793,1570
334950.0,4,2.5,2410,0,8,2410,0,47.2641,2380
775000.0,3,2.5,1980,0,9,1980,0,47.6884,1590
600000.0,4,2.5,2370,0,8,1600,770,47.5564,2050
565000.0,3,1.75,1720,0,7,1270,450,47.649,1130
292500.0,2,1.0,750,0,6,750,0,47.5368,1260
825000.0,3,2.25,2510,0,8,1810,700,47.7003,2510
495000.0,3,2.5,2577,0,8,2577,0,47.2935,2090
525000.0,3,1.5,1540,0,8,1540,0,47.5678,1540
438600.0,1,1.0,720,0,7,720,0,47.6597,1520
507000.0,3,2.25,1810,0,8,1450,360,47.6258,1740
275900.0,3,1.75,1380,0,7,1380,0,47.3117,1540
1170000.0,4,2.5,2570,0,9,2570,0,47.593,2570
275000.0,4,1.75,1690,0,7,1690,0,47.497,1350
355000.0,3,0.75,1420,0,7,860,560,47.6872,1350
233000.0,4,2.0,2130,0,7,1250,880,47.3069,1590
666000.0,3,2.5,3000,0,7,2110,890,47.5781,1970
317500.0,4,2.5,2150,0,7,1360,790,47.4785,1620
420000.0,4,2.0,2280,3,8,1270,1010,47.3594,2280
290000.0,4,2.0,1560,0,6,1560,0,47.4927,1480
320000.0,3,2.0,1880,0,6,940,940,47.5091,2060
650000.0,3,2.5,2320,0,8,2320,0,47.591,2320
325000.0,3,1.75,1010,0,7,1010,0,47.7317,1250
165000.0,3,1.0,1120,0,6,1120,0,47.5109,1050
500000.0,3,1.75,1560,0,8,1560,0,47.5966,2430
443000.0,4,1.5,1860,0,7,1860,0,47.729,1510
213400.0,3,1.5,1150,0,7,1150,0,47.4417,1760
480000.0,4,1.75,1920,0,7,1920,0,47.6344,1580
275000.0,4,2.25,2490,0,8,1460,1030,47.3115,2000
299880.0,3,2.5,1460,0,7,1460,0,47.544,1490
499950.0,3,3.5,1820,0,8,1430,390,47.596,1550
1705000.0,5,3.0,4290,3,9,2480,1810,47.5473,3550
550000.0,4,2.75,2230,0,7,1480,750,47.5246,1760
300000.0,4,2.5,2070,0,8,2070,0,47.3352,2430
920000.0,3,1.75,2480,0,8,1240,1240,47.615,2450
2300000.0,4,3.25,4110,4,12,2720,1390,47.6934,2640
620000.0,4,2.75,2290,0,7,1550,740,47.6793,1460
253500.0,3,1.0,1220,0,6,1220,0,47.2063,1640
978000.0,4,2.75,2620,2,9,1720,900,47.58,3530
387500.0,4,2.5,3190,0,8,3190,0,47.4445,2260
325000.0,3,1.0,850,0,6,850,0,47.7441,1150
568000.0,3,2.5,1740,0,8,1740,0,47.5892,1740
525000.0,4,2.5,2140,0,8,2140,0,47.7173,1690
560000.0,3,2.5,2070,0,8,2070,0,47.5295,2620
394000.0,3,2.5,1680,0,7,1680,0,47.6964,1710
484950.0,2,1.0,1000,2,7,1000,0,47.6753,1830
1295000.0,3,2.75,3340,0,10,2550,790,47.6665,3340
315000.0,3,2.5,1260,0,8,1260,0,47.4914,1310
590000.0,4,2.25,2430,0,9,2430,0,47.7642,2750
106000.0,1,1.0,560,0,5,560,0,47.511,1120
751000.0,3,2.5,3380,0,10,3380,0,47.5275,3630
474000.0,2,1.0,1100,0,7,1100,0,47.6741,2050
189000.0,2,2.0,1700,0,5,850,850,47.3025,1380
440500.0,3,2.5,1600,0,7,1600,0,47.6868,1690
1017000.0,3,2.5,2605,2,9,2090,515,47.6529,2605
589000.0,2,2.0,1850,0,8,1850,0,47.7101,1860
273000.0,3,2.25,1830,0,8,1830,0,47.2642,2160
950000.0,3,3.25,3050,4,8,1650,1400,47.3881,1170
277700.0,2,1.5,1240,0,8,1200,40,47.6104,1410
299900.0,3,2.25,2100,0,7,2100,0,47.3336,1410
235000.0,3,1.0,1250,0,7,1250,0,47.5093,1720
464000.0,2,2.0,1230,0,7,1230,0,47.7145,1560
281000.0,3,1.75,1690,0,7,1690,0,47.314,1980
320000.0,3,1.0,1520,0,7,1520,0,47.7638,1520
282000.0,4,2.0,1890,0,7,1890,0,47.3846,1690
745000.0,4,1.75,1990,0,8,1990,0,47.5639,2620
245000.0,3,1.75,1480,0,7,1480,0,47.2977,1830
250000.0,3,1.75,1480,0,7,1480,0,47.2977,1830
470000.0,3,2.5,2120,0,8,1770,350,47.674,2480
216650.0,3,3.5,1480,0,7,1300,180,47.5421,1140
440000.0,3,1.0,1250,0,7,1250,0,47.7012,1840
590000.0,4,2.5,2010,0,8,2010,0,47.5782,2100
935000.0,5,2.5,3150,0,10,1800,1350,47.6368,3280
848000.0,3,3.5,3010,0,10,3010,0,47.5943,2780
827500.0,5,4.25,3920,0,9,3000,920,47.5492,3000
1125000.0,6,3.0,2880,0,8,2180,700,47.6506,1870
630000.0,2,2.25,2550,0,10,1720,830,47.5304,2560
340000.0,5,1.0,1120,0,7,1120,0,47.7296,1310
570000.0,4,2.75,3140,0,8,1900,1240,47.7086,3170
2750000.0,4,4.0,4130,4,10,2860,1270,47.5968,2980
514500.0,4,2.5,2990,2,9,1740,1250,47.3424,3370
360000.0,2,1.0,1120,3,7,1120,0,47.5397,1880
228900.0,4,1.5,1570,0,7,1570,0,47.4789,980
660000.0,3,2.75,2210,0,8,2210,0,47.6954,2230
647000.0,4,2.5,2390,0,9,2390,0,47.5965,2590
366000.0,3,1.75,1520,0,8,1520,0,47.7687,2080
354000.0,5,1.75,1830,0,7,1060,770,47.5208,1410
850000.0,4,3.5,2640,2,8,2640,0,47.5421,1700
496700.0,3,2.5,1740,0,8,1740,0,47.5783,2080
300000.0,3,2.0,1550,0,8,1550,0,47.4654,1860
390000.0,3,1.0,1040,0,7,1040,0,47.6701,1450
350000.0,3,2.25,1640,0,8,1640,0,47.5948,1830
561000.0,3,2.25,1640,0,8,1640,0,47.5948,1830
475000.0,3,1.75,1260,0,7,1260,0,47.5727,1320
275000.0,3,1.5,1170,0,7,840,330,47.5459,1170
290000.0,3,1.75,1590,0,7,1090,500,47.3621,1540
199000.0,3,2.5,1750,0,7,1330,420,47.352,1670
279900.0,4,2.5,1770,0,7,1770,0,47.3672,1770
1655000.0,4,2.25,3530,0,8,2860,670,47.6618,2840
405000.0,3,2.5,2160,0,7,1360,800,47.7295,2010
615000.0,4,2.25,2360,0,9,2360,0,47.6307,2650
268000.0,3,1.75,1980,0,8,1180,800,47.3104,2090
451000.0,4,1.5,1620,0,8,1620,0,47.7065,1620
850000.0,2,2.75,2700,0,9,2700,0,47.7187,1440
1180000.0,5,2.25,3270,2,9,2470,800,47.5428,3690
245000.0,2,1.0,870,0,6,870,0,47.5256,1120
450000.0,2,1.75,840,0,6,700,140,47.6692,1700
370350.0,3,3.5,1340,2,8,1080,260,47.711,1650
543000.0,3,2.5,1540,0,8,1540,0,47.6498,1500
265000.0,2,2.0,1650,0,6,1650,0,47.5073,1260
497000.0,3,2.5,2630,0,8,2630,0,47.5322,2220
419000.0,4,2.25,1880,0,7,1100,780,47.7731,1790
545800.0,4,2.5,1980,0,8,1980,0,47.579,1770
403000.0,3,1.0,1500,0,7,1000,500,47.6385,1570
195000.0,3,2.0,1230,0,6,1230,0,47.4853,1080
1125000.0,4,2.5,2520,0,8,1670,850,47.6434,2290
255000.0,5,1.75,1970,0,7,1170,800,47.2925,1910
500000.0,2,1.5,1520,0,7,1520,0,47.7131,1440
855000.0,4,2.75,2600,0,8,1300,1300,47.6382,2550
390000.0,4,2.0,2290,0,7,2290,0,47.4678,2140
339000.0,3,2.0,1979,2,7,1329,650,47.3912,1650
1325000.0,4,3.5,2170,0,9,2170,0,47.6828,1950
429900.0,4,1.5,1820,0,8,1190,630,47.521,1890
370900.0,3,1.5,1200,0,7,1200,0,47.7392,1550
457500.0,3,1.0,1210,0,7,1210,0,47.5377,1530
499000.0,4,2.5,1970,0,7,1440,530,47.5949,1760
225000.0,2,1.0,1040,0,7,1040,0,47.2791,1300
615000.0,3,1.75,1920,0,7,1070,850,47.6392,2280
455000.0,2,1.5,1020,0,7,1020,0,47.6774,1138
458000.0,3,1.0,1660,0,7,1060,600,47.7105,1450
580000.0,3,2.25,1670,0,7,1220,450,47.6028,1710
966000.0,5,4.5,3810,0,10,3810,0,47.5915,3390
240000.0,4,1.75,2020,0,7,1010,1010,47.5059,2240
229050.0,1,1.0,420,0,4,420,0,47.5375,1460
328500.0,3,2.25,1390,0,7,1390,0,47.7227,1390
319000.0,3,1.5,2010,0,7,1110,900,47.4738,1900
650000.0,4,2.0,1820,1,7,1640,180,47.6815,2060
398500.0,3,2.5,1630,0,8,1630,0,47.7753,1630
250000.0,1,1.0,800,0,6,680,120,47.4916,1270
815000.0,3,2.0,2270,0,9,2270,0,47.5434,2880
1065000.0,3,2.75,2290,0,9,1950,340,47.6811,2290
510000.0,3,2.25,2750,0,7,1870,880,47.6367,2430
156000.0,2,1.75,590,0,5,590,0,47.545,1360
254500.0,4,2.75,2570,0,8,1720,850,47.258,2420
760000.0,3,2.5,2050,2,9,1600,450,47.759,2930
210000.0,3,2.5,1610,0,7,1610,0,47.3658,1680
349950.0,3,2.5,2140,0,7,2140,0,47.384,1990
676000.0,3,2.0,1730,0,7,1730,0,47.6462,1210
475000.0,4,3.5,2440,0,8,1940,500,47.555,2390
880000.0,4,2.75,3220,0,9,2320,900,47.6713,2310
1209000.0,4,3.25,4330,0,11,4330,0,47.6009,5110
420000.0,3,1.5,1780,4,7,1030,750,47.5168,1780
607000.0,3,1.0,1230,0,7,1230,0,47.5822,2220
475000.0,4,1.75,2160,0,8,2160,0,47.7603,1990
395000.0,2,1.75,1400,0,7,710,690,47.5628,1250
650000.0,4,1.75,1900,0,7,1180,720,47.5933,2060
625000.0,5,2.75,2910,0,8,1510,1400,47.48,2160
849000.0,3,3.0,2960,0,10,2960,0,47.7183,2640
429950.0,3,1.5,2010,0,8,1570,440,47.7102,1920
825000.0,3,2.5,3760,0,9,3230,530,47.5489,3080
505000.0,2,1.0,1020,0,7,1020,0,47.6781,1480
265000.0,2,1.0,1290,0,7,1290,0,47.6968,1290
283000.0,3,1.0,890,0,6,890,0,47.5168,1850
560000.0,3,2.75,1620,0,7,1140,480,47.6175,1900
765000.0,4,2.5,3360,0,10,3360,0,47.6373,2980
610000.0,5,2.75,2930,0,9,1520,1410,47.5576,3070
589000.0,3,2.5,2940,0,9,1710,1230,47.6681,2540
192500.0,3,1.0,1080,0,6,1080,0,47.4716,1800
3200000.0,3,3.25,4560,4,11,2760,1800,47.6205,4060
550000.0,3,1.0,1010,0,7,860,150,47.6861,1930
460000.0,2,1.5,1790,0,8,1280,510,47.6871,1540
264500.0,4,2.25,2060,0,7,1200,860,47.314,2110
339000.0,3,1.0,1150,0,6,1010,140,47.5194,1340
950000.0,4,3.5,4030,0,9,4030,0,47.6416,2130
677500.0,3,1.75,2020,0,8,2020,0,47.574,2370
690000.0,4,2.5,2740,0,9,2740,0,47.6123,2780
312000.0,4,2.25,1930,0,7,1430,500,47.4098,1714
840000.0,5,1.75,2500,0,9,1560,940,47.5361,3370
357500.0,3,3.5,2080,0,8,2080,0,47.35,2080
675000.0,3,1.5,1460,2,7,980,480,47.6962,2180
515000.0,3,2.75,3290,0,10,3290,0,47.3052,2600
491234.0,4,2.5,1540,0,8,1540,0,47.5521,1210
290000.0,3,2.0,1310,0,7,1310,0,47.3893,1100
490000.0,4,2.5,2120,0,8,1280,840,47.6743,2350
810000.0,4,2.0,2920,0,8,1520,1400,47.5876,2360
252000.0,3,1.5,1150,0,7,1150,0,47.4752,1220
299999.0,3,2.5,2380,0,8,2380,0,47.2932,2830
400000.0,3,2.75,2220,0,7,2220,0,47.5515,960
530000.0,5,2.0,3020,0,7,1860,1160,47.5207,1380
357000.0,3,2.0,2460,4,7,2460,0,47.3811,2660
365000.0,3,1.75,1820,0,7,1030,790,47.6867,1420
804000.0,4,2.5,2620,0,9,2620,0,47.5634,900
808250.0,3,2.0,1750,0,8,1010,740,47.6419,1750
360000.0,4,2.5,2020,0,7,2020,0,47.401,2090
240000.0,3,1.75,1240,0,6,1240,0,47.3705,1240
335000.0,2,2.0,1380,0,7,1380,0,47.7732,1810
380000.0,3,1.75,1920,0,7,1920,0,47.4544,1560
350000.0,3,1.75,1680,0,7,1070,610,47.7624,1680
194000.0,3,1.0,1400,0,7,1400,0,47.4848,1160
310000.0,3,1.0,1240,0,6,1090,150,47.7636,2090
315000.0,3,1.75,1410,0,7,1410,0,47.6931,1770
258950.0,3,1.75,1440,0,8,1440,0,47.3187,1790
479000.0,2,2.25,1230,0,8,1020,210,47.6192,1230
510000.0,5,1.5,1550,0,7,1550,0,47.6811,1970
400000.0,3,2.0,1760,0,8,1760,0,47.74,1670
1450000.0,4,3.5,5000,0,11,3610,1390,47.554,3850
680000.0,5,2.0,2140,0,7,2020,120,47.6044,1810
1750000.0,6,3.0,3510,0,10,3510,0,47.6263,3450
335000.0,3,1.75,2010,0,8,1500,510,47.373,1200
460000.0,5,2.5,3390,0,8,1750,1640,47.4462,2360
440000.0,4,2.25,2160,0,8,1080,1080,47.5443,1850
412250.0,2,2.0,1300,0,8,1300,0,47.703,1510
185000.0,3,1.5,1280,0,6,1280,0,47.3342,1150
286500.0,3,2.0,1840,0,7,1040,800,47.3106,1600
422000.0,4,2.5,3200,0,7,3200,0,47.367,2610
408000.0,3,2.25,2800,0,9,2800,0,47.3507,2800
306500.0,2,1.0,1390,2,7,1390,0,47.3985,2580
359900.0,4,2.5,2600,0,8,2600,0,47.3451,2610
560000.0,3,2.5,1960,0,8,1960,0,47.6319,2480
259875.0,3,1.0,1250,0,6,1250,0,47.6625,1250
385000.0,3,1.0,1250,0,6,1250,0,47.6625,1250
188000.0,1,1.0,550,0,4,550,0,47.5181,1100
1142000.0,4,3.25,2500,0,8,1960,540,47.632,3670
255000.0,3,1.0,1250,0,6,1250,0,47.4987,1300
1185000.0,4,2.75,3020,0,9,3020,0,47.5866,3060
635200.0,4,1.75,1640,0,7,920,720,47.6766,1300
355000.0,3,1.75,1870,0,7,1870,0,47.445,1350
544000.0,3,2.5,1760,0,8,1760,0,47.6688,1700
402000.0,3,1.5,1320,0,7,1320,0,47.5909,1320
575000.0,4,1.5,1430,0,7,1430,0,47.6606,1500
216000.0,3,1.75,1580,0,7,1580,0,47.3819,1580
1200000.0,4,3.5,4170,0,11,4170,0,47.528,4560
850000.0,4,3.25,3090,4,9,3090,0,47.768,2020
238000.0,3,2.0,1020,0,7,720,300,47.5445,1360
625000.0,4,1.75,2180,0,8,2020,160,47.636,1890
1110000.0,5,3.25,3350,0,8,2510,840,47.6645,1620
820000.0,3,2.5,2510,2,9,2510,0,47.5419,1790
355000.0,3,2.5,1880,0,8,1250,630,47.5401,2030
495000.0,4,1.5,1810,0,8,1210,600,47.726,1830
1300000.0,5,2.5,4170,0,11,4170,0,47.5455,4670
398750.0,3,2.5,2230,0,7,2230,0,47.5801,1310
835000.0,4,2.5,3650,0,9,3650,0,47.7066,3150
705000.0,6,2.75,2830,0,8,1430,1400,47.636,2060
625000.0,4,1.5,2120,0,8,2120,0,47.6024,1830
550000.0,4,2.5,2090,0,8,2090,0,47.6339,2000
540000.0,3,1.5,2600,0,7,1400,1200,47.5659,1320
519000.0,2,1.0,830,0,7,830,0,47.689,1460
311000.0,4,2.5,1975,0,7,1975,0,47.363,1975
305000.0,4,2.5,1900,0,7,1420,480,47.3092,1600
395000.0,4,2.75,2640,0,8,2640,0,47.4242,2520
275000.0,4,1.5,1610,0,6,1010,600,47.3747,1320
450000.0,3,3.25,1770,0,8,1430,340,47.5478,1410
324000.0,2,1.0,1070,0,7,1070,0,47.7307,1490
2795000.0,5,3.25,4590,2,11,3590,1000,47.6453,2920
565000.0,4,1.0,1540,0,7,1540,0,47.6522,1290
373000.0,4,1.75,1590,0,7,1590,0,47.7456,1720
613000.0,2,2.0,1170,1,8,1170,0,47.6402,2160
614000.0,4,2.25,2880,0,8,1920,960,47.7584,2410
595000.0,4,1.75,2510,0,8,1680,830,47.5569,2510
440000.0,2,1.0,1280,0,7,850,430,47.634,1280
425000.0,3,1.5,1570,3,8,1570,0,47.438,2130
407000.0,2,1.0,740,0,6,740,0,47.6929,1800
472000.0,3,1.5,1740,0,7,1740,0,47.5897,1390
472000.0,3,2.5,1180,0,8,1180,0,47.6381,1180
1250000.0,5,2.75,2960,3,9,2160,800,47.7606,2940
412000.0,3,1.75,1880,0,7,940,940,47.5354,1110
717000.0,3,1.0,1150,0,8,1150,0,47.6805,1160
425000.0,3,1.0,1320,0,7,1320,0,47.6131,1510
299999.0,4,2.0,1640,0,6,820,820,47.4791,1640
254000.0,3,2.0,1470,0,7,1470,0,47.3539,1580
178500.0,3,1.0,900,0,6,900,0,47.2883,1460
800000.0,3,1.75,1510,0,8,1230,280,47.6387,1300
420000.0,3,1.0,1440,0,6,720,720,47.696,1280
319900.0,2,1.0,1380,0,7,1380,0,47.7486,1870
350000.0,2,1.5,1150,1,7,1150,0,47.7298,1910
968000.0,6,2.75,3610,4,9,2070,1540,47.5739,2890
491000.0,3,2.0,1250,0,7,1250,0,47.6705,1320
948000.0,3,2.5,3510,0,9,3510,0,47.5635,3510
900000.0,3,2.5,2260,0,8,1700,560,47.6928,1740
270000.0,3,1.75,2840,0,7,1420,1420,47.3516,1650
198000.0,3,1.5,1430,0,7,820,610,47.2927,1430
250000.0,2,1.0,1420,0,7,1420,0,47.4594,1220
615000.0,4,2.5,2120,0,8,2120,0,47.5526,2170
550000.0,3,2.5,2080,0,8,2080,0,47.5723,2210
190000.0,2,2.5,1370,0,7,1370,0,47.4606,1370
629000.0,4,2.25,1900,0,8,1280,620,47.561,2330
434000.0,3,1.75,1660,0,7,1660,0,47.7647,1660
415885.0,3,1.0,1310,0,7,1310,0,47.5301,1120
550000.0,3,2.5,1840,0,7,920,920,47.6557,1780
272000.0,1,0.75,1040,1,7,580,460,47.5078,1560
665000.0,3,2.5,2610,0,10,2610,0,47.7377,3060
510000.0,3,2.0,1990,0,7,1990,0,47.5421,2120
530000.0,3,2.0,3080,0,8,1740,1340,47.4695,2100
355000.0,3,1.0,1200,0,7,1200,0,47.7452,1960
255000.0,4,1.0,1250,0,7,1250,0,47.4258,1260
790000.0,4,2.75,2640,0,10,2640,0,47.6481,2980
695000.0,5,1.75,1790,0,8,1790,0,47.5945,1840
255000.0,2,2.0,1140,0,7,1140,0,47.4351,1130
410000.0,3,2.25,1790,0,7,1380,410,47.7477,2140
650000.0,4,2.75,1910,0,7,1420,490,47.6952,2300
675000.0,4,1.75,1530,0,7,1530,0,47.6529,1650
332888.0,2,2.5,1050,0,8,950,100,47.6018,1350
300000.0,3,1.75,1730,0,7,1130,600,47.3915,1950
320000.0,4,1.5,1100,0,7,1100,0,47.5704,1380
342500.0,5,2.25,2100,0,7,1050,1050,47.4922,2100
752875.0,4,2.5,2800,0,9,2800,0,47.7432,2280
1730000.0,5,3.5,5000,3,10,3410,1590,47.5665,3360
255000.0,1,0.5,880,0,6,500,380,47.5732,1410
244000.0,3,2.5,1470,0,7,1470,0,47.7651,1360
1420000.0,5,3.25,3950,2,10,3430,520,47.6898,2070
218000.0,3,1.0,980,0,7,980,0,47.4892,1430
359000.0,4,1.0,2180,0,7,2180,0,47.7522,1360
840000.0,4,2.75,3040,0,11,3040,0,47.522,3830
900000.0,5,3.75,4130,0,9,3170,960,47.715,4130
205000.0,4,1.75,1850,0,7,1850,0,47.3468,1750
205000.0,3,2.5,1600,0,7,1600,0,47.3904,1410
500000.0,2,1.5,2070,0,7,1370,700,47.5571,2070
510000.0,4,2.5,3180,0,7,3180,0,47.4905,2610
1135000.0,6,4.25,6900,0,9,4820,2080,47.7506,4170
1545000.0,4,2.25,2640,0,7,2080,560,47.6313,1910
210000.0,3,1.5,1920,0,6,1920,0,47.4446,1616
597500.0,3,1.75,2030,0,8,1600,430,47.7112,2910
400000.0,2,1.0,1140,0,6,1140,0,47.2592,1580
412000.0,3,1.0,1660,0,7,1260,400,47.7576,1390
299950.0,2,1.5,1390,0,7,1390,0,47.7274,1340
1081000.0,4,3.0,2490,0,8,1690,800,47.6628,1960
422500.0,4,2.5,2550,0,9,2550,0,47.3979,2630
410000.0,3,2.0,1270,0,6,1270,0,47.6876,1470
1400000.0,4,3.25,2980,3,10,2140,840,47.5933,2200
245000.0,3,2.0,1470,0,8,1470,0,47.3191,1980
720000.0,4,3.0,3550,0,10,2180,1370,47.7533,3170
315000.0,2,1.0,780,0,6,780,0,47.5609,1750
191950.0,2,2.5,1390,0,7,1390,0,47.3081,1390
455000.0,4,2.5,2440,0,8,2440,0,47.5108,2260
523000.0,3,1.5,1260,0,8,1260,0,47.5755,1700
250000.0,3,2.25,1640,0,7,1640,0,47.311,1230
294000.0,3,3.0,1670,0,7,1140,530,47.4881,1010
490000.0,3,2.25,2380,0,8,2040,340,47.6955,1680
310000.0,4,1.0,1030,0,7,1030,0,47.553,1250
265000.0,3,1.5,1560,0,7,1560,0,47.2048,1400
402000.0,4,1.75,1640,0,7,1010,630,47.6933,1680
705000.0,2,2.5,2200,3,8,2200,0,47.2458,2700
589450.0,4,2.5,3190,0,10,3190,0,47.353,3190
219950.0,3,1.5,1200,0,7,1200,0,47.4482,2120
750000.0,3,2.25,2250,0,8,1510,740,47.6741,2240
478000.0,2,1.75,1960,0,7,980,980,47.6531,1650
170000.0,3,1.0,1250,0,7,1250,0,47.4548,1510
489950.0,4,2.25,2640,0,9,2640,0,47.3099,2780
1370000.0,2,2.25,2460,4,9,1930,530,47.6792,2260
319950.0,3,2.5,1700,0,7,1700,0,47.3798,1950
208417.0,2,1.0,840,0,5,840,0,47.5292,830
410000.0,4,2.0,1900,0,6,950,950,47.6767,1230
590000.0,4,2.75,2160,3,7,1080,1080,47.7081,2450
648000.0,3,1.75,1610,0,8,1610,0,47.553,2270
255000.0,3,2.5,1720,0,8,1720,0,47.2624,1720
465000.0,4,2.75,2190,0,8,2190,0,47.7751,2190
622000.0,4,1.75,3020,0,8,1510,1510,47.56,2230
306000.0,3,1.75,1980,0,7,1980,0,47.3745,1630
617000.0,3,2.5,1880,0,7,1880,0,47.657,1230
438750.0,3,1.75,1610,0,7,1610,0,47.7137,1230
1280000.0,4,3.0,3260,0,9,2300,960,47.6314,2410
995000.0,5,3.25,3970,2,9,2970,1000,47.7764,2520
1580000.0,4,2.5,4570,4,12,4570,0,47.7282,3810
635000.0,5,2.75,2620,0,7,1710,910,47.6806,1790
215000.0,3,1.0,1180,0,7,1180,0,47.39,1290
530000.0,3,2.5,1365,0,7,1315,50,47.6776,1360
295000.0,2,1.0,720,0,6,720,0,47.5245,1000
245000.0,3,2.25,1350,0,7,930,420,47.3593,1460
400000.0,6,2.5,3060,0,8,1530,1530,47.4379,2690
303000.0,3,2.75,1850,0,8,1850,0,47.1928,1850
330000.0,3,1.75,1320,0,7,1320,0,47.5695,1160
700000.0,3,1.75,1990,3,9,1990,0,47.7439,2880
126000.0,1,1.0,610,0,5,610,0,47.4865,1090
850000.0,4,1.0,2500,0,7,2500,0,47.6488,2880
405000.0,3,2.0,1440,0,7,1440,0,47.7243,1800
869900.0,6,4.5,2750,0,8,1770,980,47.6883,1860
485000.0,3,1.75,1790,2,8,1790,0,47.5412,1310
400000.0,2,2.0,1050,0,8,720,330,47.6181,1340
299950.0,3,2.5,1780,0,7,1780,0,47.386,3050
585000.0,4,2.5,2200,0,8,2200,0,47.733,2270
495000.0,4,2.0,1720,0,7,1470,250,47.6929,1510
2200000.0,5,4.5,5840,0,12,4570,1270,47.5457,4850
447000.0,3,2.25,1520,0,7,1520,0,47.6273,1530
206000.0,3,1.0,1320,0,7,1320,0,47.312,1320
500000.0,3,1.0,1070,0,7,950,120,47.5627,1090
302500.0,4,2.5,1990,0,8,1990,0,47.3585,1850
1250000.0,4,4.25,4980,3,9,3080,1900,47.6406,2840
391000.0,2,1.0,890,0,6,890,0,47.6966,1690
250000.0,3,2.0,1440,0,7,1440,0,47.3784,1480
435000.0,4,2.5,2440,0,7,2440,0,47.4891,2440
160000.0,4,2.25,1800,0,7,1440,360,47.4874,2400
451000.0,5,3.0,2260,0,7,1330,930,47.7508,1940
206000.0,2,1.0,810,0,6,810,0,47.4882,1090
590000.0,4,2.75,2240,0,7,1540,700,47.5785,1830
695000.0,3,2.5,4560,0,9,3800,760,47.621,2360
350000.0,3,1.5,1550,0,7,1550,0,47.394,1550
1236300.0,5,3.5,3180,0,10,2420,760,47.6423,2060
395000.0,6,2.25,2950,0,7,1700,1250,47.7476,1790
419000.0,5,3.0,2190,0,7,2190,0,47.5049,1440
592350.0,2,2.0,1570,0,8,1570,0,47.709,2165
855000.0,5,3.25,3420,0,9,2620,800,47.5366,3310
771000.0,4,2.5,2420,0,9,2420,0,47.6893,2650
325000.0,3,2.25,1570,3,7,1570,0,47.2377,1570
1850000.0,5,3.25,3680,0,9,2630,1050,47.6341,3050
545000.0,4,1.75,1910,0,7,1210,700,47.5693,1780
615000.0,3,1.75,1780,0,7,990,790,47.5696,1780
625500.0,2,1.0,2160,0,6,1300,860,47.6981,1680
232000.0,3,1.5,1460,0,7,1460,0,47.3182,1510
168000.0,3,1.5,1370,0,6,1370,0,47.4499,2350
238000.0,3,1.5,1370,0,6,1370,0,47.4499,2350
260000.0,3,2.5,1500,0,8,1500,0,47.2625,1720
460000.0,3,1.75,1210,0,7,1210,0,47.5294,1250
900000.0,3,2.5,2850,1,8,1680,1170,47.748,2670
289950.0,3,1.0,1090,0,6,1090,0,47.7562,1060
265000.0,3,1.75,1450,0,7,1450,0,47.3482,1520
465000.0,4,2.25,1820,0,8,1340,480,47.7415,1270
370000.0,3,1.5,1320,0,7,1320,0,47.7126,1380
240000.0,2,1.5,1670,0,7,1670,0,47.4864,1670
232000.0,4,2.0,1440,0,5,1440,0,47.5072,1500
237502.0,3,1.0,980,0,7,980,0,47.5256,1300
1280000.0,4,3.5,4340,0,10,2850,1490,47.6427,1290
957000.0,4,2.25,2860,0,8,1430,1430,47.588,2190
218000.0,3,1.5,1140,0,6,1140,0,47.3684,980
205000.0,3,1.5,1120,0,7,1120,0,47.3632,1260
350000.0,3,3.25,1460,0,8,1130,330,47.5481,1560
256000.0,4,2.5,2050,0,7,2050,0,47.3527,2030
275000.0,3,1.0,1250,0,7,1000,250,47.7289,1310
372000.0,4,2.5,2520,0,9,2520,0,47.3893,2540
688888.0,3,3.25,2580,1,9,1760,820,47.5314,2140
170000.0,2,1.0,1200,0,7,1200,0,47.6337,2150
530000.0,5,2.25,2140,0,7,1070,1070,47.6071,1680
905000.0,4,3.25,3440,0,11,3440,0,47.5429,3580
365000.0,4,2.5,1800,0,7,1080,720,47.5303,1870
312000.0,4,2.5,1790,0,7,1290,500,47.4061,1730
400000.0,2,1.75,1250,0,7,1250,0,47.5242,1250
278750.0,2,2.0,800,0,6,800,0,47.7024,1160
510000.0,3,2.0,1410,0,8,1410,0,47.5718,2690
527700.0,2,2.25,1330,0,8,1330,0,47.6904,1320
740000.0,4,2.75,2890,0,9,2190,700,47.6419,2280
512000.0,4,2.5,2550,0,9,2550,0,47.4836,2840
362000.0,5,2.5,2880,0,8,2880,0,47.3747,1960
225000.0,3,1.0,660,0,5,660,0,47.4842,1320
491500.0,3,2.25,1470,0,7,1470,0,47.5672,1610
429950.0,4,1.75,1700,0,8,1320,380,47.7453,2000
375000.0,3,1.0,1040,0,7,1040,0,47.5765,1280
199400.0,2,1.0,880,0,6,880,0,47.5331,1430
364900.0,4,2.5,2490,2,9,2490,0,47.3831,2650
324950.0,3,1.5,1210,0,7,1210,0,47.5255,980
467000.0,5,2.0,2080,0,6,1040,1040,47.5858,1940
380000.0,3,1.0,1380,0,7,1380,0,47.7134,1190
250000.0,3,2.25,1620,0,7,1620,0,47.4437,1910
700000.0,4,1.0,1680,0,7,1680,0,47.6663,1710
206990.0,3,1.0,1330,0,6,1330,0,47.3174,1300
670000.0,3,1.75,1730,0,7,970,760,47.6662,1640
315000.0,2,1.0,790,0,6,790,0,47.6978,1380
319950.0,3,2.5,2240,0,8,2240,0,47.265,2190
419000.0,3,1.5,1500,0,7,1500,0,47.7741,1630
205000.0,3,2.0,1800,0,8,1800,0,47.2623,2220
335000.0,4,2.5,1980,0,7,1980,0,47.3495,1980
397000.0,3,1.75,1340,0,7,1340,0,47.694,1550
370000.0,2,1.0,750,0,7,750,0,47.6175,1630
330000.0,4,2.25,1790,0,7,1170,620,47.5126,1990
1785000.0,4,3.5,5490,4,12,2910,2580,47.5511,4290
399000.0,3,2.0,1940,0,7,1140,800,47.774,1940
400000.0,4,1.75,2670,4,8,2670,0,47.2585,2190
249900.0,3,2.0,1220,0,7,1220,0,47.3523,1570
717000.0,3,1.5,1310,0,7,1090,220,47.6821,1570
319000.0,4,2.5,1930,0,8,1930,0,47.4016,2280
635000.0,4,3.0,2100,0,8,2100,0,47.6807,1320
355000.0,3,1.0,1180,0,7,1180,0,47.7372,1320
1600000.0,5,3.25,4320,0,12,4320,0,47.5461,4410
585000.0,4,1.75,3140,0,7,2320,820,47.6941,2240
320000.0,3,2.0,2320,0,7,1160,1160,47.5141,1380
305495.0,3,1.75,2110,0,7,2110,0,47.4744,1800
240000.0,4,2.0,1790,1,7,1670,120,47.3965,2440
199950.0,5,2.5,1740,0,7,1740,0,47.3904,1740
1620000.0,4,3.25,3820,0,10,3820,0,47.5837,2440
770000.0,3,3.5,2050,4,9,1750,300,47.4536,2300
255000.0,4,2.25,1680,0,8,1680,0,47.3258,1678
289000.0,4,2.25,1930,0,8,1930,0,47.4501,1930
494500.0,4,3.0,3760,0,8,2470,1290,47.5161,1960
746000.0,3,2.25,2370,0,8,1650,720,47.6366,1960
385000.0,4,3.0,2120,0,8,2120,0,47.4745,2180
688100.0,4,2.5,2370,0,8,2370,0,47.6915,2110
870300.0,4,2.5,2350,0,8,1690,660,47.6605,1750
310000.0,3,1.0,1180,0,7,1180,0,47.7416,1180
500000.0,3,2.5,2270,0,8,2270,0,47.7733,1770
255000.0,3,2.25,1830,0,7,1400,430,47.3925,1960
1475000.0,3,2.75,3910,0,9,1970,1940,47.6324,3480
154500.0,3,1.0,890,0,6,890,0,47.4388,1590
425000.0,3,2.25,1820,0,7,1260,560,47.7241,1850
700000.0,4,2.5,2440,0,10,2440,0,47.561,2490
410500.0,2,1.0,1110,0,6,740,370,47.6436,1590
432000.0,3,2.0,1870,0,7,1210,660,47.7244,1620
530000.0,3,1.5,1240,0,8,1240,0,47.5745,1420
465000.0,3,2.0,1560,0,7,1560,0,47.7294,1970
498688.0,3,2.5,1910,0,8,1910,0,47.5752,1800
573500.0,3,1.0,2200,0,9,1600,600,47.4527,1880
349900.0,4,2.75,2530,0,8,2530,0,47.289,2490
220000.0,3,1.0,1130,0,7,1130,0,47.4965,1460
260000.0,2,1.0,820,0,6,820,0,47.52,1000
290000.0,2,1.0,960,0,6,960,0,47.5554,1210
615000.0,4,1.5,1980,0,8,1780,200,47.584,2250
730000.0,4,3.5,3370,0,10,2250,1120,47.7196,3080
1950000.0,4,3.25,7420,3,12,7420,0,47.4548,5610
332500.0,3,2.25,1800,0,7,1800,0,47.3879,1870
650000.0,5,3.5,3990,0,9,2820,1170,47.741,2750
1400000.0,4,2.5,4070,0,8,3390,680,47.6838,2020
465000.0,4,1.75,1640,0,7,1480,160,47.7649,1440
690000.0,4,3.25,3730,0,10,2460,1270,47.5775,3680
289900.0,3,1.75,1220,0,7,1220,0,47.4492,1640
1620000.0,3,3.5,3490,0,9,2570,920,47.6385,1880
339950.0,3,2.5,1730,0,7,1730,0,47.432,1780
367999.0,4,2.75,3430,0,8,3430,0,47.3183,2090
380000.0,4,2.5,2320,0,7,2320,0,47.3828,2010
440000.0,3,1.75,2030,0,7,2030,0,47.451,1950
975000.0,5,4.0,4850,0,10,4850,0,47.6426,3850
309500.0,3,1.5,1340,0,7,1340,0,47.741,1540
350000.0,3,1.0,1130,0,6,1130,0,47.7359,1180
215000.0,2,2.0,1180,0,6,1180,0,47.3487,1310
254000.0,2,1.0,910,0,6,910,0,47.5253,1460
567000.0,3,1.75,1630,3,7,1630,0,47.6851,1800
402000.0,2,1.0,710,0,7,710,0,47.6412,1370
365000.0,4,1.0,1520,0,5,1520,0,47.4742,1740
625000.0,4,2.5,2820,0,9,2820,0,47.7538,1300
432000.0,4,1.75,1970,0,7,1970,0,47.534,1230
335500.0,5,3.0,2240,0,8,1700,540,47.4416,2280
672500.0,2,1.75,1860,2,8,1020,840,47.5751,2130
336000.0,4,1.0,1780,0,6,1780,0,47.5486,1460
294400.0,4,2.5,1788,0,7,1788,0,47.2883,1700
541900.0,3,2.5,1880,0,8,1880,0,47.6091,1840
505000.0,3,1.75,2300,0,8,1520,780,47.6884,2300
255000.0,3,2.5,1610,0,7,1610,0,47.3657,1680
435000.0,6,2.5,2270,0,7,1470,800,47.7722,2270
636000.0,2,1.75,1230,0,7,1230,0,47.6423,1210
655000.0,4,3.5,3420,0,9,3420,0,47.3554,3420
280500.0,3,1.5,1670,0,7,1370,300,47.4283,1090
520000.0,2,1.0,1120,0,7,900,220,47.6924,1500
354000.0,4,2.5,2580,0,8,2580,0,47.4042,2900
810000.0,5,2.75,3847,2,9,2299,1548,47.3379,2690
400000.0,4,2.5,3630,0,9,2300,1330,47.2617,2830
879900.0,4,2.75,3580,0,10,1840,1740,47.6319,2910
1288000.0,5,4.0,4050,0,10,2780,1270,47.56,3120
902500.0,3,3.5,3240,0,10,2130,1110,47.3388,3180
900000.0,3,1.75,1540,0,7,1540,0,47.6187,1330
419500.0,4,2.5,2550,2,7,2550,0,47.4793,2560
685000.0,4,2.0,2340,0,8,1270,1070,47.6495,1600
429950.0,4,2.5,2320,0,8,2320,0,47.4798,2330
464950.0,4,2.5,1640,0,7,1640,0,47.559,1640
239900.0,2,1.0,910,0,6,910,0,47.4463,1410
406250.0,4,3.25,2550,0,8,2550,0,47.7324,2370
447000.0,4,2.5,2660,0,8,2660,0,47.4831,2480
466800.0,3,2.5,1480,0,7,1480,0,47.6595,1660
674000.0,4,2.5,2810,0,7,1740,1070,47.5846,1970
525000.0,1,1.0,830,0,7,830,0,47.6557,1350
674950.0,3,2.75,3510,0,10,3510,0,47.3735,2970
374900.0,3,2.5,2480,0,7,2480,0,47.4389,2230
1443920.0,4,3.0,3720,0,9,2720,1000,47.6282,2610
559500.0,3,2.25,2150,0,8,2150,0,47.7179,2240
522500.0,3,2.5,2370,0,9,2370,0,47.5427,2660
1130000.0,5,2.5,4310,0,10,4310,0,47.6662,3170
498500.0,5,2.75,2990,0,8,2990,0,47.4944,2290
571000.0,4,1.0,1350,0,8,1350,0,47.6885,1520
543000.0,2,2.0,2370,0,7,1600,770,47.5007,2370
271920.0,3,2.0,1410,0,7,1410,0,47.3315,2090
104950.0,2,1.0,1170,0,6,1170,0,47.497,1820
485500.0,4,2.5,1800,0,8,1800,0,47.5998,1800
1210000.0,4,2.75,3650,2,9,2530,1120,47.6756,3140
260250.0,3,1.75,1490,0,7,1490,0,47.3473,1490
875909.0,4,2.5,3610,0,10,3610,0,47.5868,3000
455000.0,4,1.75,2050,0,7,1250,800,47.4492,2270
309000.0,3,1.0,1092,0,6,1092,0,47.5321,930
229000.0,4,2.25,2010,0,8,1170,840,47.3086,1990
250000.0,3,2.0,1680,0,7,1680,0,47.3255,1250
600000.0,4,2.0,2510,0,9,2510,0,47.7219,3180
535000.0,4,2.5,2280,0,8,2280,0,47.7237,2300
571000.0,3,2.5,2510,0,7,2510,0,47.6895,2530
1030000.0,5,2.75,3190,3,9,1690,1500,47.5641,3100
600000.0,4,3.25,4690,2,10,3680,1010,47.7718,2910
469500.0,3,2.25,1850,0,7,1300,550,47.7408,1580
1150000.0,4,3.0,4160,0,11,3040,1120,47.5182,3780
785000.0,4,1.5,2220,0,8,1970,250,47.6564,1984
872750.0,3,2.5,2870,0,10,2870,0,47.6944,2840
900000.0,4,2.75,3950,3,10,2050,1900,47.6969,3130
350000.0,2,1.75,1740,0,8,1740,0,47.526,1560
2575000.0,5,3.0,4780,0,10,3660,1120,47.6242,4660
940000.0,4,2.5,3160,0,10,3160,0,47.6418,3900
185000.0,5,1.75,1990,0,7,1990,0,47.3325,2240
850000.0,4,3.5,3920,0,10,3920,0,47.6316,2550
201000.0,3,1.0,960,0,7,960,0,47.238,1930
499000.0,2,1.5,1540,0,7,1540,0,47.7189,1470
315000.0,4,2.5,1970,0,7,1970,0,47.515,1840
509950.0,3,2.5,1880,0,8,1880,0,47.5666,2060
286300.0,3,2.75,2000,0,8,1260,740,47.5066,2130
590000.0,3,2.5,1990,0,8,1310,680,47.705,2450
325000.0,4,1.0,1400,0,6,1400,0,47.5166,1600
625000.0,4,2.5,3190,0,9,3190,0,47.3425,2810
378000.0,3,1.5,1000,0,7,1000,0,47.7144,1000
239950.0,3,1.75,1670,0,7,1170,500,47.2975,1740
550000.0,4,2.0,2100,0,7,1060,1040,47.6699,1920
325000.0,2,1.0,1010,0,6,1010,0,47.5532,1560
831000.0,4,2.5,2030,0,7,1630,400,47.6547,2000
249000.0,3,1.0,1090,0,6,1090,0,47.7743,1910
484000.0,4,1.75,2440,0,7,1390,1050,47.7406,1390
395000.0,4,3.0,2500,0,9,2500,0,47.3325,2700
839900.0,4,2.5,3420,0,9,3420,0,47.6388,3080
760000.0,4,2.5,2850,0,8,2850,0,47.6759,1720
750000.0,4,1.5,2030,0,8,1530,500,47.5855,2610
3000000.0,5,3.75,4590,0,11,3450,1140,47.6389,3870
440000.0,3,2.5,2230,0,7,2230,0,47.5308,2230
501000.0,2,1.75,1810,0,8,1170,640,47.5695,2090
739000.0,6,4.5,4000,0,7,4000,0,47.6146,1380
685650.0,3,1.75,1490,0,8,1490,0,47.5919,2070
1005000.0,4,4.5,4225,0,11,4225,0,47.6118,2870
980000.0,4,1.75,2120,0,8,1920,200,47.6601,2300
275000.0,3,1.5,1030,0,7,1030,0,47.5069,1330
319950.0,4,1.75,2310,0,7,1650,660,47.4569,1790
448500.0,3,2.25,1830,0,8,1830,0,47.7466,2100
437000.0,5,2.0,2120,0,7,2120,0,47.4558,2120
330000.0,4,1.5,2500,0,7,1250,1250,47.5212,1640
365000.0,3,2.5,2470,0,8,2470,0,47.4096,2400
329000.0,2,1.0,940,0,6,940,0,47.7067,1290
681500.0,5,2.75,3260,0,8,1630,1630,47.6169,2860
566000.0,3,2.25,1660,0,8,1370,290,47.6889,2100
897500.0,4,3.0,4370,0,10,4370,0,47.6573,2430
738000.0,3,2.5,2620,0,9,2620,0,47.6972,2620
185000.0,3,1.75,1500,0,7,1500,0,47.3141,1490
445000.0,2,1.0,910,1,7,830,80,47.5145,1700
175000.0,3,1.75,1430,0,6,1430,0,47.5388,1550
315000.0,2,1.0,900,0,6,760,140,47.5148,1500
445000.0,4,1.75,1250,0,6,1250,0,47.62,990
1400000.0,5,3.0,3850,0,9,2290,1560,47.6425,3010
832500.0,4,2.5,3450,0,10,3450,0,47.7302,3110
771150.0,4,3.5,3950,0,10,3950,0,47.5414,3920
225000.0,4,1.5,1950,0,6,1950,0,47.4364,1950
389950.0,3,2.5,1700,0,7,1700,0,47.5333,1700
435000.0,3,2.5,2370,0,7,2370,0,47.5288,2690
845000.0,3,1.75,1600,0,7,1600,0,47.6447,1660
1300000.0,4,1.75,4060,0,9,2660,1400,47.6437,3320
350000.0,3,2.25,1322,0,8,1087,235,47.5976,1690
250000.0,3,1.75,1140,0,7,1140,0,47.2598,1280
370000.0,2,1.5,1280,0,7,1080,200,47.5872,1340
750000.0,4,2.5,3080,0,8,3080,0,47.7066,2750
439950.0,2,1.75,1210,0,7,910,300,47.6789,1260
395000.0,4,1.75,1950,0,7,1950,0,47.7492,1500
375000.0,4,1.0,1450,0,6,1450,0,47.7061,1450
263000.0,3,2.25,1590,0,7,1590,0,47.2857,1590
185000.0,3,1.0,1240,0,7,1240,0,47.37,1170
500000.0,3,1.0,1440,0,7,790,650,47.591,2690
920000.0,4,2.5,3470,0,10,3470,0,47.554,4370
936000.0,7,3.75,5100,0,10,3640,1460,47.595,3350
1500000.0,3,1.75,2430,2,8,1340,1090,47.6201,2930
1100000.0,3,2.25,2420,0,8,1420,1000,47.6867,2500
247000.0,3,2.5,1510,0,7,1150,360,47.3482,1810
289500.0,3,1.0,1200,0,7,1200,0,47.6981,1580
432500.0,3,2.5,2240,0,7,2240,0,47.5356,2610
680000.0,3,1.75,1870,0,7,970,900,47.6663,1810
589000.0,3,1.0,1110,0,7,1110,0,47.6496,1420
756450.0,4,2.0,3210,0,7,2040,1170,47.5322,2540
536650.0,3,1.75,2090,0,8,1230,860,47.7149,2310
540000.0,3,2.25,1320,0,7,1320,0,47.6081,2010
385000.0,3,1.75,1340,0,7,1340,0,47.7134,1540
485000.0,3,1.0,1020,0,7,1020,0,47.6787,2370
240000.0,3,2.0,1220,0,7,1220,0,47.4712,1990
415500.0,3,2.0,1220,0,7,1220,0,47.4712,1990
550000.0,3,2.0,1390,0,7,1390,0,47.6783,1440
1260000.0,4,2.0,2970,0,9,2970,0,47.6235,2500
430000.0,2,2.0,1440,0,7,1440,0,47.3604,1630
415000.0,2,1.75,1550,3,7,830,720,47.5274,1920
365000.0,4,2.5,1904,0,7,1904,0,47.3107,1560
257000.0,4,1.5,1400,0,7,1400,0,47.3314,1580
420000.0,3,2.5,2140,0,8,2140,0,47.5541,2860
338995.0,3,1.75,1320,0,7,1320,0,47.4557,1320
615000.0,3,1.75,2620,0,7,1330,1290,47.7235,1530
312500.0,4,0.5,2300,0,8,2300,0,47.3285,1820
513000.0,4,2.5,2000,0,8,2000,0,47.7443,2210
857500.0,4,2.75,2960,3,9,2210,750,47.5747,2270
1060000.0,3,2.75,2700,1,10,2700,0,47.5706,3390
585000.0,3,1.75,1740,3,8,1150,590,47.4919,2110
350500.0,2,2.5,1770,0,7,1770,0,47.3497,1770
215000.0,3,2.0,1290,0,7,1290,0,47.4811,1650
440000.0,4,2.0,1450,0,7,1450,0,47.7285,1450
270000.0,3,2.25,1420,0,7,1130,290,47.3598,1460
385000.0,3,0.75,1330,0,7,1330,0,47.5377,1410
688500.0,3,1.75,1760,3,7,1760,0,47.6748,1760
700000.0,3,1.75,2010,0,7,1230,780,47.6105,2210
585000.0,5,2.0,2560,0,8,1280,1280,47.5547,2200
401000.0,2,1.5,1260,0,7,1260,0,47.6747,1260
655000.0,4,2.25,2420,0,8,1890,530,47.6287,1740
317000.0,3,1.0,1010,0,6,1010,0,47.5746,960
500000.0,4,2.5,1770,0,6,1770,0,47.719,1460
314963.0,2,1.0,890,0,6,890,0,47.6975,1490
715000.0,3,1.5,1670,2,7,1670,0,47.5671,1670
280000.0,3,2.25,1360,0,7,1360,0,47.4687,1200
531000.0,3,2.5,2120,0,9,2120,0,47.7374,2490
617000.0,3,2.5,1910,0,8,1910,0,47.6176,1530
440000.0,4,1.0,1480,0,7,1480,0,47.7079,1480
140000.0,3,1.0,1090,0,7,1090,0,47.2975,1380
661000.0,4,1.75,1670,0,8,1670,0,47.6315,2360
697000.0,4,1.75,1670,0,8,1670,0,47.6315,2360
1195000.0,5,2.75,3650,0,9,2750,900,47.5497,2900
535000.0,4,2.0,1970,0,8,1030,940,47.6873,1650
404500.0,2,2.0,1320,0,6,1320,0,47.5643,1410
396500.0,3,1.0,1710,0,7,1100,610,47.5256,1310
450000.0,3,2.25,1740,0,8,1180,560,47.5339,1880
605000.0,3,3.25,2200,0,8,1740,460,47.6325,2200
699000.0,3,2.0,2010,2,9,2010,0,47.5153,1640
805000.0,3,3.0,3910,0,11,3910,0,47.6953,1860
156000.0,1,0.75,470,0,4,470,0,47.6554,1730
595000.0,4,2.5,2330,0,8,1780,550,47.6955,1740
285000.0,3,1.75,1930,0,6,1930,0,47.5263,1350
725000.0,4,2.5,3270,0,9,3270,0,47.5374,2740
216300.0,3,2.5,1650,0,8,1650,0,47.3206,1720
410000.0,4,2.75,2220,0,7,1260,960,47.4804,1580
597000.0,2,1.75,2470,3,7,1140,1330,47.5599,1790
325000.0,3,1.0,1300,0,7,1300,0,47.7562,1300
355000.0,5,2.75,2530,0,7,1530,1000,47.3738,2250
338000.0,3,1.5,2400,0,7,1200,1200,47.5001,1460
210000.0,4,2.25,1500,0,7,1500,0,47.3378,1700
423000.0,4,1.75,1700,0,7,1700,0,47.7308,1930
249500.0,4,1.5,2120,0,7,1170,950,47.2933,1790
325000.0,4,2.5,2240,0,8,2240,0,47.3922,1920
257000.0,3,1.75,1540,0,7,1070,470,47.3666,1240
550000.0,3,1.75,1890,3,8,1890,0,47.6454,2110
490000.0,3,1.0,1260,0,7,1260,0,47.6773,1760
299000.0,2,1.5,1160,0,7,1160,0,47.7255,1410
295000.0,2,1.0,1300,0,6,1300,0,47.466,1880
630000.0,4,2.5,3220,0,8,3220,0,47.6261,2550
320000.0,4,1.5,2020,0,7,1010,1010,47.4579,1720
1110000.0,4,2.5,2990,0,8,2100,890,47.5932,2270
398000.0,4,1.0,1420,0,7,1420,0,47.6988,1670
218000.0,3,1.0,1020,0,7,1020,0,47.5175,1290
590000.0,4,2.75,2400,0,8,2400,0,47.4686,2270
1595000.0,5,3.0,3640,3,10,2540,1100,47.5842,3330
348500.0,2,2.25,1550,0,8,1550,0,47.5396,1460
592500.0,2,2.0,1870,0,8,1870,0,47.7082,2170
505000.0,3,2.5,2340,0,8,2340,0,47.7347,2340
1430000.0,5,4.25,3350,0,10,2260,1090,47.6351,1810
502000.0,3,1.0,1710,0,7,1140,570,47.5719,1670
257500.0,2,2.0,1180,0,7,1180,0,47.7252,460
405000.0,3,1.5,1600,0,7,1600,0,47.721,1700
427000.0,3,1.75,1300,0,7,1300,0,47.7005,1370
290000.0,3,1.5,1040,0,7,1040,0,47.7583,1040
222000.0,3,1.0,1220,0,7,1220,0,47.5191,1210
315000.0,3,2.5,2240,0,8,2240,0,47.3503,2240
371000.0,3,1.5,1420,0,7,1420,0,47.694,1540
279900.0,3,1.75,1580,0,7,1580,0,47.2798,1580
250000.0,3,1.5,2390,0,7,1890,500,47.4754,2430
599000.0,4,2.25,2260,0,8,1400,860,47.5689,2770
267300.0,3,1.75,1890,0,7,1890,0,47.2568,1690
585000.0,2,1.75,1830,2,7,1070,760,47.5592,1570
350000.0,3,1.75,1000,0,6,1000,0,47.7417,1220
506000.0,3,1.75,2180,0,8,1480,700,47.7594,2180
400000.0,6,2.0,2320,0,8,2320,0,47.398,2540
151100.0,3,1.0,840,0,6,840,0,47.496,1260
251000.0,3,1.0,840,0,6,840,0,47.496,1260
555000.0,4,2.25,2350,0,8,1430,920,47.5579,2640
467500.0,3,1.75,2040,0,7,2040,0,47.4361,1790
479000.0,4,2.5,2370,0,8,2370,0,47.3389,2870
247000.0,5,2.0,1590,0,7,1060,530,47.3398,1460
299500.0,3,1.0,1380,0,7,1380,0,47.4653,1040
306888.0,4,1.5,1940,0,7,1270,670,47.7297,1960
675000.0,4,2.5,3320,0,9,3320,0,47.3637,2530
577000.0,2,1.0,1090,0,7,1090,0,47.6638,2080
219950.0,3,1.5,1650,0,7,1090,560,47.3285,1560
375000.0,3,1.5,1110,0,6,1110,0,47.6717,1670
650000.0,4,2.5,2110,0,7,1530,580,47.6882,1420
975000.0,3,3.0,1850,0,6,1850,0,47.6711,1360
229000.0,1,1.0,600,0,6,600,0,47.5558,1480
575000.0,5,2.5,2760,0,8,1730,1030,47.6074,1680
815000.0,4,1.75,2970,4,9,1560,1410,47.5907,3310
525000.0,3,1.75,2300,0,7,1350,950,47.7716,2320
471000.0,3,2.5,2030,0,8,1720,310,47.5305,1670
450000.0,4,1.75,2160,0,8,1260,900,47.6893,1670
590000.0,3,2.0,1650,0,7,1650,0,47.5713,1280
744000.0,4,2.5,3140,0,8,2200,940,47.5664,2860
460000.0,4,2.25,2690,0,9,2690,0,47.3106,2570
299000.0,5,2.5,1940,0,7,1290,650,47.7438,1810
231000.0,4,1.0,1220,0,6,1220,0,47.205,1540
195000.0,3,1.0,1300,0,6,1300,0,47.3037,1150
305000.0,3,1.75,1660,0,7,1130,530,47.4473,1250
895000.0,4,1.5,3390,0,8,2530,860,47.58,3080
1110000.0,4,1.5,2310,0,7,1890,420,47.6232,2840
339000.0,2,1.0,950,0,7,950,0,47.557,1180
885000.0,4,3.75,2400,0,7,1370,1030,47.6295,2230
375000.0,3,1.0,1780,0,6,1050,730,47.5119,1260
367400.0,4,1.5,1280,0,7,1280,0,47.6023,1310
700000.0,4,2.0,1930,0,7,1430,500,47.646,1910
667000.0,5,2.25,2560,0,8,1870,690,47.5819,2070
200000.0,2,1.0,920,0,6,920,0,47.5177,1210
552775.0,3,2.5,1900,0,8,1900,0,47.6326,2900
452000.0,3,2.0,2270,0,6,1270,1000,47.5092,2210
418000.0,3,2.5,2080,0,8,1360,720,47.4694,1790
601500.0,3,1.75,1460,0,8,1460,0,47.6709,2240
600000.0,3,1.75,1670,0,8,1670,0,47.5929,2330
340000.0,4,2.5,2810,0,9,2810,0,47.333,2660
310000.0,3,2.5,2370,0,8,2370,0,47.2703,1870
290000.0,2,1.75,1700,0,8,1700,0,47.5066,1700
438000.0,2,1.0,1630,0,7,1630,0,47.7222,1800
718000.0,4,2.75,2930,0,8,1660,1270,47.5841,2200
200000.0,2,1.0,860,0,6,860,0,47.4878,1030
479900.0,3,2.0,1980,0,9,1980,0,47.3657,2200
400000.0,3,2.5,2080,0,9,2080,0,47.4395,2550
219950.0,3,1.0,1060,0,7,1060,0,47.4434,1130
300000.0,3,2.5,1590,0,7,1590,0,47.7344,1820
437000.0,3,2.25,1980,0,7,1290,690,47.7753,1550
350000.0,4,2.0,1720,0,7,860,860,47.7307,1250
626000.0,4,1.75,1350,0,7,1350,0,47.6335,1890
490000.0,3,2.5,2080,0,8,2080,0,47.7455,2320
289000.0,3,2.5,2090,0,8,2090,0,47.3724,2740
595000.0,3,2.5,2030,0,7,2030,0,47.6594,1790
676000.0,3,2.25,2680,0,9,2680,0,47.4828,2680
389000.0,3,1.75,1820,0,7,1220,600,47.7466,1940
240000.0,3,2.0,1300,0,7,1300,0,47.3837,1630
382500.0,4,2.5,2210,0,8,2210,0,47.4206,1970
511555.0,3,2.0,1400,0,7,1400,0,47.586,1600
710500.0,3,1.75,2040,0,8,1540,500,47.6608,1620
429000.0,3,2.5,2420,0,8,1860,560,47.463,2620
170000.0,4,1.75,1920,0,7,1920,0,47.4222,1490
2135000.0,4,3.25,3860,4,10,2630,1230,47.6224,4590
480000.0,5,2.75,2760,0,7,1430,1330,47.7563,2460
1665000.0,4,3.75,3450,4,10,2640,810,47.6134,3180
225000.0,3,1.0,1040,0,6,1040,0,47.4906,1100
615000.0,3,1.75,2220,2,8,2040,180,47.774,2540
438950.0,4,2.5,2470,3,7,2470,0,47.2396,1680
242000.0,3,1.75,1300,0,7,1300,0,47.3448,1400
560000.0,3,2.5,1960,0,8,1460,500,47.6339,1960
857500.0,3,1.5,2040,2,8,2040,0,47.6658,1540
685000.0,4,2.5,3030,0,9,3030,0,47.6075,2790
486000.0,4,3.0,2260,0,7,2260,0,47.7297,2200
749000.0,3,2.5,2670,0,9,2670,0,47.6599,2670
260000.0,3,2.5,1520,0,7,1520,0,47.3687,1670
1015000.0,3,1.75,3610,2,10,2610,1000,47.583,2900
565000.0,3,1.75,1130,0,7,930,200,47.6379,1360
355000.0,3,2.0,1480,0,7,1480,0,47.6969,1850
775000.0,5,2.0,3540,3,9,3540,0,47.7108,2280
335000.0,4,2.25,2100,0,7,1050,1050,47.4676,1760
1300000.0,5,4.0,3366,2,8,2966,400,47.6466,2340
545000.0,3,1.75,1810,0,7,1810,0,47.6599,1140
540000.0,3,1.75,1680,0,7,1680,0,47.5745,1460
687500.0,3,1.75,2450,2,8,1540,910,47.7296,2520
115000.0,1,2.0,1150,0,7,1150,0,47.2951,1200
227000.0,1,2.0,1150,0,7,1150,0,47.2951,1200
870000.0,4,2.5,3240,2,9,3240,0,47.5641,4610
1190000.0,4,2.5,3480,0,11,3480,0,47.6404,3960
375000.0,4,2.5,2800,0,9,2800,0,47.3596,2960
902000.0,3,2.75,3240,2,8,1620,1620,47.567,2700
269500.0,2,1.5,1480,0,6,940,540,47.4942,1090
570000.0,3,1.0,1700,0,6,1200,500,47.6819,1550
359950.0,2,1.0,1240,0,7,1040,200,47.7061,1190
1450000.0,4,3.5,3720,0,10,2880,840,47.5885,2080
615000.0,3,2.5,1910,0,8,1910,0,47.6324,2240
250000.0,4,2.0,2120,0,7,2120,0,47.3722,1720
530000.0,4,2.5,3020,0,7,3020,0,47.5346,2640
474950.0,3,2.0,2250,0,7,2250,0,47.542,2110
490000.0,4,2.0,1650,0,7,1650,0,47.7117,1650
210000.0,2,1.5,880,0,7,880,0,47.5188,1070
265500.0,3,1.0,1860,0,7,1860,0,47.3904,1740
1462500.0,5,3.25,3840,3,10,2750,1090,47.5929,2060
310000.0,4,2.25,2192,0,8,2192,0,47.3644,1914
324500.0,3,2.5,1590,0,7,1590,0,47.4832,2160
599000.0,4,4.75,3700,0,7,1840,1860,47.768,1720
525000.0,4,2.5,3670,0,10,3670,0,47.4617,3300
400000.0,3,1.0,1630,0,7,1630,0,47.7548,1480
887500.0,3,3.0,4230,3,9,3780,450,47.4176,2880
344000.0,2,1.0,1060,0,6,770,290,47.6896,1820
525000.0,3,2.5,2700,0,9,2700,0,47.7434,2660
385000.0,3,2.25,2110,0,8,2110,0,47.7311,1740
820000.0,4,2.5,3720,0,10,3720,0,47.6085,3515
1305000.0,4,3.5,3440,0,11,2560,880,47.6672,3090
549000.0,4,2.25,2420,0,8,1350,1070,47.6206,2160
180000.0,3,1.0,1090,0,7,1090,0,47.5177,1230
589000.0,4,2.5,2910,2,8,2910,0,47.5388,2550
350000.0,3,1.0,1050,0,7,1050,0,47.5564,1490
197400.0,3,2.0,1610,0,7,1110,500,47.334,1920
267000.0,3,2.5,1760,0,8,1760,0,47.3731,1890
480000.0,3,1.5,1540,0,7,1540,0,47.5817,1710
650000.0,4,2.5,2580,0,8,1660,920,47.703,2060
600000.0,2,1.0,1370,0,7,1370,0,47.6744,1500
490000.0,2,1.75,1440,0,8,1440,0,47.7028,1810
225000.0,3,1.0,1410,0,7,980,430,47.4577,1510
640000.0,3,2.25,1980,0,8,1980,0,47.6384,2800
710000.0,3,3.5,2440,0,7,1990,450,47.589,2440
325000.0,3,2.0,1350,0,7,1350,0,47.7313,1350
595000.0,3,3.25,3130,0,9,2210,920,47.7741,2710
128750.0,3,1.0,880,0,5,880,0,47.3019,880
465000.0,3,2.25,1920,0,7,1240,680,47.6078,1920
710000.0,4,1.75,2700,0,8,1450,1250,47.6838,1760
605000.0,4,2.75,1670,0,7,840,830,47.5496,1100
994000.0,4,2.5,3470,0,10,3470,0,47.547,3360
489950.0,3,2.25,1820,0,8,1820,0,47.7133,2430
365000.0,3,1.5,1310,0,7,1310,0,47.7291,1090
359950.0,3,2.0,1790,0,8,1790,0,47.3898,2330
495000.0,4,2.5,2460,0,8,2460,0,47.4912,2510
255000.0,3,1.5,1060,0,7,1060,0,47.4293,1410
330000.0,3,1.75,1340,0,7,1340,0,47.7207,2950
450000.0,3,1.75,1480,0,8,1480,0,47.6634,1920
655000.0,4,2.5,3500,2,9,3500,0,47.5428,3180
485000.0,4,2.75,2910,2,9,2120,790,47.3397,2850
375000.0,4,1.75,1940,0,8,970,970,47.7578,1940
570000.0,4,2.5,2280,0,8,2280,0,47.5902,2246
350000.0,3,2.25,1190,0,8,1190,0,47.6972,1210
550000.0,3,1.0,1260,3,7,1260,0,47.5058,2020
513000.0,5,2.0,2270,0,7,1150,1120,47.6692,1950
450000.0,4,2.25,1990,0,7,1030,960,47.5237,1320
432500.0,4,1.75,1500,0,7,750,750,47.5917,1220
432000.0,5,2.75,2060,3,7,2060,0,47.1776,2240
480000.0,3,2.25,1950,0,8,1950,0,47.7213,1900
402200.0,3,1.75,1790,0,7,1330,460,47.7311,1770
650000.0,3,1.0,1520,0,6,1520,0,47.5872,2710
1199500.0,4,2.5,3240,0,9,3240,0,47.5825,2920
312000.0,3,2.0,2440,0,8,1440,1000,47.375,2400
610000.0,4,2.0,2220,0,7,1380,840,47.5723,1850
823000.0,5,1.75,2640,0,7,1650,990,47.6802,1750
471000.0,4,1.75,1450,0,7,950,500,47.6706,1850
481015.0,3,2.25,1550,0,8,1550,0,47.6946,1620
1959000.0,5,4.5,6200,1,11,5050,1150,47.5632,3700
624000.0,4,3.25,2810,0,8,1680,1130,47.692,2110
480000.0,4,2.5,2080,0,7,1200,880,47.7393,1920
815000.0,3,1.5,1370,0,7,1370,0,47.6217,1580
1650000.0,4,2.25,2920,0,11,2920,0,47.6237,3080
180000.0,3,1.0,1000,0,6,1000,0,47.5118,1280
156601.0,2,1.75,1210,0,7,1210,0,47.3438,1650
374950.0,4,2.5,2790,0,8,2790,0,47.3557,2850
368000.0,2,1.5,1660,0,6,830,830,47.5134,1930
550000.0,3,2.0,1650,0,7,1650,0,47.6727,1210
198000.0,3,1.75,1300,0,7,1300,0,47.2752,1150
345000.0,3,1.75,1090,0,7,1090,0,47.7227,1240
1712750.0,5,2.5,2660,0,9,1960,700,47.6176,3960
185900.0,3,1.0,940,0,5,940,0,47.2763,1370
950000.0,3,2.75,2750,2,9,1810,940,47.5617,2850
995000.0,4,4.5,3850,2,10,3000,850,47.5522,3480
345000.0,2,1.0,860,0,7,860,0,47.7132,1780
741000.0,4,2.75,2070,0,7,1390,680,47.5697,1850
737000.0,2,2.25,2290,0,8,2290,0,47.7199,1810
668750.0,4,2.5,2340,2,8,1590,750,47.7728,2110
575000.0,3,1.75,2680,0,8,1590,1090,47.5316,2620
280000.0,4,2.0,1710,0,8,1030,680,47.366,1620
583000.0,3,1.5,1800,0,7,1800,0,47.6344,1610
196000.0,3,2.25,1510,0,7,1090,420,47.7758,1870
349950.0,3,2.5,1700,0,8,1700,0,47.432,2280
429000.0,4,1.0,1350,0,7,1350,0,47.6727,1530
270000.0,5,2.5,2140,0,7,1330,810,47.3927,2050
385000.0,6,4.0,2700,0,7,1350,1350,47.5525,2260
535000.0,1,1.0,920,3,7,920,0,47.6748,1890
352500.0,3,1.75,1500,0,7,1030,470,47.7672,2090
624000.0,3,1.75,1510,0,7,860,650,47.6864,1650
215000.0,5,1.5,1980,0,7,1980,0,47.4571,1510
870000.0,4,3.0,4500,2,9,3040,1460,47.5581,3540
440000.0,4,2.5,3220,0,8,2610,610,47.495,2500
518000.0,2,1.5,1140,0,7,940,200,47.6124,1460
259500.0,3,2.25,1490,0,7,1490,0,47.3474,1510
795127.0,4,3.25,4360,0,10,3360,1000,47.6398,3540
290000.0,3,1.0,960,0,7,960,0,47.5765,1520
385000.0,4,3.0,2253,0,7,2253,0,47.3935,1786
259950.0,2,1.0,770,0,6,770,0,47.747,1120
330000.0,2,2.5,1310,0,8,1310,0,47.4911,1310
280000.0,3,1.0,980,0,6,830,150,47.5206,1140
595000.0,4,2.5,1820,0,8,1820,0,47.5842,2710
925900.0,4,3.75,3980,0,10,3980,0,47.6303,3980
499000.0,3,2.25,3010,0,8,2410,600,47.7671,2620
325000.0,4,2.5,1830,0,8,1830,0,47.267,2109
895000.0,5,2.5,2550,0,9,1610,940,47.6336,2510
162248.0,2,1.0,800,0,6,800,0,47.4756,850
1072500.0,3,2.25,2890,4,8,1790,1100,47.5027,2110
430000.0,3,1.5,1810,0,7,1030,780,47.6819,1780
615500.0,3,1.5,1810,0,7,1030,780,47.6819,1780
260000.0,3,1.0,940,0,6,940,0,47.5551,1180
295000.0,4,2.0,1810,0,7,1810,0,47.5597,1980
1186040.0,3,1.75,2550,0,9,1650,900,47.6109,2100
749950.0,4,2.5,2370,2,9,2080,290,47.7064,2970
175000.0,6,1.0,1370,0,6,1120,250,47.5238,1020
415000.0,6,1.0,1370,0,6,1120,250,47.5238,1020
190000.0,3,1.0,1200,0,6,1200,0,47.3231,1250
625000.0,3,1.75,2100,0,7,1350,750,47.6702,1720
420000.0,3,2.25,2020,0,7,2020,0,47.6988,1850
339900.0,4,1.5,1570,2,7,1400,170,47.3864,2326
160000.0,2,1.0,1140,0,8,1140,0,47.7637,1850
353000.0,4,2.5,1830,0,7,1830,0,47.3557,1830
390000.0,3,2.0,1010,0,8,1010,0,47.6232,1750
675000.0,4,2.5,1770,2,8,1770,0,47.7382,2470
400000.0,3,2.5,2120,0,7,2120,0,47.4787,2230
1340000.0,4,3.5,3190,3,10,2160,1030,47.5928,2390
1650000.0,4,2.5,2780,1,8,1730,1050,47.6209,3590
1000000.0,5,3.0,3350,0,8,2180,1170,47.6705,2660
850000.0,5,3.5,3450,0,8,2350,1100,47.6991,2640
275000.0,3,1.5,1060,0,6,1060,0,47.5498,1560
450000.0,3,2.5,1670,0,8,1670,0,47.5314,1670
305000.0,4,1.75,2251,1,8,1390,861,47.3369,2520
643002.0,3,2.5,1770,0,7,1270,500,47.6807,1400
468000.0,2,1.75,1510,0,8,1510,0,47.6644,1740
324950.0,4,2.5,1770,0,7,1770,0,47.3506,2080
290000.0,3,2.0,1260,0,7,1260,0,47.4034,1460
488500.0,3,2.0,1710,0,7,1030,680,47.697,1710
367950.0,3,1.75,2290,0,7,1250,1040,47.7611,1660
285000.0,2,1.0,790,0,6,790,0,47.5015,1440
417000.0,3,2.75,1820,0,8,1820,0,47.501,1820
1115000.0,4,2.5,3180,0,10,2390,790,47.6388,3180
1550000.0,4,4.0,5280,3,11,3220,2060,47.5323,3470
604000.0,3,2.5,3240,2,10,3240,0,47.3256,4050
380000.0,3,2.5,2390,0,8,2390,0,47.4378,2310
336500.0,4,2.5,2500,0,7,2500,0,47.3853,1960
685000.0,4,2.0,2290,3,7,2290,0,47.6807,2000
4208000.0,5,6.0,7440,0,12,5550,1890,47.5692,4740
670000.0,3,1.0,1600,1,7,990,610,47.5872,2600
524000.0,2,1.0,1120,0,7,1120,0,47.6454,1500
172000.0,3,1.0,1340,0,7,1340,0,47.3173,1250
680000.0,6,2.0,1670,0,7,900,770,47.6637,1330
549900.0,4,3.0,2830,0,8,2830,0,47.2925,2250
357000.0,4,2.75,2700,0,9,2700,0,47.3168,2728
107000.0,3,1.5,910,0,6,910,0,47.5238,1410
232900.0,3,1.5,910,0,6,910,0,47.5238,1410
800000.0,4,3.5,2370,0,8,1610,760,47.684,2170
248500.0,2,1.5,880,0,7,880,0,47.7063,880
670000.0,3,2.5,2050,3,8,1730,320,47.5708,2370
207000.0,3,1.75,1180,0,6,1180,0,47.4018,1490
164000.0,3,1.0,1070,0,7,1070,0,47.2899,1190
570500.0,2,1.0,1380,0,7,1080,300,47.6416,1600
599990.0,3,2.25,2680,0,8,1570,1110,47.5683,2480
395000.0,5,1.75,2100,0,7,1060,1040,47.7097,1680
979500.0,4,3.75,4133,0,11,4133,0,47.7479,1970
207000.0,3,1.0,920,0,6,920,0,47.7114,1300
237000.0,3,1.0,920,0,6,920,0,47.7114,1300
650100.0,2,1.0,1750,0,7,1180,570,47.5946,2480
385000.0,4,2.5,1950,0,7,1150,800,47.656,2050
335000.0,2,1.75,1660,0,7,1660,0,47.4899,1290
347000.0,4,1.5,2670,0,8,2670,0,47.2659,2420
204000.0,3,1.0,980,0,6,980,0,47.42,1240
615000.0,4,2.25,1780,0,8,1780,0,47.6647,2360
943500.0,3,2.25,2370,0,7,2370,0,47.5827,2370
560000.0,3,2.0,1640,0,7,1020,620,47.5636,2130
547500.0,4,2.5,2610,0,8,1610,1000,47.5618,2250
359500.0,4,1.75,2030,0,7,1450,580,47.5067,1750
660000.0,3,2.5,2590,0,9,2590,0,47.5516,2590
258000.0,3,1.75,1620,0,7,1310,310,47.3635,1580
355000.0,3,1.75,2040,0,8,2040,0,47.3519,1950
253500.0,2,1.0,810,0,7,810,0,47.5232,1240
422500.0,3,1.0,1270,0,7,1270,0,47.534,1590
239000.0,2,2.0,1470,0,7,1470,0,47.3086,1470
628000.0,3,2.25,1720,0,7,1140,580,47.6882,1530
352000.0,2,2.5,1320,0,8,660,660,47.5364,1420
311600.0,3,2.25,1358,0,7,1358,0,47.7052,1358
235000.0,4,1.5,2070,0,7,1060,1010,47.3417,1450
870000.0,5,2.25,2910,0,9,2910,0,47.5633,2740
190848.0,4,1.5,1370,0,7,900,470,47.3344,1370
570000.0,4,1.75,2340,0,7,1170,1170,47.6746,1270
661254.0,4,4.0,2290,0,7,1690,600,47.5824,1920
575000.0,4,2.0,1650,0,7,1650,0,47.6781,1690
230000.0,2,0.75,650,0,5,650,0,47.7281,1110
680000.0,3,2.25,2300,0,8,2300,0,47.5677,2240
148000.0,1,1.0,620,0,5,620,0,47.5138,1180
244900.0,1,1.0,620,0,5,620,0,47.5138,1180
214950.0,3,1.0,1400,0,6,1280,120,47.4845,1730
580000.0,3,1.5,1800,0,8,1420,380,47.5778,1800
263000.0,3,1.5,1300,0,7,1300,0,47.4556,1840
317000.0,5,2.5,2360,0,7,1180,1180,47.4875,1160
302000.0,4,3.0,3320,0,7,1750,1570,47.4596,1830
899000.0,3,1.0,1480,0,8,1480,0,47.6497,2660
1289000.0,3,2.5,2190,0,8,1550,640,47.6685,2190
710000.0,3,3.25,3740,0,11,3100,640,47.4549,2400
230000.0,3,1.0,1360,0,7,1020,340,47.4901,1480
430000.0,3,1.0,1210,0,6,1210,0,47.531,890
1169000.0,5,4.25,4610,4,11,4610,0,47.5878,4400
397000.0,3,1.0,860,0,7,860,0,47.6942,1250
595000.0,3,2.5,2250,0,8,2250,0,47.7174,1790
485000.0,3,1.75,2030,0,8,1330,700,47.5217,2030
755000.0,5,2.5,3260,1,8,2310,950,47.7587,2390
185000.0,3,1.0,1840,0,7,920,920,47.455,1250
340000.0,3,1.0,1840,0,7,920,920,47.455,1250
236000.0,4,2.75,2000,0,7,2000,0,47.3629,1710
550000.0,4,2.5,2810,0,9,2810,0,47.7441,2750
680000.0,3,2.0,1780,0,7,980,800,47.6794,1620
630000.0,4,2.5,2540,0,9,2540,0,47.5855,2540
560000.0,3,2.0,2340,1,7,1170,1170,47.54,2110
385000.0,3,2.0,1480,2,7,740,740,47.5081,1250
280000.0,3,2.25,1358,0,7,1358,0,47.7052,1358
225000.0,3,2.5,1750,0,7,1180,570,47.3746,1570
610000.0,4,1.75,1830,0,8,1230,600,47.5449,3630
592500.0,3,2.0,1170,0,7,800,370,47.6752,1330
750000.0,4,2.75,3170,0,10,3170,0,47.5774,2940
164000.0,4,1.0,1530,0,7,1530,0,47.3638,1470
320000.0,2,1.0,1100,0,7,1100,0,47.7414,1510
544000.0,4,2.5,2030,0,8,2030,0,47.5692,1780
344950.0,3,1.75,1870,0,8,1320,550,47.4428,1870
539500.0,3,2.5,3080,0,10,3080,0,47.3752,3130
420000.0,4,1.75,2480,0,7,1600,880,47.4722,2390
305000.0,2,1.0,910,0,6,910,0,47.7712,2000
229000.0,2,1.0,810,0,6,810,0,47.7317,1500
1068000.0,5,3.5,3990,0,11,3990,0,47.5198,3490
397500.0,3,2.25,1430,0,8,1430,0,47.6917,1430
540000.0,4,2.0,2190,0,6,2190,0,47.6944,2210
650000.0,4,2.5,2290,0,8,2290,0,47.6353,2150
1900000.0,6,4.0,3020,4,8,2840,180,47.5924,3680
649000.0,2,1.75,2260,2,9,1890,370,47.6359,2860
287500.0,5,2.0,2020,0,7,1620,400,47.4891,1270
815000.0,4,2.75,2620,2,8,1310,1310,47.6829,1900
795000.0,2,2.5,2830,0,10,2830,0,47.6481,3190
502775.0,3,1.75,1700,0,8,1200,500,47.5192,2040
222900.0,2,1.0,1110,0,6,1110,0,47.4962,1150
399950.0,4,3.0,2150,0,8,1450,700,47.3268,2430
728000.0,4,2.5,2650,0,9,2650,0,47.6278,2650
850000.0,5,3.5,3870,0,10,3870,0,47.6403,4290
525000.0,4,2.75,2530,0,8,2530,0,47.7356,2530
257000.0,3,1.0,1450,0,7,1450,0,47.4299,1360
433500.0,3,2.5,2200,0,8,2200,0,47.5418,2130
314950.0,4,1.75,1890,0,7,1290,600,47.2901,1510
500000.0,3,1.75,1530,0,7,1100,430,47.6949,1780
300000.0,3,1.5,1590,0,7,1590,0,47.7394,1590
645000.0,4,2.5,2690,0,8,2690,0,47.6449,2230
222500.0,3,1.0,990,0,7,990,0,47.3422,1360
275000.0,3,1.75,1300,0,7,1080,220,47.5026,1270
498000.0,3,1.5,1720,0,8,1720,0,47.5284,1360
800000.0,3,1.75,2080,0,7,2080,0,47.7018,1870
297000.0,3,2.5,1840,0,8,1840,0,47.267,1940
625000.0,5,3.5,4010,3,9,2560,1450,47.4928,2440
770000.0,4,2.5,3560,0,9,3560,0,47.5593,3190
517000.0,3,2.25,1640,0,8,1540,100,47.6793,1530
238000.0,1,1.0,530,0,5,530,0,47.6946,1200
234550.0,3,1.0,1990,0,7,1140,850,47.4778,1160
230500.0,3,2.25,1690,1,7,1160,530,47.3505,1690
585000.0,5,2.5,2670,0,7,1620,1050,47.7015,1610
733000.0,4,1.75,1930,0,7,1450,480,47.6604,1280
357950.0,2,1.0,810,0,7,810,0,47.6631,900
530000.0,3,1.75,1550,0,7,1050,500,47.6817,1560
377500.0,4,2.5,2640,0,8,2640,0,47.4485,1680
475000.0,4,2.5,2320,0,7,2320,0,47.5406,2320
399000.0,3,1.75,2170,0,7,2170,0,47.2881,1710
660000.0,3,2.0,2080,0,7,1040,1040,47.5791,1710
400000.0,5,2.25,2070,0,7,1080,990,47.6095,1740
440000.0,2,1.0,800,0,7,800,0,47.6639,1150
366400.0,4,2.25,2040,0,8,1270,770,47.3849,2030
627250.0,4,2.5,2830,0,9,2830,0,47.742,2970
375950.0,3,1.75,1480,0,6,1100,380,47.6985,1510
162000.0,3,2.25,1810,0,7,1280,530,47.2976,1690
780000.0,3,2.75,1970,0,8,1970,0,47.663,1680
705000.0,4,2.5,2650,0,8,1520,1130,47.5866,1690
450000.0,4,2.5,2820,2,9,1820,1000,47.3426,2560
311000.0,3,2.75,1400,0,7,1000,400,47.5095,1400
485000.0,3,2.5,1580,0,8,1580,0,47.5692,1770
485000.0,3,2.5,1800,0,8,1800,0,47.7558,1940
725000.0,5,3.75,3360,0,8,2640,720,47.558,1930
185000.0,3,1.0,1510,0,6,1510,0,47.2649,1520
1890000.0,4,4.25,4285,0,10,4285,0,47.6332,1570
260000.0,3,2.25,1610,0,7,1610,0,47.3713,1530
356000.0,4,2.5,2470,0,8,2470,0,47.3457,2470
225205.0,3,1.0,1200,0,6,1200,0,47.3746,1200
445000.0,3,1.0,1260,0,7,1260,0,47.7,1560
356000.0,2,1.0,920,0,6,920,0,47.5484,1460
760250.0,5,2.75,2540,0,7,1440,1100,47.5875,2540
572000.0,2,2.0,1870,0,8,1870,0,47.7142,1810
970000.0,3,2.25,3060,2,9,1810,1250,47.579,4950
348450.0,4,2.5,1950,0,8,1950,0,47.3817,2210
535500.0,3,1.5,1730,0,8,1730,0,47.7499,1730
710000.0,5,2.5,2570,2,8,1620,950,47.7216,2680
745000.0,3,1.75,1490,0,7,1140,350,47.584,2310
355000.0,4,2.5,2040,0,7,2040,0,47.4973,2160
333000.0,4,2.5,2690,0,8,2690,0,47.3666,2690
282000.0,3,2.5,1610,0,7,1610,0,47.349,1570
840500.0,3,2.0,2520,0,8,1410,1110,47.6365,1960
432000.0,3,1.75,1550,0,7,1550,0,47.6136,1360
625000.0,3,1.0,1800,2,9,900,900,47.5672,1400
209977.0,3,1.0,1170,0,7,1170,0,47.4941,1440
174000.0,2,1.0,900,0,6,900,0,47.2616,1767
740000.0,4,2.0,2800,0,8,1730,1070,47.6869,2470
518000.0,3,1.75,1830,0,7,1830,0,47.676,1830
539000.0,3,1.75,1380,0,7,940,440,47.6652,1250
575000.0,3,2.75,1990,0,8,1530,460,47.532,2170
530000.0,2,1.75,1170,0,9,780,390,47.6192,1280
242025.0,4,1.75,1400,0,7,1400,0,47.4153,1910
1030000.0,4,2.5,2620,0,8,1770,850,47.5876,2360
230000.0,3,1.0,880,0,7,880,0,47.3837,880
350000.0,4,2.5,2260,0,8,1460,800,47.4645,2260
595000.0,3,1.0,1300,0,6,1300,0,47.6829,1440
440000.0,3,1.75,1450,0,8,1450,0,47.7222,1950
550000.0,3,1.0,1110,0,7,1110,0,47.6461,1460
940000.0,4,2.25,1890,1,9,1470,420,47.6316,2430
375000.0,3,1.5,1100,0,8,940,160,47.5927,1380
567500.0,2,1.5,1350,0,7,1070,280,47.6511,1610
735000.0,3,2.5,3020,0,8,1510,1510,47.5529,2400
114000.0,2,1.0,730,0,6,730,0,47.4943,1220
608000.0,2,1.0,1390,0,7,1010,380,47.6422,1590
442500.0,3,1.5,2710,0,7,2170,540,47.6522,2130
381800.0,4,2.0,1530,0,7,1110,420,47.7336,1100
330000.0,3,2.0,2170,0,7,1340,830,47.571,1350
90000.0,2,1.0,790,0,7,790,0,47.7351,1310
312000.0,2,1.75,1160,0,6,1160,0,47.5509,960
339000.0,3,1.0,1080,0,7,1080,0,47.777,1080
313000.0,3,1.75,2190,0,8,2190,0,47.3098,1980
618080.0,3,2.5,2030,0,8,2030,0,47.5654,2030
325000.0,3,2.25,2480,0,8,2480,0,47.4543,2280
242000.0,4,1.0,2240,0,7,1120,1120,47.5089,1080
364000.0,2,1.5,1650,0,7,860,790,47.7772,1660
545000.0,3,1.75,1700,2,7,1450,250,47.5643,1700
445000.0,3,2.5,2790,0,10,2790,0,47.3043,2890
1085500.0,4,2.75,3010,3,9,3010,0,47.7005,3010
660000.0,4,2.5,2550,0,8,1290,1260,47.6208,2270
845000.0,4,2.5,2880,0,10,2880,0,47.6911,3460
417000.0,4,2.0,2090,0,6,1060,1030,47.5893,1590
213800.0,2,1.0,740,0,5,740,0,47.4934,750
400000.0,2,1.75,960,0,7,960,0,47.5551,1000
759950.0,4,3.5,2100,0,8,2100,0,47.7076,1250
990000.0,4,2.5,2540,0,9,2540,0,47.6451,1400
710000.0,3,1.75,1650,0,8,1650,0,47.6118,2400
315000.0,1,0.75,770,0,6,770,0,47.5565,1550
515000.0,4,2.5,2280,0,8,1500,780,47.5392,2690
638000.0,3,2.0,1660,0,7,970,690,47.5741,1560
370000.0,4,2.0,2020,0,7,1160,860,47.7307,1840
184000.0,3,1.0,970,0,7,970,0,47.3251,1410
583800.0,3,2.5,2480,0,8,2480,0,47.6313,2310
309500.0,3,1.0,1250,0,7,1250,0,47.5074,1770
1960000.0,4,4.0,4430,0,12,4430,0,47.6422,3900
299000.0,1,1.0,740,0,7,740,0,47.5519,1400
215000.0,2,1.0,710,0,6,710,0,47.4903,960
410000.0,4,2.0,1970,0,8,1820,150,47.479,2090
478000.0,2,1.0,820,0,7,820,0,47.6494,1630
431000.0,2,1.0,1000,0,7,1000,0,47.5474,1280
635000.0,4,2.5,3080,0,9,3080,0,47.6325,2640
648000.0,5,2.25,2410,0,8,2410,0,47.5434,2080
640000.0,3,2.5,2370,0,9,2370,0,47.5345,2550
932808.0,5,4.5,4690,0,10,3450,1240,47.5539,4070
835000.0,2,2.0,2280,0,8,2280,0,47.7103,2280
469775.0,2,1.75,1530,0,7,1030,500,47.6465,2090
587000.0,5,3.5,3610,0,7,3610,0,47.6832,1620
677915.0,3,2.0,1740,0,7,990,750,47.6448,1250
1075000.0,4,3.0,3600,4,9,2100,1500,47.5866,2700
671000.0,4,3.0,3130,0,7,1750,1380,47.6811,2080
695000.0,5,3.25,3940,0,9,3940,0,47.5435,3550
205000.0,4,2.0,2200,0,6,1100,1100,47.481,1330
350000.0,4,1.0,1510,0,7,1510,0,47.761,1950
360000.0,3,1.75,1560,0,7,1560,0,47.4779,1720
313999.0,4,2.25,1870,0,7,1870,0,47.3657,1870
300000.0,3,2.25,2070,0,8,1690,380,47.3551,2070
452000.0,2,1.75,1660,0,7,830,830,47.7661,1900
495500.0,3,2.5,2010,0,7,2010,0,47.6262,2040
288000.0,3,1.0,1410,0,7,1410,0,47.3199,1570
227490.0,3,1.75,1820,0,7,1820,0,47.3352,1420
470950.0,3,2.5,2560,0,8,2560,0,47.6916,2120
735000.0,4,2.75,2450,2,8,2450,0,47.5471,2320
730000.0,7,2.75,3110,0,7,2010,1100,47.6684,1240
412000.0,3,2.5,2210,0,8,2210,0,47.4377,2260
589500.0,4,2.5,2630,0,9,2630,0,47.5222,3240
291000.0,7,1.0,2350,0,7,1550,800,47.5432,1500
1300000.0,5,3.75,4450,0,9,3460,990,47.6418,2550
190000.0,3,1.0,1200,0,6,1200,0,47.3262,1160
456200.0,2,1.75,1210,0,6,1210,0,47.7148,1670
225000.0,3,1.0,1290,0,7,970,320,47.3054,1300
2000000.0,3,2.5,3490,4,10,2290,1200,47.6092,1780
740000.0,4,2.5,3360,0,9,3360,0,47.6649,1930
467000.0,3,1.75,2660,0,8,1330,1330,47.5575,2030
385000.0,2,1.0,770,0,6,770,0,47.7057,1390
670000.0,3,2.5,1800,0,7,1240,560,47.646,1790
500000.0,4,2.5,2900,0,8,1660,1240,47.55,2250
352450.0,3,2.0,1430,0,7,1430,0,47.7564,1630
669888.0,4,2.75,2550,0,9,2550,0,47.5302,2670
405000.0,3,2.75,1310,0,7,1310,0,47.6016,1310
518000.0,3,1.5,1430,0,7,1430,0,47.5874,1450
280000.0,4,1.0,1880,0,7,1120,760,47.5101,1880
435000.0,3,2.5,1600,0,7,1600,0,47.5531,1830
314950.0,3,2.0,1760,0,7,1760,0,47.1923,1910
209900.0,2,2.0,1180,0,6,1180,0,47.3491,1310
630000.0,4,2.5,2330,0,8,2330,0,47.6471,2460
442000.0,4,1.5,1960,0,7,1960,0,47.6304,2050
340000.0,4,1.0,1140,0,5,1140,0,47.4619,1450
230000.0,3,1.75,1400,0,7,1400,0,47.4233,1400
495200.0,5,2.25,2710,0,7,1410,1300,47.7642,2850
900000.0,4,2.5,3510,0,10,3510,0,47.6016,3320
265000.0,2,1.0,910,0,5,910,0,47.6916,1020
489500.0,3,1.75,2090,0,8,1330,760,47.7621,2450
335000.0,3,2.0,1410,0,7,1410,0,47.3273,2950
585000.0,3,3.25,3050,0,8,2240,810,47.7445,3050
800000.0,4,2.25,2010,1,8,1010,1000,47.5591,2010
379500.0,4,2.25,2120,2,7,2120,0,47.2041,2120
475000.0,3,1.0,1270,0,6,1270,0,47.6175,1210
520000.0,3,2.0,1670,0,7,1150,520,47.6096,2020
515000.0,4,2.5,1800,0,8,1800,0,47.5962,1800
577500.0,2,1.0,1640,0,7,940,700,47.6912,2054
269900.0,3,2.25,1740,0,7,1110,630,47.4149,1640
329000.0,3,1.0,1600,0,7,1150,450,47.5292,1460
458500.0,3,1.5,1280,0,7,1280,0,47.6117,1280
890000.0,4,2.0,1480,0,6,1480,0,47.5849,2790
361500.0,4,2.5,1980,0,7,1980,0,47.3528,1850
2535000.0,5,3.25,3730,4,10,3730,0,47.624,4180
325000.0,2,1.0,900,0,7,900,0,47.7282,1580
1850000.0,4,3.25,3480,0,8,3480,0,47.6353,2200
945000.0,4,2.0,2840,0,7,1420,1420,47.6237,2840
370000.0,3,2.5,2490,0,9,2490,0,47.3705,2490
320000.0,0,2.5,1490,0,7,1490,0,47.5261,1500
450000.0,2,2.0,1510,0,8,1510,0,47.7196,1440
800000.0,4,2.5,2900,0,10,2900,0,47.5981,2900
676000.0,3,2.5,2240,0,7,2240,0,47.6786,1460
1272500.0,4,1.75,2040,0,9,2040,0,47.6279,3220
290000.0,3,1.75,1460,0,7,1460,0,47.7713,1920
158000.0,3,1.5,990,0,7,990,0,47.3294,1360
379950.0,4,1.75,1970,0,7,1140,830,47.7771,1820
583000.0,4,2.5,2660,0,8,2660,0,47.6876,2330
150000.0,2,1.0,870,0,6,870,0,47.498,1020
261500.0,3,2.5,1740,0,7,1740,0,47.3574,1260
278000.0,4,2.5,2290,0,7,2290,0,47.3617,1480
555000.0,4,2.75,2170,0,8,1290,880,47.691,2120
355000.0,3,1.75,2040,0,7,1470,570,47.7439,1900
375000.0,4,1.5,1770,0,7,1770,0,47.6011,1600
227000.0,3,1.75,2380,0,6,1380,1000,47.5294,1720
335000.0,4,2.0,2030,0,7,2030,0,47.1647,1560
680000.0,3,2.25,2270,0,9,1820,450,47.7506,2520
686500.0,2,1.75,1390,0,8,1390,0,47.6701,2160
410000.0,3,1.75,1530,0,7,1180,350,47.7422,1550
425000.0,2,1.0,1430,0,6,1230,200,47.6996,1950
562500.0,3,2.5,2030,0,8,2030,0,47.6187,2040
345000.0,4,2.5,2390,0,7,2390,0,47.4807,2390
627500.0,4,2.5,2540,0,8,1640,900,47.5609,2820
355000.0,3,1.0,1890,0,7,1890,0,47.5719,1746
335000.0,3,2.25,1870,0,7,1870,0,47.3779,1670
350000.0,4,3.0,1780,0,7,1780,0,47.5488,1730
590000.0,3,1.0,1610,0,7,1610,0,47.6718,2510
252000.0,3,2.0,1420,0,7,1420,0,47.2887,1790
1295000.0,5,4.0,4440,0,10,2220,2220,47.5708,2720
705000.0,4,2.0,1820,0,7,1820,0,47.6438,1440
498000.0,3,2.0,1620,0,7,1180,440,47.6574,2120
312500.0,2,1.0,870,0,7,870,0,47.7288,1250
260000.0,4,1.75,1830,0,7,1060,770,47.4169,1040
209950.0,3,1.5,2290,0,7,2290,0,47.3643,1310
610000.0,3,1.75,1110,0,7,1110,0,47.5676,2050
500000.0,4,1.0,1440,0,7,1440,0,47.6725,1490
850000.0,3,3.5,3070,3,8,1570,1500,47.7076,2350
689000.0,4,2.5,2440,0,8,1480,960,47.5606,2140
470000.0,4,2.0,2410,0,9,2410,0,47.6234,1910
640000.0,3,3.0,2270,0,9,2130,140,47.516,2850
290000.0,4,1.75,2340,0,8,1590,750,47.497,1970
258500.0,3,2.5,1800,0,7,1800,0,47.3186,1670
1100000.0,4,3.5,2210,0,9,1550,660,47.5816,2370
420000.0,3,1.75,1820,0,7,1250,570,47.6441,2030
230000.0,3,1.0,1190,0,7,1190,0,47.4116,1190
252000.0,3,1.5,1400,0,7,1400,0,47.3639,1480
515000.0,3,2.5,2600,0,8,2600,0,47.7353,2600
425000.0,2,1.0,910,0,6,910,0,47.675,1740
575000.0,3,2.5,1760,2,8,1760,0,47.5723,1760
390000.0,2,1.0,860,0,7,860,0,47.6823,1090
561500.0,4,2.25,2310,0,8,1780,530,47.6657,2310
1350000.0,4,1.75,2000,0,9,1820,180,47.643,1950
835000.0,5,2.75,2460,0,9,1490,970,47.6938,2050
245000.0,2,1.0,1020,0,6,1020,0,47.4956,1480
475200.0,3,2.5,1670,0,8,1670,0,47.5317,1670
425000.0,2,1.0,790,0,7,790,0,47.6833,1330
218000.0,2,1.5,2010,0,7,2010,0,47.4947,1360
600000.0,4,2.5,2600,0,9,2600,0,47.5232,2640
545000.0,4,2.25,1890,0,8,1890,0,47.6342,1920
2408000.0,5,2.5,4600,2,9,3600,1000,47.623,5500
460000.0,5,3.0,2008,0,7,1216,792,47.5376,2040
425000.0,2,1.0,880,0,7,880,0,47.573,1360
455000.0,3,1.75,1700,0,7,850,850,47.5766,1520
313100.0,3,2.0,1730,0,8,1730,0,47.353,1980
780000.0,4,3.5,3910,0,10,2490,1420,47.4846,2830
345500.0,4,2.5,2160,0,8,2160,0,47.4106,1770
243000.0,3,1.75,1200,0,7,1200,0,47.4135,1270
670000.0,5,3.5,3860,3,8,2660,1200,47.7139,2440
325000.0,3,1.5,1320,0,6,840,480,47.7451,1210
281000.0,2,1.0,1280,0,7,1060,220,47.4833,1460
130000.0,3,1.0,1100,0,7,1100,0,47.5231,1450
340000.0,3,2.5,2170,0,7,2170,0,47.3817,2020
485000.0,4,2.75,2720,0,8,2720,0,47.4777,1960
642860.0,4,2.75,2520,0,8,2520,0,47.7685,2520
747000.0,3,1.75,2560,0,7,1280,1280,47.6207,1620
559950.0,4,2.5,2650,0,8,2250,400,47.7317,2110
577288.0,4,2.75,2870,0,9,2870,0,47.5688,2030
575000.0,2,1.0,1230,0,7,880,350,47.6815,1710
287000.0,3,1.0,1450,0,7,1450,0,47.5238,1170
1149000.0,4,3.75,3180,0,9,2500,680,47.6853,2910
335000.0,2,1.0,1800,0,6,900,900,47.51,2040
375000.0,4,2.25,2020,0,8,2020,0,47.5403,1800
325000.0,2,1.0,620,0,6,620,0,47.7322,1400
530000.0,3,2.25,2190,0,7,1330,860,47.5041,2550
287000.0,4,2.25,1980,0,7,1470,510,47.3669,1980
320000.0,5,3.0,2970,0,8,1810,1160,47.3079,2630
425000.0,4,2.5,2270,0,7,2270,0,47.5381,2090
550000.0,3,1.0,1630,3,8,1630,0,47.693,2120
135000.0,3,1.0,1520,0,6,1120,400,47.328,1320
695000.0,3,1.75,2080,0,8,2080,0,47.5776,2300
975000.0,5,2.5,3020,2,9,1980,1040,47.5586,2890
210000.0,4,1.75,2180,0,8,1180,1000,47.405,2180
518000.0,4,1.75,1780,0,7,1050,730,47.7085,1590
335500.0,3,1.0,1370,0,6,1370,0,47.7156,1450
750000.0,4,3.5,3050,3,9,2050,1000,47.571,2170
515000.0,3,1.75,1490,0,7,1490,0,47.569,1630
344500.0,4,2.75,1800,0,7,1050,750,47.4632,1820
470000.0,3,1.5,1760,0,7,1160,600,47.5514,2080
606150.0,4,1.75,1770,0,8,1370,400,47.6208,2040
292000.0,4,2.75,2910,0,7,1600,1310,47.2842,2220
450000.0,3,2.5,2880,3,7,2880,0,47.2485,1460
429000.0,3,1.75,2520,0,8,1260,1260,47.5339,1360
765000.0,4,2.5,3190,0,9,3190,0,47.6698,2560
425000.0,2,1.0,540,0,5,540,0,47.6729,1290
505000.0,4,2.5,3170,0,7,3170,0,47.4911,3010
544950.0,3,1.75,1830,0,7,1830,0,47.6059,1600
382000.0,3,2.0,1360,0,8,1360,0,47.5487,1450
475000.0,3,1.75,1870,0,7,1870,0,47.695,1870
355000.0,3,1.5,1370,0,7,1370,0,47.7253,1370
410000.0,4,2.5,1700,0,7,1700,0,47.7306,1370
450000.0,4,2.0,1960,0,6,980,980,47.5958,1175
565000.0,7,4.5,4140,0,7,2070,2070,47.7302,1440
529100.0,2,1.0,1290,0,7,1290,0,47.694,1670
452500.0,4,2.5,2460,0,7,2460,0,47.5381,2320
245000.0,4,2.0,1580,0,7,1040,540,47.3467,1550
415000.0,1,1.0,700,0,6,700,0,47.6783,1330
610000.0,4,2.5,2410,3,9,2410,0,47.6242,2360
363500.0,4,1.75,2180,0,7,1090,1090,47.4973,2020
510000.0,3,2.75,1950,0,8,1230,720,47.6301,1990
650000.0,4,2.5,2630,0,8,2630,0,47.6314,2840
290000.0,4,2.5,2050,0,7,2050,0,47.4357,1780
170000.0,3,1.0,790,0,6,790,0,47.4984,960
510000.0,2,1.0,1070,0,6,1070,0,47.6168,1380
2280000.0,7,8.0,13540,4,12,9410,4130,47.6675,4850
316000.0,4,2.5,2320,0,8,2320,0,47.3432,2230
690000.0,4,2.5,2670,0,9,2670,0,47.5627,2560
199950.0,2,1.0,700,0,5,700,0,47.4924,970
207000.0,3,1.0,860,0,6,860,0,47.4906,980
449950.0,4,2.25,3490,0,8,3490,0,47.4513,2320
361550.0,3,1.75,1160,0,7,1160,0,47.4655,1420
824000.0,4,3.5,3650,0,10,3650,0,47.7711,3730
537000.0,3,1.75,1550,0,7,1550,0,47.6345,1720
838400.0,4,2.5,2620,0,9,2620,0,47.5631,2580
225000.0,2,1.0,720,0,6,720,0,47.5176,990
329900.0,3,2.0,1380,0,7,1380,0,47.5514,1320
282500.0,4,1.0,1170,0,6,1170,0,47.5305,1610
229950.0,3,1.75,1170,0,7,1170,0,47.3279,1230
500000.0,2,1.0,1630,0,7,1270,360,47.7228,1660
495000.0,3,1.75,1890,0,8,1890,0,47.7032,1920
149500.0,3,1.0,1010,0,7,1010,0,47.3592,1240
726000.0,3,2.5,2040,0,8,1420,620,47.6375,2260
899000.0,4,2.5,4080,0,10,4080,0,47.5933,3470
317000.0,3,1.0,1270,0,7,1270,0,47.5124,1270
395000.0,1,1.0,790,0,6,790,0,47.6544,1110
360000.0,4,3.0,2580,0,8,2580,0,47.4296,2010
570000.0,4,2.5,2290,0,8,2290,0,47.5714,2100
320000.0,4,2.5,3490,0,8,3490,0,47.3772,2910
320000.0,3,1.75,1510,0,7,1510,0,47.4118,1470
268000.0,5,2.5,2400,0,7,2400,0,47.369,1880
191000.0,2,1.0,900,0,6,900,0,47.5269,940
400000.0,2,1.0,1270,0,7,910,360,47.5285,1040
515000.0,2,1.0,1050,0,7,1050,0,47.6699,1340
610000.0,4,2.5,2950,0,9,2950,0,47.531,3160
538000.0,2,1.75,1850,0,7,1060,790,47.6821,1850
432000.0,3,2.5,1970,0,7,1970,0,47.5335,1960
335000.0,4,2.25,2400,0,8,2400,0,47.4383,2180
302000.0,5,1.75,2360,0,7,2060,300,47.7617,1950
787500.0,4,1.75,1580,0,7,1080,500,47.6353,2010
420000.0,3,1.0,1790,0,8,1520,270,47.718,1710
560000.0,3,2.5,2840,0,9,2840,0,47.702,2820
535000.0,3,2.5,1970,0,8,1970,0,47.5759,2090
310000.0,3,2.5,1780,0,7,1230,550,47.5237,1780
760000.0,5,2.0,3920,0,7,2560,1360,47.5798,1830
242500.0,3,1.75,1550,0,7,1550,0,47.4331,1550
1313000.0,6,3.0,2980,2,8,2980,0,47.6366,1720
235000.0,3,1.0,1270,0,6,1270,0,47.4815,1650
598780.0,4,2.25,3040,0,7,1520,1520,47.5911,2560
433200.0,3,2.5,2075,0,8,2075,0,47.4848,2300
343000.0,2,1.0,1110,0,6,700,410,47.5454,2830
145000.0,2,1.0,800,0,6,800,0,47.6836,2390
291970.0,1,1.0,680,0,5,680,0,47.446,1470
599950.0,3,1.0,1680,0,7,1680,0,47.5085,1330
1749000.0,4,2.5,3910,0,8,3910,0,47.6295,2920
870000.0,4,1.75,2780,0,9,1560,1220,47.595,2350
323000.0,4,2.75,2000,0,7,2000,0,47.3511,1690
727000.0,4,3.0,3150,0,9,3150,0,47.5962,3150
166000.0,1,1.0,1120,0,7,1120,0,47.2972,1280
450000.0,4,1.75,1740,0,7,1270,470,47.7675,2190
400000.0,3,2.5,2970,0,7,1510,1460,47.7735,2390
599000.0,3,2.5,2970,0,7,1510,1460,47.7735,2390
165000.0,3,1.0,1150,0,5,1150,0,47.2756,1290
229000.0,2,1.0,1190,0,6,830,360,47.5094,1140
305000.0,1,1.0,900,0,5,900,0,47.7553,1470
930000.0,3,3.25,2950,0,9,2450,500,47.5852,1930
542000.0,3,2.5,1990,0,8,1540,450,47.6205,2470
214000.0,3,1.0,1020,0,6,1020,0,47.3127,1600
718000.0,3,2.5,2070,0,8,2070,0,47.6946,1650
349000.0,3,2.5,1430,0,8,1430,0,47.698,1430
305000.0,3,2.5,2030,0,7,2030,0,47.4024,2290
498000.0,3,2.5,1620,0,7,1620,0,47.6036,1370
799950.0,4,3.5,4220,0,10,4220,0,47.2642,2500
737000.0,3,2.5,2300,2,9,2300,0,47.6842,2300
860000.0,4,3.25,3830,0,10,3830,0,47.5953,2555
339950.0,3,2.5,2390,0,8,1840,550,47.3546,2460
249000.0,3,2.25,1440,0,7,940,500,47.4034,1440
370000.0,2,1.0,910,0,6,910,0,47.5322,1620
725000.0,3,2.0,1550,0,7,1550,0,47.5755,2900
529000.0,5,2.5,2380,0,8,1580,800,47.479,1880
310000.0,4,2.75,2060,0,7,1310,750,47.3581,1540
315000.0,4,2.25,1880,0,8,1880,0,47.4362,1900
1300000.0,4,2.5,3470,0,9,2480,990,47.63,2280
435000.0,3,2.0,2360,0,7,2360,0,47.483,1650
350000.0,3,1.75,1970,0,7,1300,670,47.5107,1970
240000.0,3,1.0,1040,0,7,1040,0,47.4804,1780
410000.0,3,2.25,1420,0,7,1420,0,47.5725,1430
430000.0,4,2.75,2290,0,7,2290,0,47.4916,2270
446000.0,4,2.5,1530,0,7,1020,510,47.7174,1650
240000.0,3,1.5,1360,0,7,1360,0,47.4648,1310
595000.0,4,3.0,3680,0,8,2320,1360,47.4703,3210
215150.0,3,1.0,920,0,6,920,0,47.3654,920
319950.0,2,1.0,1070,2,7,1070,0,47.507,2090
385000.0,3,2.0,1590,0,8,1590,0,47.3731,1670
280000.0,3,2.5,1600,0,8,1600,0,47.3618,1790
399950.0,3,2.5,1510,0,7,1040,470,47.7153,1360
132500.0,3,1.0,1080,0,7,1080,0,47.32,1200
399950.0,2,0.75,1330,0,7,930,400,47.5671,1330
290000.0,2,1.0,850,0,7,850,0,47.7282,870
860000.0,5,2.25,1960,0,8,1290,670,47.6066,1720
3100000.0,6,4.25,6980,4,12,5330,1650,47.5552,3930
245000.0,4,1.0,1530,0,7,1400,130,47.5015,1530
255000.0,3,1.5,1320,0,7,1320,0,47.5068,2000
310000.0,4,3.0,2320,0,7,2320,0,47.7703,2050
299000.0,3,1.0,960,0,7,960,0,47.7763,1080
575000.0,4,2.5,2040,0,8,2040,0,47.5719,2130
284000.0,3,1.0,1080,0,7,1080,0,47.7401,1850
840000.0,3,1.75,2020,0,8,1090,930,47.6726,1680
442573.0,3,1.75,1780,0,7,1290,490,47.7314,1910
560000.0,3,1.0,1140,0,8,1140,0,47.6948,1350
485000.0,3,2.0,1610,0,7,1010,600,47.5421,1040
472500.0,4,1.75,1440,0,7,1440,0,47.6775,1720
1610000.0,4,2.75,4270,0,11,4270,0,47.5951,3860
808000.0,8,3.75,3460,0,7,2860,600,47.6617,2170
398000.0,3,1.75,1890,0,7,1890,0,47.7663,1820
340000.0,3,2.5,2240,0,8,2240,0,47.4837,2400
380000.0,2,1.0,760,0,6,760,0,47.5462,1130
235000.0,3,1.0,1020,0,6,780,240,47.5042,1330
400000.0,3,1.5,1330,0,7,1330,0,47.7167,1940
582000.0,5,2.5,2780,0,8,1590,1190,47.5681,2750
209000.0,2,1.0,1070,0,6,1070,0,47.4989,1130
335000.0,5,3.0,2660,0,7,1670,990,47.46,1610
285950.0,2,1.0,710,0,6,710,0,47.5122,1100
645000.0,5,2.25,3340,0,8,3340,0,47.4553,2460
312000.0,2,1.0,1160,0,7,1160,0,47.6499,1110
663000.0,3,2.25,2840,0,7,1580,1260,47.5828,2220
443950.0,3,1.75,2000,0,6,2000,0,47.5217,2100
315000.0,3,2.0,1060,0,7,1060,0,47.5523,1080
302200.0,4,1.5,1730,0,7,1730,0,47.4497,1510
770000.0,3,2.5,2190,3,9,2190,0,47.6528,2315
374950.0,4,1.75,1660,0,8,1660,0,47.4483,1800
330000.0,3,2.5,2210,0,9,2210,0,47.3079,2440
230000.0,2,1.0,870,0,6,570,300,47.5404,1730
967000.0,4,2.5,3100,0,9,3100,0,47.6961,1240
536500.0,4,2.5,1720,2,8,1470,250,47.591,1140
315000.0,6,4.0,3120,2,7,2090,1030,47.5305,1460
626000.0,3,1.0,1040,0,7,860,180,47.6768,1170
334009.0,4,2.0,1650,0,6,1650,0,47.7183,1860
429000.0,2,1.0,1010,0,7,1010,0,47.6715,1410
818000.0,4,2.5,4020,0,10,4020,0,47.7467,3440
326000.0,5,2.75,2166,0,8,2166,0,47.3461,2474
310000.0,5,3.0,1880,0,7,1100,780,47.5453,1640
525000.0,4,2.0,2260,0,7,1130,1130,47.7193,1800
350000.0,3,2.25,2010,0,7,2010,0,47.4735,1720
936000.0,4,2.5,3330,0,10,3330,0,47.6484,3150
226000.0,3,1.0,1520,0,7,1030,490,47.4527,1530
1250000.0,5,3.5,3510,0,10,2700,810,47.669,1460
428000.0,3,1.75,1580,2,7,1580,0,47.2303,2040
329932.0,3,1.5,1460,0,7,1100,360,47.7112,2330
539000.0,3,1.5,1460,0,7,1100,360,47.7112,2330
275000.0,3,1.75,1650,0,8,1650,0,47.3155,2020
590000.0,4,2.5,2660,2,9,2660,0,47.4816,2330
782000.0,4,2.5,3510,0,10,3510,0,47.6772,3530
575000.0,4,2.5,2120,0,8,2120,0,47.5348,1990
509000.0,3,2.25,1780,0,7,1780,0,47.7484,1780
290000.0,4,2.5,2000,0,7,1200,800,47.353,1800
305240.0,3,1.0,1300,0,7,1300,0,47.7352,1500
555000.0,3,2.0,2180,2,8,1680,500,47.573,1850
317000.0,3,2.0,1790,0,7,1390,400,47.4658,1880
430000.0,3,2.0,1910,0,8,1910,0,47.6312,1980
850000.0,2,1.5,1800,4,7,900,900,47.5934,2090
469000.0,3,2.25,2620,0,7,1660,960,47.7643,1820
327200.0,2,2.0,1440,0,6,1440,0,47.4831,1430
835000.0,3,3.0,2790,4,8,1600,1190,47.3571,2990
360000.0,4,2.5,2340,0,8,2340,0,47.374,2340
372000.0,4,2.5,2070,0,8,2070,0,47.5072,2010
453000.0,3,1.0,2160,0,7,2160,0,47.7277,2270
275000.0,2,1.75,2090,0,7,1090,1000,47.4594,1940
475000.0,4,2.5,2040,0,7,2040,0,47.7399,2040
310000.0,4,2.75,1950,0,7,1400,550,47.3969,2300
173000.0,4,2.0,1200,0,7,1200,0,47.4413,1350
313500.0,5,3.0,2240,0,6,2240,0,47.481,1780
345000.0,3,2.5,1360,0,8,1360,0,47.549,1360
436000.0,3,1.5,1500,0,8,1300,200,47.7598,1950
244500.0,2,1.75,1300,0,6,650,650,47.4989,1370
206000.0,3,1.75,1140,0,7,1140,0,47.3063,1370
890000.0,4,2.5,2930,0,9,2930,0,47.7065,3590
329950.0,4,2.25,2140,0,8,2140,0,47.2654,2140
250000.0,3,1.75,1628,0,7,1628,0,47.2558,1490
246000.0,3,2.0,1990,0,7,1990,0,47.2507,2760
440000.0,3,1.75,1950,0,7,1150,800,47.7685,2560
395000.0,4,1.75,1910,0,7,1460,450,47.7344,1810
305000.0,3,1.0,820,0,6,820,0,47.5514,1100
160000.0,3,2.25,1470,0,7,1160,310,47.2729,1670
269000.0,3,2.25,1470,0,7,1160,310,47.2729,1670
169500.0,3,1.0,1060,0,6,1060,0,47.2869,1060
690500.0,4,2.75,3130,0,8,3130,0,47.7397,1450
245560.0,2,1.5,1260,0,7,1260,0,47.7775,1800
345000.0,4,2.75,2200,0,8,2200,0,47.3148,2190
383000.0,4,1.75,2580,2,8,1290,1290,47.5067,1970
388500.0,3,2.25,1350,0,8,1050,300,47.5997,1350
250000.0,3,1.75,1350,0,7,1350,0,47.3179,1660
455500.0,3,1.75,2290,0,9,1650,640,47.3837,2900
672000.0,3,1.0,1220,0,7,1220,0,47.6088,1390
550000.0,4,1.5,2750,0,7,1500,1250,47.4345,1470
487000.0,3,1.75,1430,0,7,1430,0,47.6371,1750
291375.0,4,2.5,2220,0,7,2220,0,47.4887,2220
225000.0,3,1.0,1490,0,7,1490,0,47.7411,1950
519950.0,5,3.5,2440,0,7,2440,0,47.5814,2000
250000.0,3,2.5,2070,0,8,2070,0,47.3099,2070
614950.0,3,1.0,1500,0,7,1500,0,47.6333,1780
599500.0,4,2.25,2020,0,7,2020,0,47.6801,2020
625000.0,4,1.5,2190,3,8,2190,0,47.7658,2520
248500.0,2,1.0,780,0,7,780,0,47.4913,1090
469950.0,5,2.0,1220,0,6,1090,130,47.6677,1790
525000.0,3,1.5,1840,0,8,1840,0,47.6746,1680
787500.0,2,2.5,2390,3,8,1810,580,47.5101,2390
485000.0,4,2.5,3710,0,10,2130,1580,47.3528,3674
310000.0,2,1.0,750,0,6,750,0,47.5324,1030
280000.0,5,2.0,2110,0,7,1110,1000,47.5164,1590
200000.0,4,1.0,1020,0,6,1020,0,47.7617,2250
490000.0,3,2.5,3080,0,9,3080,0,47.4473,2860
146000.0,3,1.0,900,0,6,900,0,47.3038,900
500000.0,5,3.0,3720,4,9,2090,1630,47.3296,1870
242500.0,3,1.0,940,0,6,940,0,47.4516,1210
324950.0,3,1.0,1040,0,7,1040,0,47.7287,1160
231500.0,2,1.0,1000,0,6,1000,0,47.49,1060
300000.0,3,2.5,2080,0,8,2080,0,47.3058,2660
545000.0,4,2.5,2500,0,9,2500,0,47.4736,2765
350000.0,3,1.0,1050,0,6,1050,0,47.7451,1460
467100.0,3,1.75,1620,0,7,1190,430,47.6651,2010
180000.0,3,1.0,1610,0,7,1610,0,47.3717,1070
749000.0,4,1.5,2130,0,8,2130,0,47.5828,2560
245000.0,3,2.5,1460,0,7,1460,0,47.2984,1640
260000.0,5,1.0,1600,0,7,1600,0,47.3943,1600
490000.0,3,3.0,1730,0,7,1730,0,47.6911,1690
565000.0,4,2.5,2280,0,8,2280,0,47.5895,2280
330000.0,4,2.25,2430,0,8,2430,0,47.4406,2070
295000.0,3,1.0,1380,0,7,1380,0,47.5139,1320
725000.0,3,1.5,1790,0,7,1790,0,47.6754,1290
1135000.0,4,2.5,3370,0,10,3370,0,47.6591,2950
680000.0,3,2.25,2920,0,8,1710,1210,47.7065,1940
490000.0,2,1.0,2180,0,7,1090,1090,47.7032,1830
635000.0,3,1.75,1480,0,7,1200,280,47.686,1480
750000.0,3,2.5,2350,0,9,2350,0,47.1622,1280
330000.0,4,2.25,2440,0,8,2440,0,47.3126,2110
270000.0,3,2.5,1350,0,7,1080,270,47.5218,1300
340000.0,3,2.25,1970,0,7,1970,0,47.4907,1780
413252.0,3,0.75,1110,0,7,1110,0,47.6834,1610
600000.0,4,2.75,2950,0,9,2950,0,47.7368,2940
726888.0,5,3.0,2970,0,9,2970,0,47.5994,2970
285000.0,2,1.0,720,0,6,720,0,47.5286,1030
365000.0,2,1.0,770,0,6,770,0,47.6951,1170
295000.0,4,2.0,1650,0,7,1650,0,47.7543,1410
460000.0,3,2.25,1620,0,7,1170,450,47.7248,1800
230000.0,3,1.5,1510,0,7,1510,0,47.3775,1360
337000.0,3,1.0,1070,0,7,1070,0,47.7207,1170
300000.0,3,1.0,1010,0,7,1010,0,47.7304,1480
2300000.0,4,2.5,3370,0,10,2240,1130,47.6349,3190
360000.0,4,2.5,2000,0,8,2000,0,47.3552,2000
585000.0,3,2.5,2060,0,8,2060,0,47.5675,2180
182700.0,3,2.25,1740,0,7,1240,500,47.2979,1740
305000.0,3,2.25,1740,0,7,1240,500,47.2979,1740
309950.0,3,2.5,1880,0,7,1880,0,47.4439,1810
550000.0,3,1.0,960,0,7,960,0,47.6891,1220
825000.0,3,2.5,3280,3,11,2670,610,47.6395,3280
998500.0,2,1.0,1570,0,8,1570,0,47.6112,1850
644500.0,4,2.5,2990,0,8,2990,0,47.6124,2990
320000.0,3,2.0,1250,0,7,1250,0,47.5066,1620
266950.0,3,2.5,1920,0,7,1920,0,47.3745,2240
633100.0,4,2.5,2470,0,9,2470,0,47.6303,2440
395000.0,2,1.0,960,0,7,960,0,47.6955,1350
259250.0,3,1.0,940,0,6,940,0,47.699,870
300000.0,3,1.0,1260,0,6,1260,0,47.6492,1180
413000.0,3,1.75,2280,0,8,2280,0,47.291,2280
435000.0,3,2.25,1740,0,8,1240,500,47.7758,2080
500000.0,4,2.75,2630,0,7,1690,940,47.7425,1800
402000.0,4,1.75,2430,0,8,1430,1000,47.5569,2050
777700.0,3,2.5,2260,0,10,2260,0,47.4096,1610
580000.0,2,1.5,1220,2,7,1220,0,47.6624,2090
570000.0,3,1.75,2580,0,9,1390,1190,47.7637,2460
174950.0,2,1.0,730,0,6,730,0,47.3832,1750
300000.0,2,1.0,760,0,6,760,0,47.5874,1750
435000.0,3,1.5,1740,0,7,1600,140,47.7211,1650
840000.0,4,2.5,3420,0,10,3420,0,47.6328,3230
469000.0,5,2.5,2240,0,7,1140,1100,47.7756,2110
870000.0,4,1.75,1920,0,8,1920,0,47.6382,1920
532000.0,4,1.75,2020,0,7,1430,590,47.6983,1780
455000.0,4,1.5,1880,0,7,1280,600,47.7718,1880
201000.0,3,1.0,1010,0,5,1010,0,47.7242,1570
649000.0,5,3.25,3990,0,9,2400,1590,47.3632,2580
445500.0,2,1.75,1390,0,6,720,670,47.6914,920
475000.0,3,2.0,1230,0,7,1230,0,47.7017,1660
590000.0,4,2.5,2940,0,10,2940,0,47.7635,3010
565000.0,4,1.5,2190,0,7,2190,0,47.5158,1160
110000.0,1,1.0,640,0,5,640,0,47.5144,1090
375000.0,3,2.5,1670,0,7,1130,540,47.5222,1220
255000.0,3,1.5,1240,0,7,1240,0,47.4478,1570
315000.0,5,1.75,1850,0,6,1760,90,47.4935,1250
496600.0,4,2.25,2020,0,8,1350,670,47.5488,2060
380000.0,3,1.0,1020,0,7,1020,0,47.5615,1400
338950.0,3,1.75,1610,0,7,1610,0,47.3443,2050
542500.0,5,3.5,2730,0,8,1530,1200,47.4587,3180
739000.0,5,2.5,2840,0,7,1620,1220,47.5817,2200
549000.0,4,1.75,1290,0,7,1290,0,47.6798,1510
252000.0,3,2.25,1670,0,7,1190,480,47.4105,1870
1698890.0,4,4.5,3860,4,11,2940,920,47.56,3750
735000.0,4,1.75,2460,0,7,1450,1010,47.6782,1560
270000.0,4,2.5,1660,0,7,1660,0,47.3761,1060
2250000.0,3,2.5,3420,0,9,2890,530,47.6352,3370
155000.0,2,1.0,1010,0,5,1010,0,47.7105,830
469000.0,4,2.5,2240,0,7,1520,720,47.5574,2240
305000.0,4,2.25,2340,0,7,2340,0,47.5183,1540
675000.0,3,1.75,1920,0,7,960,960,47.6645,1190
931000.0,3,2.5,2460,0,8,1560,900,47.6364,2090
385000.0,3,1.0,1470,0,8,1470,0,47.746,1710
815000.0,3,2.5,3400,0,9,3400,0,47.5611,3250
531000.0,3,2.25,1910,0,7,1910,0,47.73,2410
386500.0,4,1.0,1400,0,6,700,700,47.5972,1690
475580.0,3,1.75,1520,0,8,1520,0,47.646,2310
358000.0,2,1.0,930,0,6,930,0,47.7095,1080
677500.0,5,1.0,2340,0,8,1810,530,47.5895,2100
868500.0,3,2.5,2920,0,10,2920,0,47.531,2920
599380.0,3,1.75,1270,0,7,1270,0,47.6046,1880
712000.0,4,2.25,2450,0,10,2450,0,47.6351,2600
350000.0,5,1.75,1380,0,7,1180,200,47.5279,1990
875000.0,4,2.0,2520,0,8,1400,1120,47.6767,1580
365000.0,3,2.25,2290,0,8,2290,0,47.429,2170
452000.0,4,2.0,1660,0,6,850,810,47.5371,1110
915000.0,3,2.75,2800,0,7,1400,1400,47.5862,2800
482500.0,3,2.5,1690,0,7,1690,0,47.6763,1690
425000.0,3,1.0,1180,0,7,1180,0,47.7121,2240
460000.0,2,1.75,1390,0,6,790,600,47.6681,1090
666570.0,4,2.0,2320,0,7,1620,700,47.5558,1740
390000.0,3,2.25,2270,0,8,1740,530,47.3451,2310
650000.0,4,1.75,2640,0,7,1500,1140,47.5819,2070
305000.0,3,2.0,1680,0,7,1680,0,47.1959,2080
250000.0,3,1.0,990,0,6,990,0,47.4839,1210
438800.0,4,2.5,2770,0,9,2770,0,47.4541,2770
290000.0,2,1.0,950,0,6,950,0,47.5149,1250
324950.0,4,2.0,2160,0,7,1290,870,47.4777,1570
453000.0,3,2.5,1650,0,7,1270,380,47.6666,1550
556000.0,3,1.0,1800,0,7,1160,640,47.6876,1240
315000.0,3,2.0,1660,0,8,1660,0,47.4897,1660
445830.0,3,2.5,1870,0,8,1870,0,47.7557,2000
1260000.0,3,3.5,3220,4,10,2760,460,47.5909,3080
287200.0,3,3.0,1850,0,7,1090,760,47.3493,1410
525000.0,4,1.5,1580,0,7,1290,290,47.6873,1690
1135000.0,4,4.25,4590,0,10,3160,1430,47.6973,3800
381000.0,3,1.75,2700,0,7,1510,1190,47.4817,1620
360000.0,3,1.75,1020,0,7,1020,0,47.7362,1020
619000.0,5,3.5,2950,0,8,2950,0,47.5923,1580
535000.0,2,1.75,1780,0,8,1780,0,47.4158,2060
402000.0,2,1.0,710,0,7,710,0,47.6765,1530
600000.0,4,3.5,4300,0,10,2710,1590,47.4472,3520
549950.0,3,2.5,2080,0,8,1430,650,47.4424,2400
300000.0,4,2.0,2360,0,7,1180,1180,47.5044,1680
360000.0,6,2.0,2210,0,7,2210,0,47.4751,1390
419000.0,7,3.25,4340,0,7,2550,1790,47.52,1890
510000.0,3,3.0,1320,0,8,1320,0,47.6904,1320
319950.0,3,2.5,1980,0,8,1980,0,47.1903,2050
1180000.0,5,5.0,3960,0,10,3960,0,47.38,2240
381000.0,4,2.5,2130,0,8,2130,0,47.4518,1940
256900.0,3,2.5,1720,0,7,1720,0,47.4033,1720
346000.0,5,1.0,1790,0,7,1350,440,47.3469,2420
465000.0,2,2.25,1390,0,7,1340,50,47.6754,1480
545000.0,3,2.0,1900,0,8,1500,400,47.5307,2140
516000.0,2,1.75,1640,0,7,910,730,47.679,1510
550000.0,4,2.5,2700,0,8,1440,1260,47.5331,1880
339950.0,4,2.25,2200,0,7,2200,0,47.3595,1740
417000.0,3,1.0,1310,0,7,1310,0,47.7502,1310
906000.0,4,2.5,2480,3,8,1480,1000,47.6653,2240
980000.0,4,2.25,3010,0,9,3010,0,47.5336,2510
555000.0,4,2.5,2450,0,9,2450,0,47.5214,2690
468000.0,2,1.75,1250,0,7,1250,0,47.6936,1680
378000.0,3,1.75,2610,0,7,1390,1220,47.2585,2140
430000.0,4,2.5,2010,0,8,2010,0,47.4821,1420
730100.0,4,2.5,3120,0,9,3120,0,47.5318,2580
219000.0,4,1.5,1370,0,7,1370,0,47.4224,1370
570000.0,3,2.5,2420,0,9,2420,0,47.6285,2420
262500.0,4,2.75,1500,0,7,1060,440,47.3665,1620
525000.0,5,2.5,2630,0,8,2630,0,47.7379,2020
520000.0,2,1.0,950,0,6,950,0,47.687,1660
417400.0,3,3.0,2680,0,8,2680,0,47.4633,2610
788000.0,4,3.25,3680,0,9,2840,840,47.5367,3620
320000.0,3,1.0,1270,2,7,1270,0,47.4831,1800
950000.0,6,1.0,2330,0,7,2330,0,47.6789,1570
255000.0,3,1.0,960,0,7,960,0,47.7766,1120
260000.0,4,2.5,1990,0,7,1990,0,47.3078,1862
394000.0,3,1.0,1450,0,6,1150,300,47.5212,1040
575000.0,4,2.5,2280,0,8,2280,0,47.7628,2350
1250000.0,4,2.25,1830,2,8,1750,80,47.6315,3100
385000.0,3,2.25,1650,0,7,1260,390,47.7377,1760
456000.0,5,2.75,2720,4,7,1700,1020,47.2838,2820
637000.0,4,2.5,1710,0,8,1110,600,47.6772,1750
485000.0,5,1.5,1420,0,7,1050,370,47.6348,1580
315275.0,3,1.75,1440,0,7,960,480,47.7128,1500
252500.0,2,1.5,1280,0,7,1280,0,47.4472,1520
240000.0,2,1.0,1320,0,7,1320,0,47.4741,1430
790000.0,4,2.5,2560,0,7,1760,800,47.6947,1760
310000.0,3,1.0,1480,0,7,1480,0,47.7703,1450
1250000.0,4,2.5,2960,4,10,2960,0,47.5075,2500
425000.0,2,1.0,1160,0,7,740,420,47.5304,1160
548000.0,3,2.5,2110,0,8,2110,0,47.7508,2110
379880.0,3,2.5,1650,0,7,1130,520,47.4821,1940
530000.0,3,2.5,1950,0,8,1950,0,47.6363,1860
695000.0,3,2.25,2600,0,8,2120,480,47.4562,2760
435000.0,3,1.0,1270,2,7,1270,0,47.5695,1560
540000.0,3,1.75,1300,0,7,1300,0,47.6529,1850
425000.0,3,2.25,1790,0,7,1290,500,47.7492,1840
490000.0,3,2.5,1930,0,8,1930,0,47.7191,1930
220000.0,4,1.0,1200,0,6,1200,0,47.5307,950
540000.0,4,2.5,2050,0,8,2050,0,47.7189,2050
670000.0,3,1.0,1710,0,7,1410,300,47.6706,1610
667500.0,3,1.75,2130,0,9,2130,0,47.6339,2370
585000.0,3,3.5,1700,0,8,1260,440,47.5767,1360
225000.0,3,1.5,1390,0,6,1390,0,47.6496,1390
375000.0,3,1.0,1230,0,7,1230,0,47.5745,1240
335000.0,3,2.0,1490,0,7,1490,0,47.7639,1640
680000.0,5,3.25,2440,0,8,1990,450,47.774,2500
600000.0,3,1.0,970,0,6,970,0,47.6212,1500
161000.0,4,2.0,1700,0,7,850,850,47.4758,1540
220000.0,4,2.0,1700,0,7,850,850,47.4758,1540
420000.0,3,1.75,1720,0,8,1720,0,47.738,1410
710000.0,3,1.0,1400,0,7,1400,0,47.6373,1630
626000.0,4,2.5,2570,0,8,1570,1000,47.6921,2440
279500.0,3,1.5,1200,0,7,1200,0,47.4901,1450
1610000.0,4,3.5,4390,3,11,3060,1330,47.5862,3240
325000.0,2,1.0,1080,0,7,1080,0,47.5682,1010
380000.0,4,2.25,1860,0,8,1860,0,47.4524,1860
470000.0,4,2.75,2150,0,8,1220,930,47.7758,2060
363000.0,4,3.0,2250,0,8,2250,0,47.4338,2300
245000.0,4,2.25,2050,0,7,2050,0,47.3009,1780
525000.0,3,1.0,1010,0,7,1010,0,47.6208,1300
1700000.0,5,3.5,5850,2,11,4670,1180,47.606,3240
658500.0,4,2.25,1900,0,7,1400,500,47.6456,1710
680000.0,2,1.0,1020,4,7,920,100,47.5145,2550
835000.0,4,2.0,3390,0,10,3390,0,47.7222,3950
595000.0,4,2.5,1990,0,8,1680,310,47.6696,1560
419000.0,4,2.5,3190,0,9,3190,0,47.3657,2830
198900.0,2,1.0,1210,0,7,1210,0,47.3752,2250
1085000.0,4,3.25,3740,0,10,2000,1740,47.7214,4210
500000.0,3,3.5,2150,0,8,1610,540,47.6213,2390
575000.0,4,1.75,2440,0,9,1620,820,47.7201,2030
324950.0,2,1.5,1230,0,8,1230,0,47.7265,1352
259000.0,3,2.5,2740,0,7,2740,0,47.473,1470
551000.0,2,2.0,2260,0,9,2260,0,47.7718,2260
488000.0,2,1.5,1000,0,7,1000,0,47.6926,1090
635000.0,4,2.25,2350,0,8,2350,0,47.6657,2390
395000.0,3,2.5,2300,0,9,2300,0,47.4181,2570
370000.0,3,1.0,1440,0,7,1440,0,47.7438,1330
675000.0,4,3.0,2780,0,7,1710,1070,47.5721,1150
402000.0,3,1.0,1200,0,7,1200,0,47.7491,1470
825000.0,3,2.75,3040,0,10,3040,0,47.7108,2770
579000.0,3,2.75,2660,0,8,1330,1330,47.4127,1560
455000.0,5,2.0,1510,0,6,1510,0,47.6029,1610
265000.0,3,2.5,1780,0,8,1780,0,47.2578,2040
713500.0,5,2.75,2920,0,8,1520,1400,47.5668,2250
240000.0,3,1.0,1550,0,7,1550,0,47.5024,1550
570000.0,4,3.0,2710,0,9,2710,0,47.2411,2710
243800.0,3,1.0,1140,0,6,1140,0,47.5372,1690
543000.0,2,1.0,940,0,8,940,0,47.6631,1440
1010000.0,3,2.25,2160,0,10,2160,0,47.6232,1550
625000.0,4,2.25,2470,0,8,2470,0,47.5924,2470
459950.0,4,2.5,2800,0,9,2800,0,47.3555,3400
370000.0,4,2.75,2420,0,9,2420,0,47.4053,2760
150000.0,4,2.0,1460,0,6,1460,0,47.5056,1460
683500.0,3,1.5,1820,0,7,1640,180,47.6479,1760
499950.0,3,2.5,1520,0,8,1040,480,47.6419,1610
255000.0,2,1.0,1320,0,6,940,380,47.5693,1970
279000.0,3,2.5,1920,0,7,1920,0,47.4024,1960
910000.0,5,3.0,2640,0,10,2640,0,47.6809,1610
699000.0,4,2.5,2650,0,9,2650,0,47.7113,1200
1651000.0,4,3.25,3640,0,9,2570,1070,47.6293,2760
248000.0,3,1.0,1420,0,6,1090,330,47.3746,1480
429000.0,3,1.0,1540,0,7,1090,450,47.3259,1820
685000.0,4,1.0,1550,4,6,1370,180,47.4502,1790
316000.0,2,1.0,730,0,6,730,0,47.5387,790
410000.0,2,1.0,2020,0,7,1010,1010,47.5359,1270
299000.0,3,1.0,1200,2,7,1200,0,47.4991,1410
559000.0,2,1.0,1240,1,7,1060,180,47.5493,1240
575000.0,3,2.25,2680,0,8,1580,1100,47.4776,2540
602000.0,3,2.5,1640,0,8,1640,0,47.6103,1440
492000.0,4,2.0,1640,0,7,1640,0,47.6662,1240
293500.0,3,2.5,1610,0,7,1610,0,47.3833,1790
481000.0,3,2.75,2290,0,7,1400,890,47.5343,2540
311100.0,4,2.25,2130,0,7,1380,750,47.4482,2300
375000.0,3,1.75,2140,0,7,1620,520,47.7139,930
1075000.0,3,3.0,4020,2,10,4020,0,47.4418,2590
500000.0,5,2.5,2030,0,7,1330,700,47.6713,1920
553000.0,3,1.0,1380,0,7,1380,0,47.5514,2270
760000.0,3,2.0,1780,2,8,1400,380,47.6797,1780
589500.0,4,1.5,1440,1,7,960,480,47.5269,1650
840000.0,5,2.75,2790,0,9,1680,1110,47.6948,2380
2546000.0,4,3.0,4190,2,9,3490,700,47.6181,3780
1275000.0,3,2.5,3870,3,9,3870,0,47.5966,4030
260000.0,3,2.5,1850,0,7,1250,600,47.434,1930
430000.0,3,2.25,1550,0,8,1550,0,47.6911,1520
781000.0,3,2.5,1920,3,8,1920,0,47.6616,1670
280000.0,2,1.0,790,0,6,790,0,47.5487,970
392000.0,5,2.25,3740,0,8,2240,1500,47.3965,2040
466200.0,3,1.5,1340,0,7,1340,0,47.6094,1850
641000.0,3,1.75,1620,0,7,940,680,47.6786,1320
350000.0,3,1.0,1680,0,7,840,840,47.6993,1890
450000.0,3,2.0,1610,0,8,1610,0,47.5672,2010
1800000.0,4,3.5,4460,0,9,2550,1910,47.6338,1980
185000.0,3,1.5,1200,0,8,1200,0,47.4658,1270
290000.0,2,1.0,1250,0,7,1250,0,47.4972,1250
964000.0,3,2.5,3630,0,11,3630,0,47.6544,3250
2000000.0,4,3.0,4260,2,11,4260,0,47.5355,3540
545000.0,3,2.5,2180,0,8,1850,330,47.592,2270
609950.0,3,2.25,1760,0,7,1330,430,47.6605,2210
605000.0,4,2.0,1820,0,7,990,830,47.6878,1390
550000.0,4,2.5,2120,0,8,1450,670,47.5551,2120
905000.0,4,2.75,2730,1,9,2730,0,47.6397,2340
384200.0,3,2.5,2430,0,8,2430,0,47.4383,2440
370000.0,3,1.0,1170,0,7,1170,0,47.5448,1380
717500.0,3,1.0,2090,2,8,1890,200,47.6393,2090
1999000.0,4,3.25,3910,2,11,2550,1360,47.6448,3070
365500.0,2,1.0,1140,0,6,1140,0,47.7673,2110
580000.0,2,1.5,1460,0,7,1460,0,47.6838,1780
415000.0,4,1.5,2700,0,9,2700,0,47.1996,1670
272000.0,2,1.0,670,0,6,670,0,47.5145,740
600000.0,3,1.75,1880,0,7,1040,840,47.6878,1770
744000.0,4,3.0,1980,0,8,1980,0,47.532,1680
830000.0,3,3.0,2080,0,9,2080,0,47.6987,3730
322000.0,3,3.25,1380,0,7,1380,0,47.7035,1380
270000.0,3,2.5,1808,0,8,1808,0,47.2598,1450
272450.0,3,1.0,1350,0,7,1350,0,47.4323,1310
605000.0,3,3.0,1760,0,7,1400,360,47.6666,1300
510000.0,3,1.75,1950,0,7,1950,0,47.7685,1950
1125000.0,4,3.5,3170,0,10,2340,830,47.6265,1770
1688000.0,4,2.5,3000,0,9,3000,0,47.6571,2580
162000.0,4,1.0,1460,0,6,1460,0,47.3431,1460
337500.0,3,1.75,1350,0,7,1050,300,47.4225,1710
312000.0,3,2.25,1470,0,7,1180,290,47.4547,1900
740000.0,4,3.0,3350,0,10,3350,0,47.3602,3350
700000.0,4,3.0,3350,0,10,3350,0,47.3602,3350
328000.0,4,1.0,1360,0,7,1360,0,47.7366,1570
241000.0,3,1.0,1020,0,7,1020,0,47.3587,1650
265000.0,3,2.25,1840,0,7,1270,570,47.4075,1750
246000.0,5,1.75,2030,0,7,2030,0,47.2867,1760
271000.0,4,1.75,1490,0,6,970,520,47.4991,1650
270000.0,2,1.0,2060,0,7,1260,800,47.509,1690
395000.0,4,2.0,2240,0,7,2240,0,47.7309,1440
340000.0,3,2.0,1460,0,7,1460,0,47.54,1400
340000.0,3,1.75,2140,0,7,1240,900,47.5074,1640
335000.0,2,2.25,1420,0,8,1420,0,47.5394,1420
435000.0,2,1.0,1060,0,6,1060,0,47.6578,1730
527950.0,4,1.75,1760,0,7,880,880,47.6889,1500
600000.0,2,2.25,2320,4,8,2320,0,47.3905,1610
667000.0,3,1.75,1770,0,8,1300,470,47.6846,1430
1148000.0,10,5.25,4590,2,9,2500,2090,47.5861,2730
417000.0,3,2.5,2040,0,8,2040,0,47.4867,1830
451000.0,4,1.75,1260,0,6,1260,0,47.5267,1880
580000.0,2,1.0,1650,0,7,950,700,47.6549,1650
570000.0,4,2.25,2380,0,8,2380,0,47.7644,2790
750000.0,5,3.25,2750,1,7,2150,600,47.6636,2750
685000.0,3,2.5,2810,0,9,2810,0,47.5464,2910
275000.0,3,2.0,1340,0,7,1340,0,47.6786,1310
739888.0,3,2.5,2420,4,8,1690,730,47.569,3740
715000.0,2,2.5,2160,0,8,2160,0,47.7017,2315
800000.0,4,2.0,2450,0,7,1450,1000,47.6414,1890
350000.0,3,1.5,1870,0,7,1120,750,47.5224,1850
220000.0,3,1.0,1000,2,6,1000,0,47.2099,1710
452500.0,3,2.5,2240,0,7,2240,0,47.5361,2480
280000.0,4,2.5,2200,0,7,2200,0,47.3333,2200
248000.0,1,1.0,790,0,6,790,0,47.5146,1900
305000.0,2,1.0,890,0,7,740,150,47.6998,1290
435010.0,3,1.0,1270,0,7,1120,150,47.5293,1220
678100.0,3,1.75,1850,0,8,1210,640,47.5853,1660
325000.0,3,2.25,1352,0,8,1352,0,47.7265,1439
529950.0,3,2.0,1540,0,7,1180,360,47.6554,1550
440000.0,3,1.75,1640,0,7,1640,0,47.7751,1730
585000.0,3,1.0,1350,0,7,1350,0,47.5749,1360
462608.0,3,2.5,2010,0,8,1390,620,47.5528,1540
350500.0,3,1.75,2080,0,7,1040,1040,47.4738,1410
210000.0,3,1.0,1040,0,7,1040,0,47.3171,1200
510000.0,3,2.5,1890,0,8,1890,0,47.5697,2060
280000.0,3,2.25,1810,0,7,1810,0,47.497,1830
385000.0,3,1.75,1930,0,7,1130,800,47.7733,1730
349000.0,3,1.0,1010,0,6,1010,0,47.7416,1010
252000.0,3,2.25,1740,0,7,910,830,47.3976,2090
1100000.0,4,2.5,2910,1,10,1940,970,47.6424,2540
375000.0,3,2.25,1330,0,7,1330,0,47.7098,1300
336000.0,4,2.25,2210,0,8,2210,0,47.3648,2040
732000.0,3,3.75,2670,4,8,2020,650,47.5702,2010
200000.0,2,1.0,1000,0,6,1000,0,47.513,1240
681716.0,4,2.5,3150,0,9,3150,0,47.5159,3030
235000.0,3,1.75,1520,0,6,1520,0,47.3434,1460
257500.0,3,1.0,1690,0,7,1210,480,47.4256,1190
315000.0,3,1.0,1070,0,7,1070,0,47.7425,1710
299950.0,3,1.0,910,0,6,740,170,47.7746,2090
530000.0,4,2.25,2130,0,7,1430,700,47.7087,2120
766500.0,2,1.75,2230,0,8,1530,700,47.6705,1970
860000.0,4,2.5,3560,2,10,2290,1270,47.6456,3290
690000.0,3,2.5,2590,0,9,2590,0,47.5271,1230
551000.0,4,1.75,2040,0,7,1020,1020,47.6964,1770
530000.0,3,2.75,2100,0,7,2100,0,47.7206,2100
568000.0,3,1.0,1340,0,7,1340,0,47.7016,1830
749950.0,3,2.5,2770,2,9,2770,0,47.5754,2530
535000.0,3,2.5,2400,0,9,2400,0,47.6317,2940
234300.0,3,1.0,1140,0,7,1140,0,47.424,1520
190000.0,2,1.0,930,0,6,930,0,47.4862,1150
525000.0,4,1.75,1820,0,7,1820,0,47.606,1430
610000.0,4,1.0,1390,0,7,1390,0,47.685,1430
520000.0,3,2.5,1480,0,8,1480,0,47.6199,1480
375000.0,2,1.0,760,0,6,760,0,47.646,1360
600000.0,3,1.75,1580,0,7,1150,430,47.6056,1730
664000.0,4,2.5,1870,0,8,1250,620,47.6651,2000
698000.0,2,1.0,1510,0,7,1010,500,47.6742,1660
418000.0,3,2.0,1250,0,7,1250,0,47.6705,1320
271675.0,3,1.75,2140,0,7,1460,680,47.3099,2090
450000.0,3,1.0,1540,0,6,1540,0,47.6698,1450
759000.0,3,2.25,2950,0,9,2950,0,47.5917,3880
599950.0,6,3.0,2020,0,7,1230,790,47.6648,2080
810000.0,4,2.75,2820,0,8,2170,650,47.6376,1740
331292.0,3,1.75,1660,0,7,1660,0,47.741,1770
348000.0,3,1.75,1830,0,7,930,900,47.5723,1320
435000.0,2,1.0,720,0,7,720,0,47.5641,1330
530000.0,3,2.5,2160,0,8,2160,0,47.7296,2160
227000.0,3,1.75,1510,0,7,1510,0,47.2576,1470
285000.0,3,1.5,1870,0,7,1870,0,47.509,1870
740000.0,4,2.25,2860,0,8,1640,1220,47.6033,2670
246000.0,3,1.0,990,0,6,990,0,47.5022,1640
260000.0,3,1.0,1910,0,7,1080,830,47.5038,1460
366000.0,3,2.0,1350,0,7,1350,0,47.6159,1820
594950.0,4,3.25,2557,2,7,2557,0,47.5449,2220
608000.0,3,2.75,2610,0,7,1710,900,47.6729,1500
313100.0,3,2.0,1720,0,6,1720,0,47.5068,1860
185000.0,3,1.75,1170,0,7,1170,0,47.2808,1230
455000.0,2,1.0,1140,0,6,1140,0,47.5328,1550
235000.0,3,2.5,2350,0,8,1570,780,47.3126,2270
230000.0,3,1.0,1020,0,7,1020,0,47.4235,1300
770000.0,4,2.25,2730,0,7,1460,1270,47.5843,2010
240000.0,4,2.25,1830,0,7,1830,0,47.3682,1860
461000.0,3,2.5,1690,0,7,1690,0,47.6885,1650
1580000.0,4,2.5,2900,3,8,1450,1450,47.5838,2900
1822500.0,4,4.5,6380,0,12,6380,0,47.5592,3040
452000.0,3,2.5,1690,0,7,1690,0,47.6788,1690
765000.0,4,2.5,2660,2,9,2660,0,47.5445,3010
1050000.0,4,4.0,4550,1,9,2300,2250,47.5964,3540
546000.0,3,3.0,1530,0,7,1150,380,47.6869,1530
781000.0,3,2.5,2070,0,8,1780,290,47.6853,2070
538000.0,4,1.75,1880,0,7,1880,0,47.5838,1750
790000.0,4,2.5,2240,0,8,1470,770,47.6621,2210
696500.0,4,2.75,2540,0,7,1630,910,47.6832,1560
276000.0,3,2.0,1370,0,7,1370,0,47.2802,1660
269000.0,2,1.0,770,0,6,770,0,47.7547,1290
2415000.0,5,4.75,7880,2,13,7880,0,47.7334,2740
829000.0,4,2.75,2970,2,8,1610,1360,47.5953,2930
122000.0,2,1.0,740,0,6,740,0,47.5168,740
352500.0,3,1.5,1360,0,7,1360,0,47.7441,1630
249000.0,4,2.0,1280,0,6,1280,0,47.45,1250
360000.0,4,2.0,1920,0,7,1080,840,47.758,1940
629500.0,3,2.0,2020,0,10,2020,0,47.5851,3030
1140000.0,4,2.25,3310,0,9,3310,0,47.732,3830
1550000.0,2,2.25,2950,0,8,1560,1390,47.6209,2060
275000.0,3,1.5,1320,0,7,1320,0,47.4908,1370
697000.0,4,2.5,3160,0,8,3160,0,47.6125,3110
379500.0,2,1.0,1640,0,7,840,800,47.6397,2440
720000.0,3,2.75,2440,0,10,1640,800,47.7672,1890
675000.0,4,2.5,3000,0,9,3000,0,47.5399,2870
1169000.0,5,2.5,2810,0,9,2810,0,47.6367,2240
1100000.0,3,2.0,2390,1,8,2390,0,47.6839,2390
520000.0,4,1.0,2080,0,7,1260,820,47.5445,1380
415000.0,3,1.75,2650,0,7,1590,1060,47.7716,1340
415000.0,3,2.5,1060,0,8,1060,0,47.6907,1220
450000.0,3,2.25,1940,1,7,1220,720,47.4556,2060
485000.0,2,1.0,1080,0,8,1080,0,47.6899,1890
294000.0,3,2.25,1700,0,7,1700,0,47.39,1930
1037000.0,4,3.5,4440,0,11,4440,0,47.5294,4390
690000.0,3,1.0,1580,0,8,1580,0,47.6363,2190
716500.0,5,2.75,3630,0,11,3630,0,47.4289,4440
481000.0,2,2.25,1290,0,8,1290,0,47.6718,1290
575000.0,4,2.75,1960,0,7,1000,960,47.5693,1830
785000.0,3,2.0,2090,0,7,2090,0,47.6378,1930
480000.0,3,1.75,1960,0,7,1960,0,47.4915,1960
720000.0,3,2.25,2120,0,8,2120,0,47.5561,2620
536000.0,3,2.75,2290,3,7,2290,0,47.3691,399
324900.0,4,2.5,1880,0,7,1880,0,47.3642,1570
265000.0,2,1.0,770,0,6,770,0,47.5304,920
545000.0,3,2.5,1530,0,7,1010,520,47.6913,1330
465000.0,2,1.5,1450,0,7,1450,0,47.7281,1890
292500.0,3,2.25,1690,0,7,1690,0,47.3889,1520
860000.0,4,1.75,1880,0,7,1880,0,47.6431,2090
1045000.0,4,3.25,4160,0,10,4160,0,47.7266,3400
495000.0,4,2.5,2140,0,7,2140,0,47.729,2080
342000.0,2,2.0,1320,0,7,1320,0,47.7223,1430
320000.0,4,2.5,2000,0,7,2000,0,47.3625,2000
444000.0,3,2.0,1460,0,8,1460,0,47.6864,1320
804100.0,4,2.5,3070,0,10,3070,0,47.5399,3320
432000.0,3,2.5,1660,0,7,1660,0,47.5803,2060
230000.0,6,1.5,1810,0,5,1050,760,47.4874,1300
935000.0,4,3.5,3510,0,11,3510,0,47.5193,3600
634950.0,3,3.0,2180,0,8,1410,770,47.6891,1570
780000.0,6,4.0,3300,0,8,1960,1340,47.676,2030
611000.0,4,2.5,2460,0,8,2460,0,47.6031,2330
475999.0,4,1.75,1880,0,7,1090,790,47.6646,1700
565000.0,3,2.0,2290,0,9,1670,620,47.5692,2750
630000.0,4,2.5,2290,0,8,2290,0,47.7502,2290
840000.0,4,3.5,3860,0,10,3120,740,47.7095,3550
790000.0,3,2.5,2640,3,10,2640,0,47.1795,1500
450000.0,5,2.5,2850,0,7,1930,920,47.3939,2220
1272000.0,4,3.25,3020,0,8,1920,1100,47.6395,2400
520000.0,3,2.0,1510,0,7,930,580,47.5425,1510
446800.0,4,2.0,2410,0,7,1260,1150,47.5729,2220
652000.0,3,1.0,1470,0,8,1200,270,47.6517,2200
1170000.0,3,2.75,2890,3,10,2830,60,47.6505,2415
745000.0,4,3.25,3490,0,10,3490,0,47.5834,3450
594000.0,3,2.25,1270,0,8,1060,210,47.6647,1160
257000.0,2,1.0,1000,0,6,800,200,47.552,1270
485000.0,4,1.75,1430,0,7,1430,0,47.604,1640
330000.0,3,1.0,1060,0,6,1060,0,47.7281,1768
381000.0,3,2.0,1680,0,6,940,740,47.6379,1550
849900.0,2,2.0,2280,0,9,2280,0,47.4125,2030
793000.0,4,2.5,2450,0,8,1490,960,47.6899,2000
920000.0,3,2.25,3650,4,7,2200,1450,47.5949,1950
455000.0,2,1.0,830,0,6,830,0,47.6909,1420
975000.0,4,2.5,3490,3,11,3490,0,47.559,3260
375000.0,2,1.5,1050,0,8,960,90,47.6028,1470
400000.0,2,2.5,1170,0,8,1170,0,47.6132,1250
447000.0,3,1.0,1220,0,7,1220,0,47.6218,1320
470000.0,3,1.75,1310,0,7,1310,0,47.686,2510
665000.0,4,2.5,3130,0,8,3130,0,47.577,2990
295500.0,3,1.75,1590,0,6,1290,300,47.4817,2990
200000.0,4,2.5,1720,0,8,1720,0,47.2704,1870
620000.0,3,2.25,2520,0,9,1590,930,47.7384,2000
434900.0,3,2.0,1520,0,7,1140,380,47.6326,1280
1328000.0,4,2.25,3260,0,9,2360,900,47.6272,3240
1650000.0,4,3.25,3910,0,10,3910,0,47.6527,2600
852500.0,4,2.5,3480,0,9,2360,1120,47.6841,3620
790000.0,3,2.5,3040,0,10,3040,0,47.7565,3480
565000.0,4,1.75,2030,0,8,2030,0,47.6274,2000
1127500.0,6,3.25,3870,0,10,2520,1350,47.7517,2360
289950.0,3,2.5,1870,0,7,1870,0,47.4899,1720
850000.0,2,2.0,2640,1,8,1640,1000,47.5647,2880
505000.0,4,1.75,1940,0,7,1030,910,47.6054,1450
372000.0,3,2.5,1710,0,7,1710,0,47.7232,1540
207000.0,4,2.0,1690,0,7,1690,0,47.3666,1480
780000.0,3,1.75,2340,0,8,2340,0,47.5386,3120
400000.0,4,1.75,1700,0,7,1340,360,47.7694,1680
440250.0,3,1.5,1850,0,7,1850,0,47.7275,1530
585000.0,2,2.0,1370,0,8,950,420,47.6589,1370
850000.0,4,2.5,2900,0,9,2900,0,47.5536,2901
570000.0,3,3.0,2400,0,7,2400,0,47.6963,1360
869000.0,4,3.0,3740,0,9,3060,680,47.7505,3240
551000.0,4,2.75,2170,0,8,2170,0,47.7484,1170
172380.0,3,1.0,970,0,6,970,0,47.3078,1050
355000.0,3,2.5,2620,3,7,1310,1310,47.2584,2330
728935.0,4,2.5,2980,0,9,2980,0,47.5515,2980
850000.0,3,2.5,2340,2,9,2340,0,47.6512,2415
515000.0,5,1.75,1880,0,6,1880,0,47.5094,1690
215000.0,2,1.0,1480,0,7,1120,360,47.2079,1670
220000.0,4,2.5,2240,0,7,1370,870,47.314,1980
845000.0,4,2.5,2940,0,9,2940,0,47.7054,3120
390000.0,1,1.0,710,0,6,610,100,47.6562,1440
135000.0,4,1.0,1460,0,5,1460,0,47.5006,1320
439000.0,3,1.0,1530,0,8,1290,240,47.4508,2090
585000.0,4,2.5,2630,0,9,2630,0,47.5229,2720
620000.0,5,1.0,2230,3,7,1700,530,47.5161,2730
477000.0,3,1.0,960,0,7,960,0,47.6758,1580
399500.0,2,1.5,1180,0,8,1180,0,47.5626,1490
500000.0,2,1.0,1760,4,7,1300,460,47.3799,2590
432500.0,3,2.5,1340,0,8,1340,0,47.724,1630
940000.0,4,2.25,2800,0,9,1650,1150,47.5893,2800
3168750.0,5,3.5,4330,4,12,2090,2240,47.6251,4320
1080000.0,3,2.5,3720,0,11,3720,0,47.636,3530
229999.0,4,2.0,1670,0,7,1030,640,47.3652,1500
233000.0,3,1.0,1100,0,7,1100,0,47.4374,1300
600000.0,3,2.5,3240,0,8,2910,330,47.5382,2990
334000.0,4,1.5,1680,0,7,1180,500,47.4578,1460
332500.0,3,1.0,1030,0,7,1030,0,47.7353,1340
249900.0,3,2.5,1630,0,7,1120,510,47.3876,1640
310000.0,3,2.0,2610,0,7,1670,940,47.5063,1520
200000.0,2,1.0,1250,0,6,1250,0,47.5158,1040
310000.0,4,1.75,1480,0,7,1480,0,47.5064,1480
230000.0,3,1.0,1390,0,5,1390,0,47.4977,1170
420000.0,4,2.5,1940,0,8,1940,0,47.5461,2050
785000.0,4,2.5,2960,0,9,2960,0,47.5544,2960
1775000.0,3,2.25,4320,0,10,2160,2160,47.6368,3430
265000.0,5,1.5,1500,0,6,760,740,47.4692,1200
295000.0,2,1.0,840,0,6,840,0,47.755,1320
896000.0,4,2.5,3560,0,11,3560,0,47.7268,3520
415000.0,4,2.75,2390,0,9,1390,1000,47.3706,2560
250000.0,3,1.75,1200,0,6,1200,0,47.4959,1270
1475000.0,3,2.5,2570,0,11,2570,0,47.6295,1570
635000.0,5,2.25,2180,0,8,1430,750,47.6235,2160
905000.0,3,2.5,3450,0,10,3450,0,47.739,2810
528000.0,3,2.5,2020,0,7,2020,0,47.6835,2020
530000.0,3,2.5,2480,0,9,2480,0,47.771,2480
310000.0,3,1.5,1140,0,7,1140,0,47.5707,1150
252000.0,3,1.0,1530,0,7,1530,0,47.4915,1530
334500.0,3,2.0,1700,0,7,1120,580,47.74,1740
370000.0,3,1.0,2150,0,8,1610,540,47.6996,1620
311000.0,3,2.0,1190,0,6,1190,0,47.5531,1460
260000.0,3,2.75,1730,2,7,1480,250,47.5327,1570
217500.0,3,1.75,1400,0,7,1400,0,47.3179,1660
290000.0,3,2.5,2200,0,7,2200,0,47.3715,2200
500000.0,3,1.5,960,0,6,960,0,47.6937,2230
423500.0,3,2.0,1770,3,7,1100,670,47.5644,1300
715000.0,4,2.5,2970,0,9,2970,0,47.6134,3940
299000.0,3,2.5,1590,0,7,1590,0,47.5515,1090
635000.0,3,2.5,3350,0,8,2550,800,47.7277,2340
806000.0,4,2.5,3370,0,10,3370,0,47.5896,3360
289950.0,3,2.5,1960,0,7,1960,0,47.4802,2560
280000.0,3,1.75,1360,0,7,1360,0,47.4619,1770
479950.0,3,2.5,2780,0,9,2780,0,47.4569,1940
394000.0,4,2.5,3000,0,7,3000,0,47.3655,1890
682000.0,4,2.5,3600,0,9,3400,200,47.7597,3150
409950.0,2,1.0,990,0,6,990,0,47.6839,1120
1000000.0,4,3.5,2990,4,9,2000,990,47.593,2390
436000.0,4,1.0,1200,2,7,1200,0,47.5372,1810
279000.0,3,1.0,1530,0,7,970,560,47.4766,1540
390000.0,1,1.75,1440,0,7,720,720,47.534,1440
635000.0,3,1.75,1940,1,7,1480,460,47.459,1910
304400.0,4,2.75,2140,0,7,2140,0,47.3075,1960
780000.0,5,1.75,2330,0,7,1360,970,47.6835,2100
520000.0,4,3.5,2734,0,8,2734,0,47.3652,2270
580000.0,3,1.75,1950,0,7,1250,700,47.7019,1290
274000.0,3,1.75,1440,0,7,990,450,47.4333,1550
315000.0,3,2.25,1530,0,7,1150,380,47.4418,1460
390000.0,4,1.75,1910,0,8,1910,0,47.3932,2130
340000.0,5,2.0,1750,0,7,1750,0,47.7694,1210
502000.0,3,2.25,1600,0,8,1600,0,47.7523,2320
260000.0,3,1.75,1750,0,8,1750,0,47.4713,1730
399000.0,2,1.0,940,0,6,940,0,47.5756,980
312500.0,2,1.0,880,0,7,880,0,47.5341,1440
370000.0,3,1.75,1650,0,7,1060,590,47.7596,2280
1240000.0,4,3.5,3820,0,10,3280,540,47.6005,3340
230000.0,3,1.5,1900,0,8,1900,0,47.3352,2010
1275000.0,4,1.75,3720,3,9,1960,1760,47.6425,2540
294350.0,3,1.0,1410,0,6,1210,200,47.5238,1330
208950.0,3,1.0,960,0,5,960,0,47.4983,960
515000.0,2,1.75,1930,0,8,1930,0,47.7173,1810
965000.0,4,2.5,3420,0,11,3420,0,47.5527,3310
925000.0,4,2.75,3010,2,9,2240,770,47.6142,1940
654500.0,4,1.0,1780,0,8,1780,0,47.6761,2030
364000.0,4,2.5,2080,0,8,2080,0,47.472,1850
150000.0,2,1.0,1250,0,7,1050,200,47.3063,1030
349950.0,5,3.0,2257,0,8,1363,894,47.4524,1540
585000.0,3,1.5,1670,0,7,1670,0,47.678,1750
801501.0,4,2.25,2250,0,9,2250,0,47.621,2730
610000.0,3,1.75,1650,0,7,1650,0,47.5297,2520
382000.0,5,2.25,2880,0,8,2880,0,47.3734,2370
495000.0,4,3.0,3620,2,9,3620,0,47.2527,2230
447500.0,3,1.75,1950,0,8,1530,420,47.6934,1660
575000.0,4,2.5,2280,0,7,1290,990,47.6297,1560
565000.0,2,1.75,1740,2,7,1040,700,47.5994,2020
348580.0,3,1.0,1220,0,7,1220,0,47.7317,1340
459000.0,4,1.75,2260,0,8,1660,600,47.6622,2390
375000.0,4,2.0,1790,2,7,1790,0,47.7216,1790
310000.0,4,2.5,2440,0,7,2440,0,47.3817,1860
210000.0,3,1.5,1400,0,7,1400,0,47.2878,2210
384205.0,3,2.75,1810,0,8,1810,0,47.5164,1810
180000.0,2,1.0,1400,0,7,900,500,47.4866,1400
310000.0,2,1.0,1400,0,7,900,500,47.4866,1400
427500.0,4,2.5,2010,0,7,2010,0,47.776,1870
780000.0,3,3.0,2520,0,8,1560,960,47.6363,1140
1762000.0,3,2.25,3060,0,10,3060,0,47.6189,3510
339950.0,4,2.5,2150,0,7,2150,0,47.3655,1610
820000.0,3,2.25,2880,0,10,2880,0,47.5575,2920
398000.0,2,2.0,1300,0,8,1300,0,47.7193,1350
492000.0,3,1.75,2770,0,8,1580,1190,47.4669,2420
240000.0,4,1.5,1780,0,8,1180,600,47.3581,1450
599950.0,4,3.5,3730,2,10,2440,1290,47.3804,3440
105500.0,2,1.0,930,0,5,930,0,47.4611,1620
445000.0,2,1.0,930,0,5,930,0,47.4611,1620
390500.0,2,1.75,1460,0,7,960,500,47.2079,1810
255000.0,3,2.0,1310,0,7,1310,0,47.3697,1310
675750.0,4,2.5,2770,0,9,2770,0,47.5748,2270
1640000.0,3,3.25,3140,3,10,2240,900,47.6406,2950
353500.0,4,2.5,1770,0,7,1770,0,47.3512,2150
765000.0,3,1.0,1220,0,7,1220,0,47.6094,1380
563500.0,4,2.5,2190,0,8,2190,0,47.5341,2190
439000.0,4,2.0,1800,0,7,900,900,47.561,1400
975000.0,5,2.75,3100,2,9,1660,1440,47.5734,3230
469900.0,3,2.5,2270,0,7,2270,0,47.5415,2060
252000.0,3,1.0,1300,0,6,1300,0,47.7469,1120
495000.0,3,2.0,1769,0,7,1769,0,47.441,1870
570000.0,6,2.5,3370,0,8,1770,1600,47.4223,2790
327000.0,4,2.5,1630,0,7,1630,0,47.5704,1920
898000.0,2,2.25,2470,0,8,1480,990,47.653,2070
300000.0,4,2.5,2600,0,8,2600,0,47.3155,2170
418500.0,3,2.0,1800,0,8,1220,580,47.6254,2460
450000.0,4,2.5,2240,0,7,1840,400,47.5118,2260
403000.0,3,2.0,1960,2,8,1650,310,47.4419,1960
440000.0,3,1.0,1710,0,7,1200,510,47.7185,1410
350000.0,4,1.75,2140,0,7,1080,1060,47.5166,1590
240000.0,3,2.0,1400,0,6,700,700,47.7634,1410
460000.0,2,1.0,890,0,6,760,130,47.656,1600
825000.0,4,1.0,1820,0,8,1820,0,47.6259,2050
267500.0,3,2.25,1860,0,7,1860,0,47.2942,1815
201000.0,3,1.0,1220,0,7,1220,0,47.2633,1260
479500.0,3,2.75,2300,0,8,2300,0,47.5216,2420
210000.0,2,1.0,1520,0,7,1520,0,47.3187,1140
445000.0,2,1.0,1440,0,7,960,480,47.6653,1160
265000.0,3,1.75,1170,0,7,1170,0,47.7479,1200
399000.0,3,1.75,1170,0,7,1170,0,47.7479,1200
785000.0,4,2.25,3200,0,9,3200,0,47.755,2650
831500.0,5,2.5,4470,0,11,4470,0,47.7377,4050
360000.0,4,2.5,2570,0,7,2570,0,47.367,2200
655000.0,3,2.5,2370,0,9,2370,0,47.528,2500
449950.0,4,1.5,1800,0,7,1800,0,47.7325,1630
612000.0,5,2.5,2300,0,8,1290,1010,47.6875,2080
575000.0,3,2.5,3240,0,8,3240,0,47.4785,1870
557000.0,3,2.5,2280,0,9,960,1320,47.7453,3100
375000.0,4,1.75,1870,1,6,1030,840,47.511,2060
369000.0,3,2.25,1820,0,7,1820,0,47.2838,1850
330000.0,5,2.75,2390,0,7,1290,1100,47.5149,1690
1031000.0,4,1.75,2110,3,8,1410,700,47.67,2140
550000.0,2,1.0,980,0,7,980,0,47.6569,1570
338000.0,3,1.75,1250,0,7,1250,0,47.7623,1340
1900000.0,4,2.5,3680,2,9,3680,0,47.6154,3410
235000.0,3,1.0,2230,0,7,1230,1000,47.5215,2380
349950.0,1,1.0,1230,0,6,1230,0,47.7055,1190
300000.0,5,2.5,2093,0,7,2093,0,47.4495,1520
431000.0,3,1.75,1660,0,7,1660,0,47.5375,1610
280000.0,5,2.5,1630,0,7,1100,530,47.3657,1630
295000.0,4,2.5,1677,0,7,1677,0,47.2957,2236
445000.0,4,2.5,2990,0,7,2990,0,47.3499,2640
550000.0,5,1.0,2150,0,7,2150,0,47.5519,1460
515000.0,4,2.5,2890,0,9,2890,0,47.5666,3090
555000.0,3,2.5,3050,0,9,3050,0,47.4326,2960
265000.0,3,2.5,1410,0,7,1410,0,47.5132,1290
597000.0,4,2.5,2280,0,8,1520,760,47.6605,1690
661000.0,2,1.0,1260,0,7,1260,0,47.6501,1830
362764.0,3,2.0,1460,0,7,1460,0,47.696,1740
427000.0,4,2.5,1600,0,8,1310,290,47.7258,1600
405000.0,3,1.75,2020,0,7,2020,0,47.7691,1950
157000.0,3,1.5,1170,0,7,1170,0,47.4211,1550
246500.0,3,1.5,1170,0,7,1170,0,47.4211,1550
386500.0,2,1.5,1280,0,7,850,430,47.6351,1280
300000.0,4,2.5,2680,0,8,2680,0,47.3025,1960
240000.0,3,1.75,1770,0,8,1270,500,47.3109,2120
818500.0,5,3.5,4790,1,9,3110,1680,47.5469,2620
249000.0,3,1.75,1300,0,7,1300,0,47.209,1410
580000.0,4,2.25,2610,0,8,1700,910,47.5659,2260
2340000.0,4,2.5,4500,0,13,4500,0,47.5477,4760
333000.0,4,2.5,2100,0,8,2100,0,47.3703,2060
230000.0,2,2.0,1340,0,7,1340,0,47.1936,1670
360500.0,3,1.0,970,3,6,970,0,47.5658,1120
265000.0,3,1.75,2200,0,8,1270,930,47.3745,1800
490000.0,2,1.0,990,0,7,990,0,47.5666,2250
600000.0,2,1.75,1180,0,7,880,300,47.6749,1470
307500.0,3,1.0,980,0,7,980,0,47.7133,1220
670000.0,4,2.25,2370,0,8,1660,710,47.6497,2350
247200.0,3,1.5,1910,0,7,1910,0,47.2782,1770
2600000.0,4,4.5,5270,4,11,3400,1870,47.5696,3390
440000.0,3,1.75,1430,0,7,1430,0,47.6073,1570
700000.0,4,2.5,2490,0,8,2490,0,47.567,2140
756100.0,4,2.0,2000,0,8,2000,0,47.5394,1390
555000.0,4,2.75,2600,0,8,1620,980,47.5523,2230
830000.0,5,3.5,2880,2,8,2270,610,47.5905,2060
180000.0,3,1.0,1010,0,6,1010,0,47.1955,1090
775000.0,5,3.5,3290,0,9,2670,620,47.7056,3130
220000.0,4,1.75,1530,0,6,1530,0,47.329,1620
650000.0,4,2.75,2020,0,9,1620,400,47.5921,2210
410000.0,3,1.75,1340,0,7,1340,0,47.7012,1340
339995.0,4,2.5,2180,0,7,2180,0,47.3775,2180
1160000.0,5,1.75,2870,4,9,1440,1430,47.6122,2940
440000.0,3,2.75,2070,0,7,1330,740,47.4327,2000
275000.0,2,1.75,930,0,6,930,0,47.5224,1100
766000.0,3,2.5,2270,0,9,2270,0,47.6685,2790
231500.0,3,2.25,1630,0,7,1130,500,47.3076,1630
472000.0,3,2.0,2770,0,9,2770,0,47.4291,2040
1325000.0,4,2.5,4010,0,12,4010,0,47.7139,4280
265000.0,4,1.75,1970,0,7,1140,830,47.4861,1710
325000.0,2,1.0,790,0,7,790,0,47.5543,960
364500.0,3,1.75,1740,0,7,1040,700,47.7508,1370
322500.0,2,1.0,1130,0,6,1130,0,47.7473,1010
338900.0,3,1.75,1180,0,7,1040,140,47.5226,1430
910000.0,5,2.5,2350,0,9,2350,0,47.6265,1840
1015000.0,5,2.5,2350,0,9,2350,0,47.6265,1840
459950.0,3,1.75,1850,2,6,1100,750,47.4648,1850
584950.0,4,3.0,3220,0,9,3220,0,47.4813,2950
252000.0,3,1.75,2050,0,7,1520,530,47.2837,1620
270000.0,3,2.5,1430,0,7,1190,240,47.1943,1670
750000.0,4,2.5,3210,0,10,3210,0,47.582,3740
775000.0,3,1.75,3520,4,8,1530,1990,47.5837,2140
325000.0,3,2.5,2260,0,8,2260,0,47.2924,2250
810000.0,5,3.25,3290,0,9,3290,0,47.5933,3210
409000.0,2,2.25,1640,0,8,1640,0,47.753,1640
400000.0,4,1.75,1580,0,7,1130,450,47.6003,830
530000.0,4,2.25,1940,0,7,1940,0,47.7567,1800
580000.0,3,2.25,1580,0,7,1580,0,47.686,2253
491300.0,3,1.75,1750,1,7,1300,450,47.6099,2310
272000.0,4,2.75,1810,0,7,1200,610,47.3703,1750
599950.0,3,2.5,1970,4,9,1970,0,47.2498,2910
464000.0,3,2.5,1770,0,8,1770,0,47.5704,1870
471001.0,3,1.75,1800,0,7,900,900,47.6867,1800
230000.0,3,1.5,1500,0,7,1100,400,47.4062,1830
358000.0,3,1.0,940,0,6,940,0,47.6195,1230
510000.0,3,2.25,2340,0,7,1210,1130,47.6979,1970
86500.0,3,1.0,840,0,6,840,0,47.3277,840
199950.0,3,1.0,840,0,6,840,0,47.3277,840
1712500.0,3,3.25,2940,3,10,2440,500,47.6299,4400
850000.0,3,2.75,3180,0,9,2190,990,47.577,2000
542000.0,4,2.5,2020,0,7,1480,540,47.6885,1520
102500.0,2,1.0,820,0,5,820,0,47.514,780
718000.0,3,1.75,4060,0,8,2810,1250,47.4843,1300
625000.0,4,2.25,2660,0,8,2180,480,47.6142,2660
350000.0,3,1.0,1010,0,7,1010,0,47.7467,1220
216000.0,2,1.0,710,0,6,710,0,47.5224,1150
340000.0,3,1.0,980,0,7,980,0,47.7294,1070
505000.0,3,1.0,1100,0,7,1100,0,47.6604,1770
372000.0,5,2.5,2840,0,8,2840,0,47.3161,2740
263850.0,4,2.25,2300,0,8,2300,0,47.313,2270
1350000.0,4,3.25,5370,4,11,5370,0,47.405,2770
325000.0,4,2.5,2280,0,8,2280,0,47.461,1970
289000.0,2,1.0,1010,0,6,890,120,47.5323,1030
364000.0,3,2.25,1420,0,7,1160,260,47.77,1920
610000.0,4,2.5,2100,0,8,1250,850,47.6909,2100
531500.0,4,2.75,3110,0,8,3110,0,47.3343,1880
402500.0,3,2.25,2160,0,8,2160,0,47.7668,1720
375000.0,2,1.0,820,0,5,820,0,47.5479,1300
537500.0,5,2.5,4340,0,8,2170,2170,47.5384,2030
375000.0,3,1.75,2100,0,8,1440,660,47.4294,2000
293550.0,4,1.75,1250,0,7,910,340,47.4138,1410
585000.0,6,3.0,3870,0,8,2700,1170,47.7642,2600
225000.0,2,2.5,1360,0,6,1360,0,47.3492,1360
185000.0,4,1.0,1400,0,7,1400,0,47.4887,1520
402000.0,3,1.5,1450,0,7,1010,440,47.7212,1350
585000.0,5,1.75,1880,0,7,960,920,47.6003,1720
549000.0,2,2.5,1380,0,9,1380,0,47.6654,1430
1810000.0,3,2.25,2910,0,9,2510,400,47.6534,2370
345000.0,3,1.75,1380,0,7,1380,0,47.7119,1670
302500.0,3,2.25,3100,0,7,1790,1310,47.3825,1770
218500.0,4,1.75,1400,0,7,1400,0,47.36,2170
705000.0,2,2.0,1650,0,7,1650,0,47.6512,1700
191000.0,3,1.0,840,0,6,840,0,47.3607,920
695000.0,3,2.5,2550,0,9,2550,0,47.6498,2190
350000.0,2,2.75,2820,0,7,1630,1190,47.5102,1690
480000.0,3,1.75,1710,0,7,1130,580,47.5563,1200
220000.0,3,1.0,820,0,6,820,0,47.363,1120
535000.0,4,2.25,2620,0,7,2620,0,47.5921,2520
1000000.0,2,1.75,2430,4,10,2430,0,47.7616,3150
592000.0,3,1.75,1560,0,8,1560,0,47.6981,1370
775000.0,4,2.5,3060,0,9,3060,0,47.7006,3110
320000.0,3,2.5,1680,0,7,1680,0,47.4794,2160
760000.0,3,3.25,3320,0,10,3320,0,47.429,3430
640000.0,3,2.5,2390,0,9,2390,0,47.6271,2370
253200.0,3,1.0,1360,0,5,1360,0,47.4945,1250
228000.0,2,1.0,1800,0,7,1800,0,47.3792,1730
325000.0,3,1.0,1160,0,7,1160,0,47.7431,1160
530000.0,4,3.25,4160,0,8,2760,1400,47.4683,2500
300000.0,4,2.25,1660,0,7,1660,0,47.3666,1960
418000.0,3,2.0,1410,0,7,1410,0,47.6994,1410
415000.0,4,1.75,2230,4,8,1180,1050,47.508,2300
384000.0,3,2.5,1700,0,7,1700,0,47.5327,1700
325000.0,3,2.5,2070,0,8,2070,0,47.3658,2030
600000.0,3,1.75,2300,2,8,2300,0,47.7588,2720
760000.0,4,2.25,3040,0,9,1940,1100,47.5923,2430
168000.0,2,1.5,1220,0,8,1220,0,47.3804,1180
405000.0,3,1.0,960,0,7,960,0,47.6465,1550
479000.0,3,1.0,1480,0,7,1480,0,47.5942,1430
549000.0,3,2.0,1560,0,7,1150,410,47.6913,1560
215000.0,3,1.5,1100,0,7,1100,0,47.3185,1570
550000.0,2,1.5,900,2,7,900,0,47.5623,1300
389000.0,4,1.75,2400,0,7,1500,900,47.7125,1530
447500.0,3,2.5,2320,0,8,2320,0,47.4829,2300
540000.0,5,3.0,2570,0,8,1580,990,47.7271,2020
273500.0,4,2.75,1300,0,7,1300,0,47.3683,1670
257000.0,5,2.75,2930,0,9,2930,0,47.4887,2930
199000.0,2,1.0,720,0,6,720,0,47.4763,970
339100.0,4,2.5,2350,0,8,2350,0,47.3284,2210
435000.0,4,2.5,2940,0,9,2940,0,47.4341,2550
400000.0,3,2.5,2020,0,6,1010,1010,47.5621,1670
356000.0,2,1.0,1430,0,7,1010,420,47.513,2300
395000.0,3,1.0,950,0,7,950,0,47.7263,1410
575000.0,2,1.0,1250,0,7,850,400,47.6549,1520
515000.0,3,1.75,1300,0,6,1300,0,47.5589,1090
618250.0,4,3.25,2520,0,8,1550,970,47.6801,1730
245000.0,3,1.5,1330,0,7,1330,0,47.7308,1570
690000.0,3,2.75,2480,0,9,1890,590,47.6399,2160
465000.0,5,2.25,3020,0,7,1510,1510,47.5249,1760
280000.0,3,1.75,1770,0,7,1240,530,47.3066,2060
285000.0,3,1.75,1930,0,7,1230,700,47.4883,2030
320000.0,3,2.25,1650,0,7,1650,0,47.3826,2010
355000.0,4,3.0,2580,0,7,2130,450,47.3726,1900
670000.0,3,2.0,2570,0,8,2570,0,47.6275,2660
550000.0,1,1.0,2880,0,7,1440,1440,47.537,1400
765000.0,4,2.75,2660,0,8,1860,800,47.6864,1830
430000.0,3,1.0,1560,0,7,1260,300,47.5554,1560
950000.0,3,2.5,3080,2,9,3080,0,47.6469,2500
525000.0,4,1.75,2540,0,7,1270,1270,47.5579,1650
300000.0,6,2.5,3080,0,7,1580,1500,47.3859,1850
345000.0,3,2.75,2190,0,8,2190,0,47.3486,2190
838000.0,3,3.75,2930,0,8,2930,0,47.4658,2070
1795000.0,5,2.75,2880,3,9,1660,1220,47.6267,3750
390000.0,3,1.75,2160,0,8,2160,0,47.35,2004
1150000.0,3,2.0,2110,0,7,2110,0,47.5836,2690
295000.0,4,2.25,1830,0,7,1830,0,47.3604,1960
775000.0,4,4.0,3180,0,8,2530,650,47.6887,2000
380000.0,3,2.5,1880,0,8,1880,0,47.3722,2120
550000.0,3,1.0,1140,0,7,1140,0,47.5851,1510
199900.0,5,1.75,1798,0,7,1798,0,47.3266,1300
329900.0,3,1.75,1670,0,7,1670,0,47.5362,1990
898000.0,3,2.25,2580,0,8,2580,0,47.6113,2580
875000.0,4,2.25,3720,2,8,1860,1860,47.5836,3180
375000.0,4,2.5,2790,0,9,2790,0,47.3681,1660
365000.0,3,2.5,2190,0,8,2190,0,47.3506,2200
530000.0,4,2.75,2280,0,7,1540,740,47.6871,1680
225500.0,3,1.0,1100,0,6,1100,0,47.3643,920
318000.0,4,2.25,2180,0,8,1680,500,47.4651,2000
910000.0,4,2.5,2770,0,9,2770,0,47.562,3040
207000.0,3,1.0,1980,0,7,1280,700,47.3221,1356
1886700.0,5,3.5,4180,0,11,4180,0,47.5873,2950
624500.0,6,3.0,3030,0,8,1670,1360,47.575,2890
640000.0,3,2.5,1690,0,8,1690,0,47.6443,1910
500000.0,3,2.0,1990,0,8,1990,0,47.4726,2120
390000.0,5,1.75,2250,0,7,1500,750,47.7217,1940
284000.0,3,2.25,2080,0,7,1550,530,47.4199,2080
620000.0,3,2.0,2460,0,8,2460,0,47.5142,2500
306000.0,3,2.5,2588,0,8,2588,0,47.3453,2403
495000.0,4,1.75,2570,0,8,1910,660,47.626,2200
499950.0,3,2.5,2370,0,7,2370,0,47.7359,2280
330000.0,3,1.0,1070,0,7,1070,0,47.7687,1840
665000.0,3,2.0,1940,0,7,1150,790,47.6638,990
850000.0,3,2.5,2650,0,8,1830,820,47.6315,1870
599950.0,4,2.5,2290,0,8,2290,0,47.57,2150
360000.0,4,2.5,2050,0,8,2050,0,47.4597,1510
699000.0,3,2.5,2680,0,9,2680,0,47.7043,2780
475000.0,3,1.75,1520,0,6,760,760,47.6966,1040
575000.0,3,2.0,2690,0,8,2690,0,47.3477,1700
345000.0,2,1.5,1180,0,7,990,190,47.5998,1170
367950.0,4,2.5,3030,0,8,3030,0,47.3511,2650
374500.0,3,2.25,1400,0,8,1400,0,47.7428,2180
607500.0,4,2.5,3000,0,8,3000,0,47.7151,1550
374000.0,3,1.0,1200,0,7,1200,0,47.7412,1220
390000.0,3,1.0,1000,0,7,1000,0,47.7142,1000
705000.0,4,3.25,2740,0,9,2740,0,47.6706,1770
467000.0,3,2.5,1990,0,8,1990,0,47.5323,2650
243500.0,3,3.0,2110,0,6,2110,0,47.4005,1330
593000.0,3,2.75,1830,0,10,1690,140,47.5307,2310
223000.0,3,1.0,940,0,6,940,0,47.5107,1050
574000.0,4,2.5,2980,2,9,2980,0,47.3895,2980
400000.0,3,2.0,2260,0,7,1130,1130,47.4544,2080
772000.0,4,2.75,3470,0,8,1750,1720,47.6339,2950
593777.0,3,1.75,1510,0,7,1510,0,47.684,1310
539500.0,4,3.5,2710,0,8,2040,670,47.5591,2500
550000.0,3,2.5,2080,0,8,2080,0,47.5469,1760
265000.0,2,2.0,1860,0,8,1260,600,47.4989,1250
428000.0,3,1.75,2120,0,7,1280,840,47.7562,2200
505000.0,3,2.0,1110,0,7,1110,0,47.6978,1410
925000.0,5,5.5,5190,2,11,5190,0,47.5424,3840
230000.0,3,1.75,1520,0,8,1520,0,47.3308,2270
695000.0,4,2.5,2650,0,10,2650,0,47.5605,2710
700000.0,4,2.75,3350,2,9,3350,0,47.5398,3870
712500.0,3,1.75,1770,0,7,1770,0,47.6631,1630
480000.0,3,2.5,2200,0,8,2200,0,47.7761,2440
470000.0,3,2.5,2000,0,7,1300,700,47.7089,2110
335000.0,3,1.75,1730,0,7,1150,580,47.6923,1900
270000.0,3,1.5,1300,0,7,900,400,47.3737,1630
810000.0,5,3.25,2950,0,8,2530,420,47.7233,2620
589000.0,3,3.0,1720,0,8,1460,260,47.648,1720
415000.0,2,1.0,880,0,7,880,0,47.6803,1370
197000.0,4,2.25,1790,0,7,1220,570,47.4672,1740
235500.0,3,1.5,1380,0,7,790,590,47.3489,1570
460000.0,3,2.25,1530,0,8,1240,290,47.587,1800
572500.0,5,1.75,2330,0,8,1380,950,47.5352,2120
302000.0,5,2.0,1540,0,7,1540,0,47.4915,2260
870000.0,3,2.5,3210,0,10,2530,680,47.6939,2630
485000.0,3,1.0,1130,0,7,960,170,47.6413,1510
240000.0,3,2.0,1460,0,7,1460,0,47.3463,1580
383000.0,3,1.75,1410,0,7,1410,0,47.7343,1550
750000.0,4,2.75,1750,0,8,1750,0,47.6143,1700
409950.0,2,1.75,1370,0,6,1370,0,47.6926,1200
246000.0,3,1.5,1780,0,7,1780,0,47.4912,1130
860000.0,4,1.75,1890,0,7,1490,400,47.6751,1890
339950.0,3,2.25,1630,0,7,1630,0,47.4279,1730
315000.0,5,1.75,2320,0,7,1160,1160,47.4631,1410
698000.0,3,2.5,2580,0,9,2580,0,47.6201,2480
419000.0,2,2.5,1470,0,8,1470,0,47.6213,1510
372000.0,3,1.0,2298,0,7,2298,0,47.6909,2580
425000.0,3,2.5,1960,0,7,1960,0,47.5322,1700
386500.0,3,2.25,2950,0,8,1950,1000,47.7239,2060
348000.0,2,1.0,670,0,5,670,0,47.7145,860
754000.0,5,3.5,3020,0,10,2230,790,47.5627,3680
269950.0,4,3.0,2390,0,7,2390,0,47.294,930
891500.0,3,2.5,3090,0,10,3090,0,47.5602,3400
349950.0,4,1.75,1780,0,7,890,890,47.5329,1860
360000.0,2,1.0,1420,0,7,1180,240,47.4342,1490
975000.0,4,2.25,2420,0,8,2420,0,47.5907,2870
449250.0,4,2.0,1480,0,7,1480,0,47.7042,1480
350000.0,4,2.25,2190,0,7,2190,0,47.4854,1900
790000.0,4,1.75,1820,3,7,1690,130,47.6681,2130
990000.0,3,1.75,1810,4,9,930,880,47.5314,3540
834000.0,3,2.25,2550,0,9,2550,0,47.6272,1680
466950.0,3,1.0,1360,0,7,1060,300,47.6837,1110
262500.0,3,1.75,2259,3,7,1491,768,47.2741,1980
762300.0,4,2.5,3880,0,10,3880,0,47.6378,3240
733000.0,6,2.75,2730,0,8,1780,950,47.6751,2090
439000.0,4,2.5,2800,2,7,1560,1240,47.7596,3060
1160000.0,5,3.25,4290,0,10,3590,700,47.6439,1920
420000.0,3,2.5,1770,0,8,1770,0,47.6027,1820
549000.0,3,2.25,1920,0,8,1920,0,47.6432,2000
518000.0,4,2.5,2320,0,8,1510,810,47.6048,1490
695000.0,4,2.5,2961,0,9,2961,0,47.5839,2620
485000.0,3,2.5,1680,0,8,1680,0,47.6194,1970
280000.0,3,1.75,1590,0,6,1590,0,47.4238,1820
306500.0,2,1.0,1420,0,6,1420,0,47.3221,1900
720000.0,2,1.0,1370,0,6,1370,0,47.6238,1690
277500.0,3,2.5,2620,3,7,2620,0,47.1944,1670
649000.0,3,2.0,1810,4,8,1810,0,47.4663,2180
3395000.0,4,3.5,4730,4,10,2940,1790,47.6967,3250
267800.0,2,1.0,700,0,6,700,0,47.7515,920
625000.0,4,2.75,2390,0,8,2390,0,47.5703,2090
600000.0,4,2.5,2070,0,9,1590,480,47.7316,2050
395000.0,4,2.0,1780,0,7,1780,0,47.745,1180
212000.0,4,2.5,1900,0,7,1900,0,47.3776,1240
425000.0,2,1.0,1040,0,7,940,100,47.6829,1420
870000.0,4,1.75,2370,2,8,1770,600,47.6779,2100
420000.0,3,2.5,1970,0,7,1970,0,47.5321,1970
800000.0,4,2.25,2120,0,8,2120,0,47.5593,1890
575000.0,3,2.5,1960,0,8,1960,0,47.7371,2520
915000.0,3,3.25,2660,0,9,2170,490,47.6186,2660
400000.0,3,2.25,1180,0,7,1180,0,47.7112,1860
750000.0,3,2.5,2390,2,8,1440,950,47.5714,2010
235000.0,3,1.0,1250,0,7,1250,0,47.3604,1250
599950.0,5,3.0,2600,0,8,1300,1300,47.7176,2150
481203.0,2,1.0,940,0,7,940,0,47.6798,1680
1815000.0,5,3.0,3880,0,10,3880,0,47.5467,3470
379000.0,3,2.5,1530,0,7,1530,0,47.6939,1370
626000.0,3,1.75,2430,0,7,1760,670,47.6785,1320
535000.0,2,1.0,1030,0,7,920,110,47.686,1530
1225000.0,4,2.5,2740,0,9,2740,0,47.6353,2760
410000.0,2,1.5,1180,0,7,1120,60,47.678,1137
940000.0,4,2.5,3090,3,8,1680,1410,47.5654,2690
326250.0,3,1.0,1060,0,7,1060,0,47.7244,1320
200000.0,2,1.0,790,0,6,790,0,47.4941,1030
880000.0,4,2.5,3070,0,8,2100,970,47.5935,2270
370000.0,2,2.0,2100,0,9,2100,0,47.72,1440
190000.0,2,2.5,1100,0,8,1100,0,47.4499,1610
160000.0,2,1.0,1070,0,6,1070,0,47.3336,1150
625000.0,4,3.0,2190,0,9,1520,670,47.7107,3050
590000.0,4,3.5,3450,0,10,2750,700,47.459,3450
575000.0,3,2.5,2070,0,8,2070,0,47.6679,2070
470000.0,2,1.0,1190,0,7,1190,0,47.6939,1550
130000.0,2,1.0,600,0,4,600,0,47.5289,1130
229000.0,3,1.0,940,0,7,940,0,47.5108,1190
279900.0,3,1.0,1280,0,6,1280,0,47.3215,1610
307000.0,3,1.0,1370,0,7,1370,0,47.6499,1160
399950.0,3,1.75,2450,0,7,1980,470,47.6957,1790
405000.0,4,2.25,1970,0,7,1370,600,47.7673,2390
539950.0,4,2.75,2910,0,8,2130,780,47.544,1970
129000.0,2,1.0,760,0,6,760,0,47.388,980
340000.0,3,1.75,1270,0,7,1270,0,47.7601,1470
214950.0,3,1.75,1570,0,7,1310,260,47.3621,1380
450000.0,4,2.75,2310,2,8,1330,980,47.513,2300
515000.0,3,1.75,1900,0,7,950,950,47.5677,1420
1400000.0,4,2.25,3780,0,9,2510,1270,47.6275,2740
230000.0,3,1.0,1060,0,7,1060,0,47.4432,1310
681000.0,3,1.75,1880,0,8,1880,0,47.5527,2430
255000.0,3,1.0,1160,0,6,1160,0,47.5097,1300
580000.0,2,1.0,860,0,7,860,0,47.6652,1490
295000.0,2,2.0,1590,0,7,910,680,47.459,1590
286000.0,2,1.0,1170,0,7,1170,0,47.537,1550
425000.0,3,1.5,1190,0,7,830,360,47.7146,1256
170000.0,2,1.0,1300,0,7,1300,0,47.3459,1360
380000.0,3,2.0,1660,0,7,1660,0,47.5568,1660
506000.0,3,2.0,1160,0,7,1160,0,47.6853,1150
315000.0,3,2.5,1950,0,7,1950,0,47.4068,1890
449950.0,4,2.5,2470,0,8,2470,0,47.5362,2400
255000.0,3,1.0,1430,0,7,1430,0,47.5116,1900
289000.0,3,2.5,1970,0,7,1090,880,47.3462,2020
389000.0,3,1.75,1400,0,7,1400,0,47.5327,1350
327000.0,3,1.5,1510,2,7,1510,0,47.2156,1750
2885000.0,7,3.0,5350,0,10,5020,330,47.6295,3050
210000.0,3,1.0,920,0,6,920,0,47.548,1860
1680000.0,4,3.75,7620,3,11,5980,1640,47.5571,2840
360000.0,4,2.5,2490,0,7,2490,0,47.4813,2510
875000.0,4,2.5,3030,0,11,3030,0,47.7125,3670
550000.0,4,2.25,1650,0,8,1650,0,47.6384,2180
257500.0,3,1.5,1210,0,7,1210,0,47.503,1210
1075000.0,4,2.75,2990,0,8,2090,900,47.5711,2510
202950.0,2,1.0,1060,0,6,1060,0,47.3613,1130
622000.0,4,1.75,2680,0,8,1340,1340,47.6965,2320
455000.0,4,1.75,1790,0,8,1410,380,47.7453,1870
805000.0,3,2.5,2690,3,10,2690,0,47.654,3610
257000.0,2,1.0,770,0,6,770,0,47.7407,1550
744500.0,5,2.5,2700,0,8,1750,950,47.6144,2570
885000.0,4,2.5,2620,0,8,2620,0,47.6916,2240
355000.0,2,2.25,930,0,8,630,300,47.5844,940
240000.0,3,1.0,1340,0,7,1340,0,47.3742,1850
169000.0,3,1.5,1470,0,6,1470,0,47.3302,1750
639900.0,3,2.5,2330,0,8,2330,0,47.6367,2940
292000.0,3,1.75,1730,0,7,1730,0,47.3921,2030
563500.0,4,2.5,2780,3,9,2780,0,47.5312,3160
389000.0,2,2.0,1200,0,8,1200,0,47.7199,1670
2750000.0,4,3.25,4430,0,10,4430,0,47.6398,3930
661000.0,3,2.0,1820,0,8,1820,0,47.6947,1920
344000.0,2,2.0,1300,0,8,1300,0,47.7132,1640
510000.0,1,1.0,680,0,5,480,200,47.6567,1170
289000.0,2,1.0,780,0,7,780,0,47.5324,1100
365000.0,3,2.25,2430,0,8,1900,530,47.5065,1720
410000.0,3,1.5,1750,0,7,1750,0,47.5316,1820
535610.0,3,1.0,1610,0,7,1010,600,47.6765,1270
397950.0,4,1.75,2120,0,8,2120,0,47.457,1820
284000.0,3,1.75,1430,0,7,930,500,47.5472,1430
201000.0,4,1.5,1360,0,7,1360,0,47.4931,1300
734000.0,4,2.25,2530,0,7,1690,840,47.6806,1530
357500.0,5,3.0,3270,0,7,3270,0,47.3342,3200
550120.0,5,2.5,2620,0,8,1520,1100,47.6919,2030
300000.0,3,1.5,1810,0,8,1810,0,47.3195,2260
374950.0,3,2.5,2120,0,8,2120,0,47.3843,1780
602500.0,4,1.75,2190,0,8,2190,0,47.5755,2590
221000.0,3,1.0,980,0,7,980,0,47.4356,980
920000.0,5,3.0,2230,0,7,1730,500,47.6404,1280
235000.0,4,2.0,1540,0,7,1540,0,47.5163,1540
375000.0,3,1.0,980,0,7,980,0,47.7292,1280
599000.0,4,2.5,2120,0,8,2120,0,47.5521,2190
562100.0,3,2.25,2090,0,8,2090,0,47.7015,1760
640000.0,3,2.5,1620,0,8,1100,520,47.6195,1620
294000.0,3,2.0,1650,0,7,1250,400,47.4707,1860
714000.0,4,2.5,3230,0,9,3230,0,47.7069,3740
970000.0,4,3.25,2790,3,9,1130,1660,47.7698,2530
280000.0,4,2.25,1600,0,7,1600,0,47.194,1540
260000.0,4,2.5,1790,0,7,1790,0,47.3994,1790
294000.0,3,1.5,2060,0,7,2060,0,47.3321,1900
255500.0,4,1.0,1370,2,5,1370,0,47.2716,1590
3300000.0,5,4.75,6200,4,11,4440,1760,47.605,2940
450000.0,3,2.0,1510,0,7,1510,0,47.7218,2060
368000.0,3,1.0,1280,0,7,1280,0,47.7677,1290
830000.0,4,2.25,2180,0,8,1370,810,47.6042,2090
282500.0,2,1.75,1440,0,6,1130,310,47.498,1250
335000.0,3,2.25,1580,0,7,1580,0,47.5643,1450
558000.0,2,2.0,1580,0,6,790,790,47.5668,1580
270000.0,4,1.5,1730,0,7,1730,0,47.4905,1510
152000.0,2,1.0,700,0,4,700,0,47.3882,1600
493000.0,4,1.75,2030,0,7,2030,0,47.7326,1970
740000.0,4,2.5,2500,0,10,2500,0,47.5595,2710
789800.0,3,2.5,2605,2,9,2090,515,47.6536,2605
275000.0,2,1.0,910,0,6,910,0,47.6929,1480
1500000.0,6,2.5,3560,0,11,3560,0,47.627,2780
424000.0,3,1.75,1140,0,7,620,520,47.6712,1480
715000.0,2,1.0,1000,4,5,1000,0,47.5935,1930
600000.0,4,2.5,3010,0,9,3010,0,47.522,2670
802000.0,2,1.75,2110,4,9,1760,350,47.4912,2120
165000.0,3,1.0,910,0,6,910,0,47.449,1090
750000.0,4,3.25,2050,0,8,1370,680,47.6235,1720
405000.0,2,1.0,1090,0,7,780,310,47.632,1160
521900.0,3,2.5,2100,0,9,2100,0,47.7412,2320
275000.0,3,1.0,1000,0,7,1000,0,47.7285,1270
600000.0,5,3.25,4410,0,9,2330,2080,47.4395,2460
442500.0,3,1.75,1800,0,8,1800,0,47.4496,2140
229950.0,2,1.0,920,0,6,920,0,47.5028,1410
274950.0,3,2.0,1410,0,7,1410,0,47.3654,1390
407185.0,3,1.75,1860,0,8,1860,0,47.5051,1410
468000.0,4,2.5,2100,0,7,1240,860,47.735,1980
450000.0,2,1.0,1030,0,7,1030,0,47.6875,1420
219950.0,2,1.0,940,0,7,940,0,47.2005,1110
275000.0,2,2.5,1340,0,7,1340,0,47.7366,1540
229950.0,2,1.0,850,0,6,850,0,47.4972,1100
675000.0,3,1.75,2130,0,7,1430,700,47.6417,1710
412950.0,4,2.5,2430,0,8,2430,0,47.4499,2450
670000.0,5,2.25,2290,0,8,2290,0,47.7012,2750
420000.0,3,1.75,1230,0,7,1230,0,47.621,1530
358000.0,3,1.5,1150,0,6,1150,0,47.3933,1700
680000.0,3,2.5,2120,0,9,2120,0,47.6649,2540
380000.0,2,1.0,980,0,7,980,0,47.6688,1200
515000.0,3,2.5,2130,0,8,2130,0,47.7754,3340
325000.0,2,1.0,1050,0,7,1050,0,47.5128,1230
875000.0,3,2.5,1820,0,7,1820,0,47.6287,2080
426000.0,3,2.5,2210,0,7,1710,500,47.5525,1350
868500.0,5,2.5,2490,0,8,1610,880,47.551,2290
657500.0,4,2.75,4140,0,11,4140,0,47.3062,3950
366000.0,2,1.0,1210,0,6,860,350,47.5532,1210
385000.0,2,1.0,1010,0,6,1010,0,47.5536,1040
300000.0,4,2.0,2050,0,7,1300,750,47.4324,2050
810000.0,3,1.75,2060,0,9,1500,560,47.6498,1830
460000.0,4,1.75,1560,0,6,860,700,47.7001,1420
459000.0,3,2.5,1780,0,8,1780,0,47.5677,1730
260000.0,3,1.75,1460,0,8,1460,0,47.342,1930
557865.0,4,2.5,3030,0,9,3030,0,47.6296,2310
295000.0,4,1.0,980,0,7,980,0,47.5892,1525
375000.0,4,2.25,1450,0,7,1450,0,47.7643,1660
2110000.0,3,2.25,3230,0,9,3230,0,47.5683,3690
307300.0,2,2.0,1520,0,7,1520,0,47.7292,1500
225000.0,4,1.0,1410,0,7,1410,0,47.3767,1540
290000.0,3,1.75,1390,0,7,1390,0,47.4429,1430
690000.0,4,2.0,2230,0,7,1510,720,47.5772,2140
825000.0,4,2.25,2110,0,8,2110,0,47.536,2350
645000.0,3,1.75,2270,0,7,1370,900,47.7057,2270
590000.0,4,2.25,2530,0,8,1320,1210,47.5698,2530
667000.0,5,2.0,1900,0,7,1180,720,47.6666,1300
664000.0,4,2.5,2390,0,9,2390,0,47.6027,2710
452100.0,4,2.5,3160,3,8,1580,1580,47.5037,1990
290000.0,2,1.0,900,0,7,900,0,47.5877,900
950000.0,3,3.0,3610,2,8,3610,0,47.4852,2230
662500.0,3,2.0,2070,0,7,1670,400,47.6624,1490
475000.0,4,2.5,1850,0,7,1850,0,47.7227,1540
450000.0,3,1.5,1440,0,7,1140,300,47.7394,1590
538250.0,3,2.25,2590,3,8,2590,0,47.3948,2590
329950.0,2,1.0,1140,0,6,1140,0,47.731,1450
1103990.0,4,3.5,2760,2,9,2760,0,47.6756,2370
307000.0,5,1.5,1310,0,6,1110,200,47.5545,960
433000.0,3,1.75,1870,0,7,1270,600,47.5412,1780
212000.0,3,2.25,1900,0,7,1280,620,47.3251,1920
750000.0,5,2.75,2860,0,8,2380,480,47.5906,2240
279000.0,3,2.0,1640,0,7,1640,0,47.3736,2250
476000.0,3,1.0,1140,0,6,1140,0,47.6606,1690
368000.0,5,1.75,2590,0,7,1390,1200,47.3941,2580
228950.0,4,3.0,2160,0,7,1320,840,47.3627,1460
568450.0,5,3.5,3260,0,8,3260,0,47.3703,1810
619000.0,4,1.75,1660,0,7,1660,0,47.6883,1660
275000.0,3,2.25,1640,0,7,1640,0,47.2844,1600
321500.0,4,2.5,2620,0,8,2620,0,47.3148,2740
230000.0,3,1.75,950,0,6,790,160,47.5271,1360
179500.0,3,1.0,900,0,6,900,0,47.2866,1000
460000.0,3,2.25,1650,0,7,1220,430,47.7375,1690
286000.0,3,2.5,1800,0,7,1800,0,47.4006,2580
427500.0,3,1.0,1480,0,7,1480,0,47.6147,1460
400000.0,3,1.0,1040,0,7,1040,0,47.5526,1770
675000.0,3,3.5,2300,0,8,2300,0,47.7122,2170
350000.0,3,1.0,2480,0,7,1240,1240,47.5366,1800
385000.0,4,1.75,1970,0,8,1540,430,47.7719,1900
525000.0,2,1.75,1530,1,7,830,700,47.6368,1280
315000.0,2,1.0,970,0,6,970,0,47.5116,1150
820000.0,4,2.5,2920,0,10,2920,0,47.4784,2180
205000.0,3,1.0,970,0,7,970,0,47.3793,1160
500000.0,2,1.0,680,0,6,680,0,47.7013,1620
599000.0,4,2.5,2640,0,8,2640,0,47.5787,2180
2225000.0,3,4.0,4200,2,11,3600,600,47.6379,2760
299000.0,1,2.5,1980,0,7,1180,800,47.4343,1980
947500.0,3,2.75,2980,2,8,2180,800,47.4522,1890
385000.0,3,3.25,1630,0,8,1630,0,47.7048,1220
639950.0,2,1.75,1780,0,7,890,890,47.5798,1560
824000.0,2,1.0,1210,0,8,780,430,47.6503,1860
199950.0,3,1.0,1010,0,7,1010,0,47.3338,1300
1005000.0,3,2.5,2570,0,8,1480,1090,47.6578,2420
950000.0,4,2.25,2770,1,9,2440,330,47.5283,2100
822000.0,3,2.5,2290,0,8,2290,0,47.5476,2210
473600.0,4,1.5,1780,0,7,1080,700,47.5173,1660
490000.0,5,2.0,2150,0,8,2150,0,47.5582,1300
245000.0,3,1.75,1920,0,7,1000,920,47.3319,1860
199000.0,4,1.0,1220,0,7,1220,0,47.3229,1270
1340000.0,3,3.0,2960,2,10,2440,520,47.6356,2960
418000.0,3,1.75,1500,0,7,1500,0,47.6976,1820
450000.0,7,3.5,2830,0,8,1830,1000,47.7493,1570
280000.0,3,2.5,1580,0,8,1580,0,47.3659,2110
273000.0,3,2.25,1230,0,7,910,320,47.1955,1820
549000.0,4,2.5,2910,0,8,2910,0,47.4804,2500
913888.0,5,2.25,2370,0,9,2370,0,47.5555,2380
689888.0,4,2.25,1930,0,8,1540,390,47.6167,1800
305000.0,4,2.0,1780,0,7,870,910,47.7045,1350
602500.0,4,2.5,2760,0,9,2760,0,47.5346,2640
355000.0,2,1.75,1620,0,7,900,720,47.543,1590
756000.0,3,2.5,2160,0,9,2160,0,47.6608,2470
289950.0,4,2.25,2190,0,7,1040,1150,47.319,1250
800000.0,3,2.5,3240,0,10,3240,0,47.5857,2970
403000.0,2,1.0,720,0,6,720,0,47.6823,1430
350000.0,3,2.25,1410,0,8,1370,40,47.6108,1730
1285000.0,5,3.5,2980,0,10,2370,610,47.6782,1780
525126.0,5,2.25,1950,2,7,1150,800,47.6159,1780
241450.0,3,1.0,1100,0,7,1100,0,47.7393,1440
320000.0,3,1.5,1400,0,7,1400,0,47.7711,1490
234000.0,4,2.0,1710,0,7,1030,680,47.3965,1710
441000.0,5,2.5,2000,0,6,1150,850,47.5971,1410
474500.0,5,2.5,2000,0,6,1150,850,47.5971,1410
705000.0,3,1.0,1440,0,7,1440,0,47.6582,1850
517500.0,4,2.5,1520,0,8,1520,0,47.5696,1860
142500.0,4,0.75,1440,0,6,1440,0,47.4761,1460
310000.0,2,1.5,1010,0,7,1010,0,47.5118,1210
749500.0,4,2.5,2440,0,9,2440,0,47.6613,2370
360000.0,5,3.0,2480,0,7,1560,920,47.4586,1910
267500.0,3,1.0,1090,0,7,1090,0,47.3991,1590
290000.0,3,1.0,1480,0,6,1380,100,47.4949,1500
850000.0,5,2.5,2800,0,8,1400,1400,47.6166,2510
815000.0,4,1.75,1820,0,8,1820,0,47.6429,1870
2200000.0,5,4.0,5840,1,11,4410,1430,47.5835,3120
1625000.0,4,3.25,2980,0,9,2150,830,47.6352,2980
175000.0,3,1.5,1220,0,7,1220,0,47.3341,1260
429950.0,3,1.75,1830,0,8,1300,530,47.7107,1850
675000.0,4,2.5,2900,0,8,2900,0,47.6063,2970
580000.0,3,2.25,1940,0,7,1520,420,47.5476,1910
240000.0,4,2.0,1750,0,6,1750,0,47.4791,1270
374000.0,3,2.5,1850,0,8,1210,640,47.3631,2260
862500.0,4,2.5,3220,2,9,2180,1040,47.6325,3000
140000.0,2,1.0,1080,0,6,1080,0,47.3857,1810
740000.0,5,3.75,3990,0,8,3090,900,47.7228,2080
589000.0,3,1.75,920,0,6,820,100,47.6386,1620
275000.0,3,1.75,1290,0,7,1290,0,47.4265,1410
489900.0,4,2.5,2090,0,8,2090,0,47.7453,2640
545000.0,3,2.5,1900,0,9,1900,0,47.6679,2500
235000.0,4,1.0,1360,0,6,1360,0,47.5054,1280
230000.0,3,1.0,1000,0,6,1000,0,47.5523,1040
655000.0,4,2.25,2170,0,7,1920,250,47.6124,1890
185000.0,2,1.0,820,0,5,820,0,47.2039,1880
196000.0,3,1.0,1090,0,7,1090,0,47.2923,1140
572000.0,3,2.25,1830,0,8,1290,540,47.6914,1990
615000.0,4,2.5,3010,0,9,3010,0,47.5213,2860
1950000.0,4,3.75,4150,0,9,3130,1020,47.639,3930
1225000.0,6,2.25,2930,0,9,2130,800,47.6295,2860
375000.0,3,2.5,1520,0,7,1520,0,47.7221,1540
295000.0,3,1.75,1250,0,6,1250,0,47.4341,1270
760000.0,4,2.5,2760,0,7,2230,530,47.6877,1600
347000.0,3,1.75,1330,0,8,1330,0,47.4463,2110
712000.0,3,2.0,1700,0,7,1500,200,47.679,1700
495000.0,4,2.0,2050,0,7,1210,840,47.5799,1310
925000.0,4,2.0,3140,0,8,2040,1100,47.5786,2010
775000.0,3,1.0,2030,0,7,1840,190,47.6765,2030
429000.0,4,2.5,2100,0,6,1400,700,47.5293,1230
229000.0,3,1.0,1010,0,7,1010,0,47.3348,1490
400000.0,4,1.5,1980,0,7,1980,0,47.5606,1980
625000.0,4,2.25,2100,0,8,2100,0,47.5595,2100
130000.0,2,1.0,840,0,7,840,0,47.7319,1350
349000.0,3,1.75,1690,0,7,1190,500,47.5312,1300
365000.0,3,2.0,2140,0,7,2140,0,47.4066,2310
487500.0,3,2.5,1810,0,7,1350,460,47.6513,1600
475000.0,3,2.5,2600,0,8,2600,0,47.5123,2350
685000.0,3,1.75,1650,0,8,1470,180,47.5766,2020
960000.0,3,1.75,2460,0,7,1230,1230,47.6343,2860
1100000.0,5,2.25,4320,0,7,2880,1440,47.6824,1880
428000.0,3,2.25,2600,0,9,2600,0,47.3719,2380
435000.0,3,2.5,1930,0,7,1930,0,47.7733,1790
769950.0,3,2.0,2190,2,7,1260,930,47.6737,2160
385000.0,3,1.0,1420,0,7,1200,220,47.574,1630
352000.0,3,2.5,2090,0,7,1670,420,47.745,2090
622500.0,3,2.5,2290,0,8,2290,0,47.5886,2290
660000.0,3,3.0,2470,0,9,2290,180,47.641,2590
105000.0,3,1.0,840,0,6,840,0,47.3277,840
420000.0,2,1.0,2100,0,7,1400,700,47.574,1570
499950.0,3,1.5,1360,0,7,1360,0,47.5697,1440
975000.0,6,3.0,3420,0,9,2270,1150,47.5508,2430
665000.0,3,2.75,1930,0,7,1490,440,47.6659,2080
540000.0,4,2.5,2180,0,7,1180,1000,47.6822,1840
400000.0,4,2.0,1670,0,7,1670,0,47.7418,1860
469950.0,4,2.75,2720,0,8,1650,1070,47.4931,2720
777000.0,4,2.5,3170,0,8,3170,0,47.6181,2540
346500.0,2,1.75,1610,0,7,1010,600,47.554,1370
685000.0,3,2.5,2370,0,8,2370,0,47.5465,2230
396500.0,3,2.5,2590,0,10,2590,0,47.3839,3110
783500.0,3,2.5,2850,0,10,1990,860,47.603,2280
575000.0,4,2.0,1660,0,7,1660,0,47.6556,1660
1500000.0,4,4.25,5550,0,11,5550,0,47.5305,4750
515000.0,3,1.5,2200,0,7,1130,1070,47.7263,2170
300000.0,3,2.5,2020,0,7,1250,770,47.4934,1540
272000.0,3,1.5,1760,0,7,1760,0,47.4085,1450
355000.0,4,2.25,1810,0,7,1810,0,47.5003,1810
223000.0,3,2.0,1310,0,6,1310,0,47.5003,1790
397000.0,4,2.5,3000,0,7,3000,0,47.369,2610
460000.0,2,2.0,1080,0,6,1080,0,47.6826,1530
848000.0,3,2.75,2170,0,9,1550,620,47.6389,1170
392800.0,2,1.0,740,0,6,740,0,47.688,1900
1690000.0,3,3.25,5290,0,11,4540,750,47.6671,3750
1800000.0,3,3.25,5290,0,11,4540,750,47.6671,3750
577000.0,3,2.25,2370,0,8,2370,0,47.7281,1870
570000.0,3,1.0,1890,0,7,1390,500,47.6597,1530
250000.0,3,1.75,1160,0,7,1160,0,47.3414,1330
645000.0,4,1.75,1550,0,8,1550,0,47.5795,1860
567500.0,3,2.5,3090,0,9,3090,0,47.4032,3650
337000.0,4,2.5,2610,0,8,2610,0,47.345,2480
280000.0,3,1.75,1230,0,7,1230,0,47.4526,1250
167000.0,3,1.5,1280,0,6,1280,0,47.3344,1150
280000.0,2,1.0,1880,0,6,940,940,47.5261,1280
317500.0,2,1.5,1220,0,6,1220,0,47.7534,1130
405500.0,2,2.75,1350,0,8,1120,230,47.522,1410
495000.0,4,2.5,2370,0,8,2370,0,47.5633,2110
691000.0,4,3.0,3040,0,10,3040,0,47.6348,2540
480000.0,5,1.75,2080,0,7,2080,0,47.3884,1670
549010.0,2,1.75,1560,0,7,880,680,47.6863,1210
750000.0,5,3.5,2980,2,8,2980,0,47.5537,2120
365000.0,2,1.0,870,0,7,870,0,47.6988,1100
412500.0,3,1.75,1660,0,7,1100,560,47.7326,1630
425000.0,3,2.25,1870,0,7,1440,430,47.7373,1870
920000.0,3,1.0,1410,0,7,960,450,47.6354,2410
340000.0,4,2.25,2180,0,9,1630,550,47.317,2310
405000.0,4,2.5,2620,0,7,1520,1100,47.7642,1880
537100.0,3,2.5,2450,0,8,1870,580,47.5308,2450
353500.0,4,2.5,3250,0,8,3250,0,47.4004,2960
522000.0,3,1.0,1150,0,7,1150,0,47.7106,1490
710000.0,4,2.75,2780,0,8,2780,0,47.6881,2760
329950.0,3,1.75,1360,0,7,1360,0,47.4625,1580
830000.0,5,2.5,2810,3,9,1540,1270,47.5742,3190
800500.0,4,2.5,1780,0,8,1780,0,47.5931,2610
168500.0,3,1.0,1100,0,7,1100,0,47.367,1570
490000.0,3,2.5,2230,0,8,2230,0,47.5347,2190
579000.0,3,2.5,1710,0,8,1140,570,47.5827,1260
600000.0,4,2.5,2620,0,8,2620,0,47.5822,2520
445000.0,4,1.75,1990,0,7,1190,800,47.5275,1240
362500.0,4,1.75,1450,0,7,1450,0,47.5289,1540
234000.0,4,2.0,1630,0,7,1050,580,47.317,1670
321500.0,1,1.0,730,0,7,730,0,47.5939,1020
660000.0,3,1.75,1980,0,7,1140,840,47.6733,1590
319000.0,4,1.0,1730,0,6,1730,0,47.4135,1380
314000.0,3,1.75,1350,0,8,1100,250,47.2628,2190
517950.0,3,2.0,1410,0,7,740,670,47.6752,1830
525000.0,5,2.5,2360,0,7,1180,1180,47.5552,2200
319500.0,3,1.0,1190,0,6,1190,0,47.4807,1660
1580000.0,4,3.25,3760,0,9,2400,1360,47.6687,3430
325000.0,1,1.0,1220,4,6,1220,0,47.4047,2770
795000.0,4,2.5,2920,0,10,2920,0,47.7439,3420
850000.0,2,1.75,1590,3,9,1320,270,47.6424,2520
1010000.0,5,3.25,3510,0,9,3510,0,47.6914,1970
475000.0,3,2.5,1320,0,8,1320,0,47.6719,1350
375000.0,3,1.0,1610,0,7,1090,520,47.7391,2040
405000.0,3,1.0,1410,0,7,1410,0,47.704,1170
420000.0,4,2.5,2170,0,7,1570,600,47.7512,1850
775000.0,4,1.75,1890,0,7,1390,500,47.6405,1890
800000.0,4,2.75,3260,0,9,3260,0,47.5395,3450
436800.0,3,1.75,2080,0,8,1540,540,47.7056,2080
620000.0,3,1.75,2040,0,8,1740,300,47.6885,1380
230000.0,3,1.0,1250,0,7,1250,0,47.275,1350
165000.0,1,1.0,850,0,6,850,0,47.5427,1590
490000.0,1,1.0,850,0,6,850,0,47.5427,1590
480000.0,3,1.75,1600,0,8,1600,0,47.5479,2210
570000.0,3,2.5,2400,0,9,2400,0,47.534,2640
615000.0,3,2.25,1870,0,8,1750,120,47.6943,1920
280000.0,3,1.0,1720,0,7,860,860,47.7439,1720
326000.0,3,1.0,1030,0,7,1030,0,47.7676,1210
550700.0,2,2.25,1190,0,9,1100,90,47.6666,1430
600000.0,2,1.0,910,0,6,910,0,47.6188,1190
450000.0,3,1.0,1290,0,7,1150,140,47.5655,1960
546000.0,2,2.25,1530,0,8,1280,250,47.6032,1410
585000.0,3,2.5,2330,0,9,2330,0,47.4787,2270
489000.0,3,1.75,2090,2,7,1200,890,47.7007,1480
765000.0,3,2.0,1570,2,8,1050,520,47.6061,1990
519000.0,3,1.75,1560,3,8,1560,0,47.5023,1760
262000.0,2,1.0,1500,0,5,880,620,47.4857,1300
550000.0,4,2.75,2160,0,7,1430,730,47.6971,1770
285000.0,2,1.0,780,0,6,780,0,47.5112,1030
476000.0,4,1.75,2340,0,7,1360,980,47.745,2250
2200000.0,3,2.0,3570,1,8,2070,1500,47.6413,3570
335000.0,1,1.0,720,0,6,720,0,47.6821,1320
510000.0,4,2.0,2990,0,8,2990,0,47.3068,2820
291000.0,3,2.25,1860,0,7,1860,0,47.3746,1530
335000.0,4,1.75,1950,0,6,1950,0,47.5232,1300
415000.0,3,1.5,1860,0,7,1490,370,47.7624,2090
430000.0,3,2.0,1550,0,7,830,720,47.5436,1330
270000.0,3,1.75,1610,0,7,1210,400,47.3004,1780
760000.0,3,2.0,1810,0,7,980,830,47.681,1800
450000.0,2,2.0,1730,0,7,1730,0,47.5933,1380
425000.0,3,2.5,1230,0,7,1230,0,47.515,2340
725000.0,4,2.5,2130,0,7,1730,400,47.649,1520
700000.0,3,2.75,2190,0,7,1610,580,47.6893,2020
998000.0,5,4.5,4130,0,10,4130,0,47.5556,3890
396000.0,3,2.25,1680,0,7,1680,0,47.7341,1590
547000.0,3,2.5,1480,0,7,1480,0,47.7078,1710
302000.0,4,1.5,1790,0,8,1210,580,47.3774,1540
999000.0,5,3.5,2810,0,9,1900,910,47.6799,1510
633000.0,4,2.5,2360,3,8,1980,380,47.573,2480
265800.0,3,1.75,1460,0,6,1460,0,47.7436,1460
530000.0,3,2.25,2160,0,8,1460,700,47.7176,2160
605000.0,6,2.0,2610,0,8,1320,1290,47.622,2170
489000.0,4,2.5,2170,0,7,2170,0,47.5396,2170
305000.0,2,1.0,2160,0,7,1360,800,47.4702,2070
513000.0,4,2.75,2020,0,7,1010,1010,47.5202,1390
765000.0,4,2.5,2980,0,10,2980,0,47.5431,3140
550000.0,2,1.5,1300,0,7,990,310,47.6233,1700
974350.0,4,2.5,3090,0,8,2420,670,47.5458,2220
653675.0,4,2.25,2280,0,8,2280,0,47.5609,2320
245000.0,3,1.75,1260,0,7,1260,0,47.3586,1600
700180.0,2,1.75,1530,0,8,1020,510,47.6726,1870
510000.0,3,2.5,1830,0,8,1390,440,47.7478,2310
390000.0,3,2.5,1610,0,7,1190,420,47.5349,1940
606500.0,3,2.5,2170,0,8,2170,0,47.5975,2170
1500000.0,4,4.25,5020,0,12,5020,0,47.6008,4930
290000.0,3,2.25,1620,0,8,1620,0,47.3521,1710
115000.0,3,1.75,1080,0,7,1080,0,47.3141,1380
500000.0,3,2.5,1940,0,8,1940,0,47.4801,2560
139950.0,0,0.0,844,0,7,844,0,47.2781,1380
580050.0,3,2.5,2360,3,9,2360,0,47.6837,1620
550000.0,3,2.5,2010,0,8,1390,620,47.5514,1690
465000.0,3,1.0,800,0,6,800,0,47.6769,1180
354950.0,3,1.0,970,0,7,970,0,47.719,1730
980000.0,4,3.25,3720,2,11,3720,0,47.5359,4040
500000.0,3,2.25,2010,0,8,2010,0,47.747,2230
667750.0,4,1.0,1430,0,7,1430,0,47.6696,1760
735000.0,3,1.75,2250,1,8,2250,0,47.7619,2730
361000.0,3,1.75,2130,3,7,1330,800,47.5057,2380
276750.0,3,2.0,1620,0,7,1290,330,47.3584,1560
760000.0,4,3.25,3140,0,10,2310,830,47.5319,2620
475000.0,2,1.0,870,2,7,870,0,47.6698,1080
234000.0,4,2.5,1820,0,7,1120,700,47.263,1310
234950.0,3,2.0,1510,0,7,1510,0,47.3412,1780
269950.0,2,1.75,1320,0,7,1320,0,47.3634,1570
495000.0,3,2.5,1800,0,8,1800,0,47.5747,1800
438000.0,2,1.0,1120,0,7,1120,0,47.6951,1230
260000.0,3,1.75,2160,0,7,2160,0,47.7355,1820
697000.0,4,2.5,3220,0,9,3220,0,47.5883,2850
212625.0,2,1.0,960,0,6,960,0,47.5188,930
593000.0,5,2.5,2640,0,7,1840,800,47.605,1720
410000.0,4,3.0,2430,0,8,2430,0,47.3533,2430
445434.0,2,1.0,1470,0,7,1020,450,47.7008,1470
200126.0,3,2.5,2040,0,8,1340,700,47.3334,2370
290700.0,3,2.5,1670,0,7,1670,0,47.3488,1370
248000.0,4,1.0,1010,0,6,1010,0,47.4174,1330
345000.0,1,1.0,540,0,5,540,0,47.7739,1840
525000.0,3,1.0,1240,0,7,800,440,47.6563,1440
400000.0,3,1.75,1510,0,7,1510,0,47.7279,1570
532000.0,3,1.0,1820,0,7,1120,700,47.5773,1500
159995.0,2,1.0,1000,0,5,760,240,47.297,990
287000.0,5,1.5,2040,0,7,1030,1010,47.5015,1560
1115000.0,4,2.5,3690,3,10,2190,1500,47.6434,3460
765000.0,3,2.5,2310,0,9,2310,0,47.5438,2830
185000.0,3,1.5,1090,0,6,1090,0,47.3609,1160
430000.0,3,1.0,1150,0,6,1150,0,47.6867,1460
346000.0,4,2.5,2100,0,8,2100,0,47.4324,2100
607000.0,4,2.75,2150,0,8,1240,910,47.6915,2200
417000.0,3,1.5,2500,0,7,1730,770,47.5297,1340
930000.0,5,2.0,3530,0,9,3530,0,47.5774,4100
573300.0,2,1.75,1290,2,7,870,420,47.531,2380
260000.0,4,1.75,2010,0,7,1410,600,47.5048,1610
280000.0,1,0.75,420,0,5,420,0,47.552,1420
825000.0,4,2.5,2180,0,8,2180,0,47.6186,2660
307000.0,4,1.0,1150,0,6,1150,0,47.7431,990
595000.0,4,1.75,2000,0,7,1130,870,47.6798,1540
528000.0,5,1.75,2780,0,8,1390,1390,47.6694,2130
600000.0,2,1.75,1550,4,8,1550,0,47.358,1690
275000.0,2,1.0,2180,0,7,1480,700,47.3757,1800
782000.0,2,1.5,1570,2,7,1320,250,47.6366,2140
610000.0,3,2.5,2260,0,9,1660,600,47.7634,2600
488000.0,3,1.0,1600,0,7,1600,0,47.653,1860
320000.0,3,1.0,1630,0,7,930,700,47.5497,1630
153500.0,3,1.0,890,0,6,890,0,47.5153,1230
414500.0,3,1.0,1350,0,7,1350,0,47.7186,1460
750000.0,5,1.75,2850,0,9,2850,0,47.7503,2640
349990.0,3,1.0,1350,3,6,1350,0,47.2217,2300
645000.0,3,2.25,3280,0,10,3280,0,47.3207,1860
425000.0,2,1.0,1090,0,7,1090,0,47.5886,1960
785000.0,4,2.5,2990,0,9,2990,0,47.6287,2440
290000.0,3,1.75,1340,0,7,1340,0,47.4379,1950
415000.0,3,1.75,1340,0,7,1340,0,47.4379,1950
248500.0,2,1.0,720,0,6,720,0,47.5274,990
325000.0,3,2.5,2330,0,7,1480,850,47.4543,1940
272925.0,2,1.0,1280,0,6,1280,0,47.7477,2480
500000.0,2,2.25,1570,0,9,1280,290,47.6514,1570
250000.0,4,1.75,1510,0,7,1510,0,47.535,1320
470000.0,4,2.5,2470,0,8,2470,0,47.7699,1690
440000.0,2,1.0,1190,0,7,990,200,47.5539,1180
299999.0,4,2.5,1981,0,8,1981,0,47.3252,1981
255000.0,3,1.75,1590,0,7,1590,0,47.2932,1470
415950.0,3,1.75,1150,0,7,1150,0,47.6048,1650
402000.0,5,2.75,2160,0,7,1220,940,47.5576,1900
729000.0,3,1.5,1770,4,9,1770,0,47.7648,2650
635000.0,2,2.5,2470,0,8,1780,690,47.5693,1940
479000.0,3,2.5,1710,0,8,1710,0,47.7236,1710
462370.0,2,2.25,1860,0,8,1860,0,47.5436,1860
171500.0,3,1.0,1150,0,5,1150,0,47.2642,1100
925000.0,5,3.0,3850,0,9,2910,940,47.727,2830
675000.0,5,3.0,3410,0,8,1870,1540,47.6358,2390
320000.0,4,1.5,1890,0,8,1890,0,47.3267,2376
499950.0,5,3.5,3200,0,7,3200,0,47.475,2730
435000.0,5,1.0,2170,0,7,1670,500,47.7555,3170
359800.0,4,2.5,2390,0,9,2390,0,47.2586,2520
239900.0,3,2.0,1410,0,7,1410,0,47.3674,1570
295000.0,2,1.0,740,2,5,740,0,47.5704,1490
380000.0,3,2.5,2150,0,6,2150,0,47.4514,1850
435000.0,4,2.5,2180,0,7,1410,770,47.5365,920
508000.0,2,1.0,820,0,7,820,0,47.6498,1730
2400000.0,6,4.5,5480,3,9,4430,1050,47.6307,2970
234500.0,4,2.5,1960,0,7,1220,740,47.3427,2030
355000.0,2,1.0,1270,0,7,960,310,47.6565,1410
230000.0,3,2.0,1710,0,7,1030,680,47.3651,1390
345000.0,3,1.75,1930,1,7,1150,780,47.4539,1590
430000.0,3,1.75,1200,0,7,1200,0,47.5553,1340
500000.0,3,1.5,1680,0,7,1680,0,47.6766,1680
378000.0,4,1.0,1300,0,7,1300,0,47.773,1450
345000.0,3,2.5,1540,0,7,1540,0,47.5299,1780
410000.0,2,1.75,870,0,6,870,0,47.5657,1420
750000.0,2,2.25,1890,0,8,1610,280,47.6688,2820
485000.0,4,1.75,2050,0,7,1330,720,47.6735,1290
105000.0,3,1.0,880,0,6,880,0,47.3634,940
1025000.0,3,2.75,2780,2,8,1960,820,47.6565,1490
360000.0,3,1.0,1160,0,7,1160,0,47.6818,1670
294000.0,5,2.75,2300,0,7,1400,900,47.3084,1750
400000.0,4,2.5,3140,0,9,3140,0,47.3863,2510
325000.0,3,1.75,2300,0,7,1150,1150,47.4176,1740
770000.0,3,2.5,2900,0,10,1490,1410,47.5708,2900
443000.0,3,2.25,1920,0,7,1920,0,47.735,1940
325000.0,3,1.0,1150,0,7,1150,0,47.7261,1510
760000.0,4,2.5,3120,0,9,3120,0,47.5699,2150
640000.0,4,2.0,2560,0,7,1890,670,47.6914,1330
415000.0,3,2.0,1410,0,7,1410,0,47.5541,1660
156000.0,3,1.0,970,0,7,970,0,47.3363,1430
996000.0,3,3.25,3620,0,10,2730,890,47.5776,2040
415000.0,2,1.0,880,0,7,880,0,47.694,980
615000.0,3,1.75,1900,0,7,1110,790,47.5742,1530
717000.0,4,2.5,2540,0,8,2540,0,47.7073,3010
548000.0,4,1.75,1690,0,7,1090,600,47.6888,1380
425000.0,3,1.5,1120,0,7,1120,0,47.7321,1580
325250.0,4,2.75,2130,0,7,1330,800,47.3788,2090
1225000.0,3,2.5,3420,0,11,3420,0,47.7225,4240
557500.0,3,1.75,1900,0,7,1900,0,47.5789,2030
1260500.0,4,2.5,3730,0,10,3730,0,47.5678,3200
249950.0,3,3.0,1790,0,7,1480,310,47.5421,1220
260000.0,4,2.75,2250,0,8,1320,930,47.2895,1800
1989000.0,3,2.5,2880,4,8,1520,1360,47.6281,3710
442900.0,4,1.75,1780,0,6,890,890,47.6511,1760
475000.0,3,2.25,1580,0,7,1200,380,47.6254,1660
365000.0,5,2.75,3260,0,8,3260,0,47.3674,2770
780000.0,4,2.5,3180,2,9,3180,0,47.7717,2440
930000.0,3,1.75,2460,0,7,1230,1230,47.6593,1700
2888000.0,5,6.25,8670,4,13,6120,2550,47.7295,4140
350000.0,3,1.0,1020,0,7,850,170,47.7039,970
357500.0,3,1.75,1630,0,7,1630,0,47.757,1430
520000.0,4,2.5,3290,0,8,3290,0,47.7399,2050
330000.0,4,2.5,1940,0,8,1940,0,47.4513,1940
310000.0,3,2.0,1350,0,7,1110,240,47.446,1290
279000.0,3,1.0,1110,0,6,1110,0,47.4705,1480
540000.0,4,1.5,2993,0,7,2233,760,47.4692,2060
322000.0,4,2.5,2280,0,8,2280,0,47.3829,2250
380000.0,5,3.25,3800,0,7,2490,1310,47.3862,2000
320000.0,2,1.0,850,0,6,850,0,47.4696,1280
400000.0,3,1.75,1560,0,7,1560,0,47.7769,2230
412000.0,3,1.0,1000,0,7,900,100,47.7031,1000
887200.0,3,1.0,1400,0,7,1400,0,47.6677,1740
395000.0,4,1.75,1540,0,6,770,770,47.5359,1080
895000.0,4,3.0,3570,3,9,2630,940,47.6394,3640
195000.0,2,1.0,800,0,6,800,0,47.205,1240
390000.0,3,1.0,1160,0,7,1160,0,47.5652,1530
165000.0,3,1.0,1010,0,6,1010,0,47.4501,1010
255000.0,3,1.0,1010,0,6,1010,0,47.4501,1010
589000.0,4,2.25,2390,0,8,2390,0,47.6651,2390
505000.0,3,2.5,1610,0,8,1610,0,47.5678,1730
335750.0,3,3.0,2400,0,7,1440,960,47.5045,1060
719000.0,3,1.75,1800,0,7,900,900,47.6529,1650
796000.0,4,3.25,2110,0,8,2110,0,47.6769,1780
95000.0,2,1.0,960,0,4,960,0,47.3864,1850
525000.0,3,3.0,2600,3,9,1890,710,47.3448,2220
417000.0,3,1.5,1340,0,7,1340,0,47.5752,1340
410000.0,3,1.0,1410,0,6,980,430,47.5769,1410
984000.0,4,2.25,2390,0,9,2390,0,47.5528,2870
325000.0,2,1.5,1180,0,8,1180,0,47.7074,1180
314950.0,3,1.0,1040,0,7,1040,0,47.4812,1660
350000.0,3,2.25,1840,0,7,1200,640,47.7408,1710
1045000.0,4,2.25,2630,0,9,1810,820,47.6393,2370
657000.0,4,2.5,2640,0,8,2640,0,47.5277,2630
234950.0,2,2.5,1720,0,8,1720,0,47.3728,1740
410000.0,4,1.75,2320,0,7,1220,1100,47.7574,2230
625000.0,3,1.75,1840,0,7,1270,570,47.6899,1480
706000.0,5,2.5,2890,0,9,2890,0,47.5286,2590
485000.0,3,1.75,2200,2,7,2200,0,47.3878,1170
685000.0,4,2.75,1660,0,7,1280,380,47.6835,1490
242050.0,3,2.5,2170,0,7,1690,480,47.3634,1420
770000.0,3,3.25,3310,0,9,3310,0,47.5558,2670
557000.0,2,1.5,1450,0,7,950,500,47.684,1450
246000.0,3,1.75,1440,0,8,1440,0,47.3503,1440
194000.0,4,2.0,1760,0,7,1760,0,47.3299,1870
720000.0,3,2.5,3170,0,9,3170,0,47.6934,2790
449000.0,2,1.0,1250,0,6,1040,210,47.5387,1550
925000.0,4,2.5,3280,0,10,3280,0,47.6553,2460
570000.0,4,3.0,2460,0,7,1700,760,47.7106,1470
395000.0,3,2.0,1470,0,7,1470,0,47.7751,1440
1000000.0,4,2.0,1780,0,8,1780,0,47.5849,2320
406000.0,4,1.0,1580,2,7,1580,0,47.5104,1700
574800.0,3,1.5,1630,0,8,1630,0,47.6865,1550
309000.0,4,2.0,2240,0,7,1120,1120,47.3666,2040
770000.0,3,2.5,2430,0,10,2430,0,47.4664,2910
525000.0,3,1.5,1940,0,7,1440,500,47.6818,1460
419000.0,3,2.5,1970,0,7,1970,0,47.5308,2340
479000.0,4,2.5,2050,0,7,1230,820,47.7242,1610
160000.0,3,1.0,1340,0,5,1340,0,47.7129,960
333000.0,4,1.75,1880,0,8,1880,0,47.4551,1880
310000.0,2,1.0,860,0,6,860,0,47.5267,1010
666000.0,3,2.5,2140,0,8,1770,370,47.6668,2140
2230000.0,3,3.0,3620,4,10,2370,1250,47.5516,2550
310000.0,4,2.75,2370,0,7,2370,0,47.3071,1960
350000.0,3,2.5,1860,0,8,1860,0,47.6455,2450
610000.0,4,3.0,2110,2,7,1640,470,47.5195,1380
564800.0,3,2.25,1990,0,8,1990,0,47.5707,2090
438000.0,3,2.25,1820,0,7,1320,500,47.737,1780
855000.0,3,2.0,3120,0,9,1820,1300,47.5612,2770
229000.0,3,2.5,1190,0,7,1190,0,47.4933,1190
260000.0,3,2.0,1170,0,6,1170,0,47.5276,1340
609000.0,3,2.5,2630,0,9,2630,0,47.7695,2800
277000.0,4,1.0,1450,0,6,990,460,47.5131,1440
283000.0,4,2.0,2100,0,7,1200,900,47.5145,1140
334000.0,2,1.75,1680,0,6,840,840,47.6976,1830
267000.0,4,1.75,2000,0,7,1100,900,47.3428,1720
385000.0,3,1.0,1030,0,7,830,200,47.6813,1830
640000.0,5,1.75,2020,0,8,1120,900,47.6821,2020
532500.0,4,2.0,2220,0,7,2220,0,47.7759,2650
335000.0,4,2.5,1750,0,7,1240,510,47.4447,1660
415000.0,3,2.5,1710,0,7,1710,0,47.5347,1500
1098000.0,6,3.25,3560,0,8,2760,800,47.6356,3210
1442500.0,2,2.5,2720,3,10,2160,560,47.5499,2880
180000.0,3,1.0,1010,0,6,1010,0,47.4872,1320
335000.0,4,2.5,1830,0,7,1830,0,47.3504,2080
835000.0,4,3.0,4480,0,9,4480,0,47.7711,3140
592500.0,4,1.5,2080,0,7,2080,0,47.606,1680
418900.0,3,1.5,1470,0,7,1470,0,47.7462,1460
340000.0,3,1.0,1600,0,7,1600,0,47.5054,1430
545000.0,3,2.0,1340,0,7,1340,0,47.5601,1630
1378000.0,5,3.5,3680,0,9,3680,0,47.6575,2020
183750.0,3,2.5,1770,0,7,1770,0,47.4325,1490
295000.0,4,2.0,980,0,7,980,0,47.4462,1230
625000.0,4,3.0,2530,0,8,1470,1060,47.7094,1840
290000.0,4,3.0,2390,0,7,2390,0,47.4872,1320
760000.0,4,2.5,3600,0,9,3600,0,47.3538,3410
560000.0,4,2.5,3270,0,8,1690,1580,47.5221,1520
475000.0,5,2.5,2300,0,6,2300,0,47.6403,1880
620000.0,3,1.0,1710,0,7,1710,0,47.6732,1790
330000.0,4,2.0,1170,0,7,1170,0,47.5797,1720
620000.0,3,2.25,1990,0,7,1390,600,47.6903,2080
320000.0,4,1.75,1710,0,6,1710,0,47.4743,1750
525000.0,3,2.5,1740,0,8,1120,620,47.6206,1750
802500.0,4,3.75,3320,0,10,3320,0,47.5818,3740
569500.0,4,1.0,1960,0,7,1960,0,47.6005,1870
850000.0,6,3.5,2820,0,8,1620,1200,47.6791,1560
630000.0,3,1.0,1590,0,7,1590,0,47.662,1570
454800.0,4,2.25,2490,1,7,1400,1090,47.6137,3080
177000.0,3,1.0,870,0,6,870,0,47.3695,870
275000.0,3,1.75,1860,0,7,1860,0,47.3191,1860
460000.0,3,2.0,2930,0,8,2240,690,47.3102,2110
729000.0,3,1.0,1580,0,8,1580,0,47.6192,1680
935000.0,4,3.25,4110,2,11,4110,0,47.5493,4190
481450.0,3,2.0,1410,0,7,1410,0,47.6852,1190
860000.0,3,2.0,2090,0,8,1490,600,47.6178,2090
274000.0,3,1.75,1400,0,7,1400,0,47.4918,1210
499000.0,3,3.5,1690,0,7,1360,330,47.6513,1650
696500.0,5,2.25,3210,0,8,3210,0,47.7632,2820
390000.0,3,1.0,1190,0,5,1190,0,47.365,1360
265000.0,3,1.0,960,0,5,960,0,47.5259,1600
470000.0,4,2.25,2380,0,8,1530,850,47.7668,2280
168500.0,2,1.0,1020,0,6,1020,0,47.499,1510
220000.0,3,1.75,1290,0,7,1290,0,47.3353,1410
295000.0,3,2.0,1830,0,7,1100,730,47.5072,1450
1475000.0,5,4.0,4770,0,12,4770,0,47.5468,4520
1295000.0,2,2.5,2910,4,9,1940,970,47.7729,2540
285000.0,3,1.0,950,0,6,950,0,47.4899,1520
294950.0,3,1.0,1160,0,7,1160,0,47.7499,1210
1465000.0,4,4.0,4930,3,12,4930,0,47.5874,4630
565500.0,3,1.75,1780,0,7,980,800,47.5589,1550
230000.0,3,2.0,1410,0,7,1410,0,47.3649,1410
569950.0,4,3.5,2700,0,8,2700,0,47.333,3210
721000.0,2,1.5,1790,0,7,920,870,47.6367,1910
565000.0,3,2.5,4040,0,9,2900,1140,47.7378,3360
438000.0,3,1.75,1990,0,7,1030,960,47.6722,1560
369900.0,3,1.75,2150,0,7,1650,500,47.5061,1550
405000.0,4,2.5,1850,0,8,1850,0,47.4943,1930
282000.0,3,2.5,1680,0,7,1240,440,47.423,1420
380950.0,2,1.0,1430,0,7,1110,320,47.7307,1380
349810.0,3,1.0,960,0,7,960,0,47.7689,1250
690000.0,4,2.5,2700,0,9,2700,0,47.7041,2730
653000.0,2,1.5,1290,0,7,1050,240,47.6878,1290
526500.0,3,2.5,1860,0,8,1860,0,47.7712,2270
1040000.0,4,3.5,4320,0,10,3280,1040,47.5568,4030
335000.0,3,1.0,2130,0,7,2130,0,47.5506,1780
570000.0,2,1.75,2870,2,8,1770,1100,47.4847,2960
1080000.0,5,3.5,3740,0,10,3740,0,47.6628,2040
475000.0,3,2.5,2130,0,8,2130,0,47.7252,2130
315000.0,4,2.0,1210,0,7,1210,0,47.5275,1210
405000.0,6,2.0,2800,0,7,1400,1400,47.4398,1980
562000.0,5,2.25,3040,0,8,3040,0,47.7157,2020
295000.0,3,2.5,1570,0,7,1570,0,47.3902,1570
383000.0,3,2.25,2090,0,7,2090,0,47.4885,1690
242000.0,3,2.25,1690,0,7,1250,440,47.2639,1670
352500.0,3,1.5,1470,0,7,1470,0,47.4695,2300
239950.0,4,1.0,1460,0,7,730,730,47.4952,1190
998000.0,4,2.5,3030,0,9,2530,500,47.6695,2070
515000.0,3,1.75,1190,0,6,1190,0,47.5576,1820
590000.0,5,1.0,1840,0,7,1840,0,47.5686,1410
1160000.0,4,3.75,3560,0,9,3560,0,47.5575,3320
289000.0,3,1.75,1580,0,7,1580,0,47.427,1460
424000.0,3,1.5,1230,0,7,1230,0,47.7281,1400
199000.0,4,2.0,1440,0,5,1440,0,47.5093,1440
730000.0,4,3.5,4420,0,10,3350,1070,47.5327,3440
244000.0,3,1.0,910,0,6,910,0,47.4729,1650
240000.0,2,1.0,670,0,6,670,0,47.5128,900
797000.0,4,2.75,2650,0,8,2650,0,47.6155,1680
350000.0,4,2.25,2220,0,8,2220,0,47.3509,2240
415000.0,3,1.75,1640,0,7,1190,450,47.7197,1770
378510.0,2,1.0,770,0,7,770,0,47.5459,1260
1195000.0,4,3.5,3960,0,10,2850,1110,47.6461,2840
379900.0,2,1.5,1140,0,6,1140,0,47.5277,1300
620000.0,3,2.5,2480,0,7,2480,0,47.6797,2480
524500.0,3,1.5,1580,0,8,900,680,47.6796,1580
270000.0,4,2.75,1990,0,7,1270,720,47.2839,2100
236000.0,4,2.25,1830,0,7,1200,630,47.2995,1730
308500.0,2,2.0,840,0,6,840,0,47.5499,1430
989900.0,5,2.25,3320,0,8,1660,1660,47.5749,3320
299000.0,4,2.25,2050,0,8,2050,0,47.3423,2330
295000.0,2,1.75,1560,0,8,1560,0,47.5729,1000
110000.0,2,1.0,800,0,6,800,0,47.4932,1170
295950.0,2,1.0,1190,0,7,1190,0,47.7634,1470
270000.0,3,1.75,1300,0,6,650,650,47.5353,1420
712000.0,4,2.5,3400,0,9,3400,0,47.3623,3180
475000.0,2,1.5,1170,0,8,1170,0,47.6719,1310
410000.0,4,2.5,2510,0,7,2510,0,47.4818,2570
588000.0,4,2.25,2510,0,9,1810,700,47.7041,2450
420000.0,3,2.5,2390,0,8,1970,420,47.7515,2390
355000.0,4,2.25,2200,0,8,2200,0,47.3895,2200
446000.0,2,1.0,2550,1,7,1610,940,47.4013,2030
765000.0,4,2.25,2560,0,8,1760,800,47.631,2240
967500.0,3,3.75,3250,2,8,2370,880,47.6481,1840
381000.0,2,2.0,1340,0,8,1340,0,47.7175,1350
490000.0,3,2.25,2840,0,9,2840,0,47.2848,2600
716000.0,4,2.25,2480,0,8,1900,580,47.6388,2640
605000.0,5,3.5,3060,0,8,3060,0,47.5322,2680
312200.0,4,2.5,2910,0,8,2910,0,47.2596,2770
327000.0,4,1.0,1900,0,7,1290,610,47.4629,1950
229950.0,4,1.75,1300,0,7,1300,0,47.3067,2120
160000.0,3,1.5,1480,0,7,1000,480,47.2866,1470
255000.0,3,1.0,1250,0,6,1250,0,47.495,1590
530000.0,4,2.5,2000,0,7,1220,780,47.6902,1560
239000.0,3,1.5,1330,0,7,900,430,47.4239,1400
285000.0,3,2.25,1840,0,7,1270,570,47.4043,1840
537000.0,4,2.0,1560,0,7,1140,420,47.6714,1850
530000.0,3,2.5,3150,0,9,3150,0,47.6455,2280
213675.0,3,2.25,1560,0,7,1560,0,47.2862,1640
530000.0,5,2.5,2910,0,7,1690,1220,47.5803,2830
780000.0,3,2.5,2940,0,10,2940,0,47.5947,2980
390000.0,3,1.0,950,0,6,950,0,47.575,1540
450000.0,2,1.0,1200,0,7,1070,130,47.5766,1770
420000.0,2,1.0,1000,0,7,1000,0,47.5404,1380
550000.0,3,2.0,1490,0,7,1490,0,47.662,1490
110000.0,2,1.0,600,0,5,600,0,47.4997,1060
700000.0,2,1.75,2320,2,8,1720,600,47.586,2380
807500.0,4,2.5,3190,0,10,3190,0,47.6209,2110
179000.0,2,1.0,990,0,7,990,0,47.3302,1560
1612500.0,4,2.75,5470,4,11,3730,1740,47.5316,3620
655000.0,4,2.75,2890,0,9,2890,0,47.7454,2880
472500.0,3,2.0,1790,0,7,1240,550,47.728,1470
299000.0,4,2.5,2350,0,9,2350,0,47.3321,2480
740000.0,4,2.5,3430,0,10,3430,0,47.723,3480
860000.0,3,1.75,2600,0,8,1700,900,47.64,2940
620000.0,4,3.0,2130,0,7,1440,690,47.5683,1240
410000.0,3,1.75,1660,0,7,960,700,47.5107,1510
343000.0,5,3.5,2473,1,7,2473,0,47.3966,2040
465000.0,2,2.75,1430,0,7,995,435,47.621,1500
273950.0,3,2.25,1570,0,8,1570,0,47.3258,1680
825000.0,2,1.0,1240,1,7,1240,0,47.5169,1550
255000.0,3,2.5,1720,0,7,1720,0,47.2137,1710
250000.0,3,2.0,1140,0,7,1140,0,47.209,1720
635000.0,4,3.25,2690,3,9,1720,970,47.7341,2400
240000.0,3,1.75,1520,0,8,1520,0,47.3263,2060
670000.0,4,2.25,2040,0,8,2040,0,47.7016,1670
713414.0,3,2.5,2830,3,9,1730,1100,47.5751,2040
245000.0,3,1.5,1340,0,7,1340,0,47.3837,1300
600000.0,4,2.5,2520,0,8,1680,840,47.7751,2590
270000.0,3,2.5,1660,0,7,1660,0,47.375,1810
190000.0,2,1.0,880,0,6,880,0,47.4903,1060
435000.0,3,2.0,980,0,6,980,0,47.595,1970
560000.0,4,1.0,1360,0,6,1360,0,47.6038,1010
998000.0,3,3.75,3710,0,10,2910,800,47.5888,2390
725000.0,3,1.0,940,0,7,940,0,47.5974,1710
210000.0,2,1.0,970,0,7,970,0,47.4943,1340
513000.0,3,2.25,1500,0,8,1500,0,47.6534,1500
290000.0,5,2.5,2780,0,8,1390,1390,47.3444,1790
1260000.0,3,2.5,3110,1,8,1640,1470,47.6112,3650
330000.0,3,2.25,1860,0,7,1860,0,47.3879,1820
189000.0,3,1.0,1010,0,6,1010,0,47.4497,1170
907500.0,3,2.25,2850,2,7,1900,950,47.6911,1680
410000.0,3,2.25,2280,0,7,2280,0,47.6522,2280
1050000.0,4,3.0,3080,3,8,3080,0,47.5671,2810
622100.0,4,2.5,2280,0,7,1510,770,47.7054,2140
250000.0,3,1.5,2030,0,7,1310,720,47.2639,1330
1180000.0,4,3.0,2570,0,8,1750,820,47.6743,1970
925000.0,3,2.75,3640,0,9,2060,1580,47.5612,3110
554000.0,3,2.0,1760,0,7,960,800,47.6876,1500
545000.0,3,2.5,2760,0,9,2760,0,47.4929,1940
660000.0,3,2.5,2650,0,9,2650,0,47.7644,2200
1900000.0,5,4.5,5160,0,12,5160,0,47.6568,4760
260000.0,4,2.0,1480,0,7,1480,0,47.462,2130
219900.0,3,1.0,860,0,6,860,0,47.4931,1150
373500.0,4,2.5,2610,0,8,2610,0,47.3438,2470
380000.0,2,1.0,1470,0,6,1470,0,47.4771,2600
1060000.0,4,2.5,4570,2,11,4570,0,47.6246,4490
2600000.0,3,3.0,3410,4,10,2220,1190,47.5721,3760
450000.0,3,2.25,1760,0,8,1760,0,47.5336,1810
379950.0,3,1.75,2040,0,8,2040,0,47.3756,2010
834800.0,3,3.5,3470,0,9,3470,0,47.711,3430
365000.0,2,1.0,680,0,6,680,0,47.6084,1610
465000.0,2,2.0,1494,4,7,1494,0,47.4728,1494
452000.0,3,1.5,1250,0,7,1250,0,47.6916,1030
840000.0,3,3.0,3570,2,10,2710,860,47.5624,2550
465000.0,4,2.0,2000,0,7,1480,520,47.5532,1110
295000.0,3,2.5,2030,0,7,2030,0,47.3747,2030
396000.0,3,1.0,1390,0,7,1390,0,47.7289,1230
397000.0,2,1.0,1030,0,7,1030,0,47.6984,1790
240000.0,3,1.0,1280,0,6,1280,0,47.4915,1430
300523.0,3,2.5,2370,0,9,2370,0,47.6503,1590
215500.0,3,2.0,1380,0,7,1380,0,47.2613,1460
552500.0,5,3.0,2320,0,8,1370,950,47.697,2090
375000.0,5,1.5,2050,0,7,1520,530,47.436,1840
160000.0,3,1.0,1210,0,6,1210,0,47.4208,1880
1070000.0,4,2.5,3270,0,11,3270,0,47.548,4180
952000.0,3,2.5,2450,0,9,1800,650,47.6439,2220
523460.0,5,1.75,1890,0,7,1090,800,47.6711,1610
305950.0,4,2.5,2007,0,9,2007,0,47.3301,2189
220000.0,3,2.5,1430,0,7,1430,0,47.1956,1580
289000.0,2,1.75,2056,0,7,1048,1008,47.2592,2220
648000.0,5,2.5,2210,2,9,1430,780,47.7383,2720
825000.0,5,1.75,2330,0,8,2080,250,47.6461,2150
400000.0,4,2.0,2070,0,7,2070,0,47.7264,1880
420000.0,2,2.5,1480,0,7,1480,0,47.676,1390
389000.0,2,1.75,1160,1,7,1160,0,47.542,1990
865000.0,4,2.5,2520,0,8,2520,0,47.6814,1810
345000.0,2,1.0,1770,3,8,1220,550,47.3346,2790
700000.0,3,2.5,3110,0,8,2430,680,47.3879,2420
550000.0,3,2.5,1680,0,8,1680,0,47.7229,1860
201500.0,3,1.0,1320,0,7,1320,0,47.5711,1320
459000.0,3,1.0,1320,0,7,1320,0,47.5711,1320
327000.0,3,2.5,1810,0,8,1310,500,47.4434,2240
540000.0,1,1.0,1140,0,7,1140,0,47.6958,1350
805000.0,5,2.5,4600,3,9,2300,2300,47.7608,2890
521000.0,3,2.0,1840,0,6,1840,0,47.5508,2010
375000.0,3,1.5,2000,0,7,1520,480,47.5297,2000
235000.0,3,1.75,1480,0,7,1080,400,47.2982,1660
240000.0,4,2.5,2040,0,7,2040,0,47.3691,1730
575000.0,4,2.25,2060,0,8,2060,0,47.6378,2360
1520000.0,6,3.5,3720,0,10,3720,0,47.5699,3030
394500.0,4,2.5,3002,0,8,3002,0,47.4231,2566
174950.0,3,1.0,1060,0,6,1060,0,47.3636,1380
383000.0,4,2.0,1830,0,7,1060,770,47.4826,1950
249950.0,3,2.0,1550,0,6,1550,0,47.4873,1510
431000.0,3,2.5,1690,0,8,1690,0,47.6332,1690
459900.0,3,1.75,2580,0,7,1290,1290,47.5646,2280
475000.0,5,2.5,2510,0,7,1490,1020,47.7212,1840
605000.0,3,2.25,1290,0,8,1290,0,47.6229,1700
234950.0,4,2.0,1450,0,7,1450,0,47.3375,1430
419000.0,4,2.5,2690,0,8,2690,0,47.4248,2160
910000.0,4,3.25,3340,0,9,2240,1100,47.6677,2880
392000.0,4,2.5,2600,0,8,2600,0,47.4423,2550
915000.0,3,2.5,3140,0,9,2500,640,47.6383,2370
630000.0,3,3.25,3800,3,9,3800,0,47.7741,2480
416100.0,4,1.75,2320,3,8,1160,1160,47.5091,2240
285000.0,4,2.5,2360,0,7,1440,920,47.3417,1450
353000.0,4,1.5,1100,0,6,1100,0,47.7,1100
297950.0,3,2.0,1390,0,8,1390,0,47.4504,1960
750000.0,2,2.0,2180,0,8,2180,0,47.7162,2890
525000.0,3,3.0,1730,0,8,1730,0,47.6692,1370
495000.0,5,1.75,2760,0,8,1510,1250,47.7363,1720
710000.0,3,1.75,2430,1,7,1620,810,47.6971,2140
310000.0,3,2.0,2010,0,8,2010,0,47.7222,1490
205000.0,5,1.75,1730,0,7,1050,680,47.3628,1350
530000.0,3,3.0,2450,3,8,2450,0,47.2215,2300
725000.0,4,2.5,3300,0,9,3300,0,47.5072,3550
195000.0,2,1.0,720,0,6,720,0,47.7678,1450
401000.0,3,2.0,1240,0,7,1000,240,47.6364,1330
1030000.0,5,2.5,3050,4,8,1650,1400,47.5647,2970
251000.0,3,1.5,1590,0,7,1590,0,47.2159,1780
667500.0,3,2.0,2040,0,7,1020,1020,47.6778,1600
300000.0,4,2.5,1840,0,8,1840,0,47.3937,2030
610000.0,4,2.25,1960,0,8,1960,0,47.6349,1960
1042030.0,4,5.0,4110,0,11,4110,0,47.6353,3650
430000.0,3,2.25,1830,0,8,1400,430,47.7412,1830
455000.0,2,1.0,1330,0,6,1330,0,47.6624,1280
600000.0,5,2.0,2190,0,7,1110,1080,47.6696,1660
638000.0,3,3.25,1720,2,9,1410,310,47.6187,1490
561000.0,3,1.75,1710,0,7,1360,350,47.5492,1490
625000.0,3,2.5,2180,0,8,1240,940,47.5828,2000
263950.0,3,1.75,1700,0,7,1180,520,47.2874,1500
740000.0,3,2.5,2960,2,9,2960,0,47.6218,2960
234999.0,3,1.0,1330,0,6,1330,0,47.4493,1200
380000.0,4,2.5,1940,0,8,1940,0,47.4583,1900
329500.0,3,2.25,1500,0,7,1170,330,47.7327,1690
464950.0,4,2.5,2230,0,7,1230,1000,47.4754,2230
500000.0,3,2.25,1700,0,8,1340,360,47.7161,2340
415000.0,4,1.5,1840,0,7,1840,0,47.7656,1690
437500.0,3,2.25,2100,0,8,2100,0,47.3668,2396
599000.0,7,2.5,2580,0,7,1880,700,47.6025,2280
367000.0,4,2.5,2350,0,8,2350,0,47.3697,2330
530000.0,2,1.0,760,0,6,760,0,47.6633,1630
989000.0,5,3.5,3280,0,9,2440,840,47.689,1980
462600.0,3,2.0,1320,0,6,1020,300,47.5515,2410
875000.0,3,2.5,1690,0,8,1690,0,47.58,2260
335000.0,3,2.25,2060,2,8,1600,460,47.2758,1870
393000.0,4,2.0,1450,0,7,1450,0,47.5442,980
1340000.0,4,3.0,2760,1,9,1840,920,47.6591,3200
590000.0,3,2.5,2830,0,9,2830,0,47.7604,2500
671000.0,4,2.75,1890,0,9,1200,690,47.6472,1650
925000.0,3,3.25,2610,0,9,1660,950,47.6701,2110
245000.0,3,2.25,1900,0,7,1250,650,47.4869,1560
392500.0,3,1.0,930,0,7,930,0,47.6889,960
505000.0,4,2.0,2730,0,8,1410,1320,47.7733,2730
702000.0,4,2.5,2650,0,8,2650,0,47.6885,2640
337000.0,2,1.0,1010,0,7,1010,0,47.5311,1480
920000.0,4,2.5,3550,0,9,3550,0,47.5499,3310
495500.0,3,1.75,2130,0,7,1720,410,47.7059,1540
245000.0,2,1.75,1840,0,7,1570,270,47.3815,1282
395000.0,2,1.0,1320,0,6,1320,0,47.585,1320
335000.0,3,1.0,990,0,7,990,0,47.7116,1450
187000.0,2,1.75,1020,0,6,1020,0,47.1958,1160
450000.0,4,2.0,1570,0,7,1570,0,47.5967,1530
280000.0,4,2.25,1930,0,7,1360,570,47.3783,1760
1375000.0,5,4.0,3760,3,11,1910,1850,47.5333,3730
265000.0,2,1.0,1000,0,6,1000,0,47.7659,1560
795000.0,3,1.75,1930,0,8,1930,0,47.5747,2350
510000.0,3,1.5,2240,0,8,1370,870,47.6887,1690
699900.0,4,2.5,2190,0,8,1430,760,47.5668,2580
839000.0,4,2.75,2400,2,8,1760,640,47.5861,2400
396000.0,4,1.75,1970,0,7,1220,750,47.7489,1690
365000.0,3,2.25,2860,0,7,2860,0,47.4269,1760
440000.0,3,2.25,1900,0,8,1220,680,47.6394,1900
405000.0,4,2.5,2090,0,8,2090,0,47.4648,2250
295000.0,3,1.5,850,0,7,850,0,47.5677,850
275000.0,4,2.5,1840,0,7,1400,440,47.5345,1840
295000.0,2,1.0,820,0,6,820,0,47.4196,1580
1500000.0,5,3.5,4370,0,11,3270,1100,47.582,2980
795000.0,3,3.5,3190,0,10,2560,630,47.6968,3120
650000.0,5,3.5,3480,0,8,2490,990,47.5741,2540
260000.0,3,1.0,1690,0,7,1690,0,47.476,1130
382000.0,2,2.5,1650,2,8,1650,0,47.5173,1760
790100.0,4,2.5,2590,0,8,2590,0,47.6496,2280
220000.0,4,2.5,2160,0,7,2160,0,47.2668,1790
799000.0,4,3.5,3500,0,9,2500,1000,47.5613,2350
1480000.0,4,2.25,3920,0,10,3120,800,47.5731,3400
367300.0,4,2.75,2190,0,8,2190,0,47.3535,1920
805000.0,4,2.0,1890,0,7,1490,400,47.6684,1640
730000.0,2,1.0,1860,0,7,1010,850,47.6714,1540
402000.0,3,2.0,1720,0,7,1160,560,47.7368,1620
750000.0,4,2.75,2600,0,8,1560,1040,47.6782,2600
458000.0,3,1.5,1570,0,7,1570,0,47.4866,1740
898000.0,3,2.5,3530,0,10,3530,0,47.5539,3220
308000.0,4,2.5,1960,0,7,1960,0,47.3167,1870
385000.0,3,2.5,2230,0,7,2230,0,47.4386,2480
1020000.0,4,3.0,2720,0,8,1790,930,47.6595,2260
1425000.0,5,3.0,2840,0,9,2440,400,47.6285,2940
240000.0,3,1.75,1260,0,7,1260,0,47.3602,1530
217000.0,3,1.5,1860,0,7,1860,0,47.3106,1810
972000.0,4,1.75,2010,2,8,1610,400,47.6457,3290
361280.0,2,1.0,820,0,7,820,0,47.55,1490
385000.0,3,1.75,1220,0,6,620,600,47.6361,1660
475000.0,3,2.5,2220,0,8,2220,0,47.4802,1930
724950.0,4,2.5,2860,2,7,1720,1140,47.6631,1760
935000.0,5,4.5,4230,0,10,4230,0,47.5444,4130
169950.0,3,1.0,840,0,6,840,0,47.3275,840
585000.0,3,2.5,2290,0,9,2290,0,47.5443,2290
585000.0,3,2.5,2290,0,9,2290,0,47.5443,2290
480000.0,5,3.5,3480,2,10,2890,590,47.2641,3400
635000.0,4,2.5,4260,0,8,4100,160,47.764,2430
368750.0,3,2.5,2230,0,7,2230,0,47.4388,2230
432500.0,6,2.0,3080,0,7,3080,0,47.6031,1830
589000.0,3,2.5,2250,0,8,2250,0,47.5908,2250
840000.0,4,3.25,3160,0,9,2280,880,47.536,3160
316500.0,3,2.5,1770,0,7,1770,0,47.4648,2280
536000.0,4,2.5,2880,0,7,2880,0,47.5388,2570
563750.0,4,2.75,2690,0,8,1750,940,47.5537,2640
152500.0,4,1.0,1730,0,6,1730,0,47.3467,1440
267950.0,4,1.0,1730,0,6,1730,0,47.3467,1440
1640000.0,5,4.0,4780,0,11,4780,0,47.7243,4040
269950.0,4,2.5,2540,0,7,2540,0,47.3754,1600
731688.0,4,3.0,2630,0,9,2630,0,47.6952,3460
240000.0,3,1.5,1890,0,7,1190,700,47.4425,2060
555950.0,2,1.0,1220,0,7,1220,0,47.6957,1420
289000.0,2,1.0,710,0,6,710,0,47.5155,740
525000.0,3,2.5,2970,0,9,1770,1200,47.6359,2990
745000.0,3,2.5,2970,0,9,1770,1200,47.6359,2990
397000.0,2,1.0,1000,2,7,1000,0,47.7001,1570
233000.0,3,1.0,1980,0,7,1030,950,47.538,1830
625000.0,4,2.25,1920,0,8,1920,0,47.5616,2030
535000.0,3,2.0,2740,4,10,2740,0,47.319,2800
270000.0,3,2.25,1740,0,7,1380,360,47.3663,1770
360000.0,3,1.75,1300,0,7,1300,0,47.7347,1520
1105000.0,4,1.5,2740,0,9,1930,810,47.6343,1680
970000.0,4,1.75,4060,3,10,2890,1170,47.6375,1860
915000.0,5,2.5,3490,4,9,1840,1650,47.5955,2690
412000.0,4,1.75,1430,0,7,1130,300,47.6083,2070
265000.0,4,1.75,1860,0,7,1110,750,47.3792,1570
426000.0,4,2.25,2120,0,7,1490,630,47.7207,1890
266000.0,4,2.25,1860,0,8,1140,720,47.3114,1950
325000.0,3,2.0,2330,0,6,1430,900,47.5585,1160
615000.0,3,1.75,1670,2,7,990,680,47.5898,2140
310000.0,3,1.75,2130,0,8,1580,550,47.3074,2180
340000.0,4,1.75,1900,0,7,1900,0,47.7311,1420
562500.0,2,1.0,1170,0,5,1170,0,47.6574,1660
447000.0,2,1.0,980,0,8,980,0,47.638,1180
2450000.0,7,4.25,4670,2,11,4670,0,47.6183,3240
250000.0,4,1.5,2500,0,7,1500,1000,47.3781,1720
633000.0,4,2.5,2020,0,8,2020,0,47.6247,2320
310000.0,3,2.0,1290,0,7,1290,0,47.7161,1270
439000.0,2,1.75,1620,0,7,1620,0,47.4821,1560
470000.0,3,3.25,1710,0,8,1360,350,47.5477,1420
270000.0,3,2.5,1720,0,7,1720,0,47.2837,1460
299500.0,3,1.75,1820,0,7,1820,0,47.2622,1780
227000.0,3,1.0,1130,0,6,1130,0,47.3733,1770
735000.0,4,2.75,3040,4,8,3040,0,47.5188,2620
537000.0,3,3.0,2410,2,7,2410,0,47.7394,2610
699000.0,4,2.5,2440,0,9,1660,780,47.6401,2810
330000.0,2,1.0,800,0,6,600,200,47.6979,1720
229000.0,3,1.0,1030,0,7,1030,0,47.473,1630
200000.0,3,1.0,1480,0,6,940,540,47.5045,1350
522500.0,3,1.75,1710,0,8,1710,0,47.623,1820
1295000.0,3,2.75,3450,3,9,2590,860,47.6389,2910
2000000.0,3,3.25,2610,4,9,2610,0,47.7175,2590
200000.0,2,0.75,780,0,4,780,0,47.442,1620
352000.0,3,1.75,1260,0,7,1260,0,47.7189,1460
855000.0,4,3.0,2590,2,9,2240,350,47.6774,2260
267000.0,3,2.5,1580,0,8,1580,0,47.3771,1560
484000.0,2,1.75,1660,0,7,1160,500,47.6624,1660
402000.0,4,2.75,2950,0,8,2120,830,47.3845,2840
905000.0,4,2.25,2240,0,8,1770,470,47.6027,2120
274000.0,4,1.75,1940,0,7,1720,220,47.3736,2000
475000.0,3,1.75,1850,0,7,1850,0,47.3412,2110
1535000.0,4,4.5,5770,3,9,3160,2610,47.677,2950
628000.0,4,2.0,2280,0,7,1140,1140,47.6034,2240
675000.0,6,1.75,2740,3,8,1370,1370,47.5062,2150
429900.0,4,3.25,3760,0,8,2740,1020,47.3862,3280
260000.0,3,1.5,1580,0,7,1140,440,47.4294,1540
690000.0,3,1.75,1600,0,7,1030,570,47.6348,2150
1081000.0,4,2.25,2100,0,9,2100,0,47.5458,2400
360000.0,4,2.5,2610,0,8,2610,0,47.2721,2280
499000.0,3,1.75,1840,0,7,920,920,47.6808,1220
159000.0,3,1.0,1320,0,7,1320,0,47.4806,2140
430000.0,3,1.75,1540,0,7,940,600,47.749,1840
1050000.0,5,2.75,2520,0,8,1660,860,47.6409,3000
725000.0,5,2.5,3780,1,9,1890,1890,47.7603,2840
150000.0,3,1.0,1200,0,7,1200,0,47.5112,1510
840000.0,4,2.25,2720,0,9,2720,0,47.5616,2470
499000.0,4,2.5,3100,0,9,3100,0,47.3696,3060
285000.0,3,1.75,1630,0,7,1100,530,47.5351,1300
340000.0,4,2.5,1910,0,7,1210,700,47.3908,1690
405100.0,4,2.0,1580,0,7,1580,0,47.7598,1180
464000.0,3,2.5,1690,0,7,1690,0,47.6834,2220
723000.0,4,2.25,1960,0,8,1290,670,47.6076,2160
430000.0,8,3.25,4300,0,8,2800,1500,47.4786,1780
645000.0,3,1.75,1840,0,7,940,900,47.58,1600
1580000.0,4,2.75,3480,2,10,2630,850,47.6354,3770
925000.0,5,3.0,2710,0,7,1890,820,47.6754,2150
759000.0,4,1.75,2100,0,7,1340,760,47.6695,1700
690000.0,4,2.0,1760,0,8,1760,0,47.6945,1950
358800.0,4,2.5,2155,0,8,2155,0,47.4204,2155
683000.0,5,1.5,1720,0,7,1520,200,47.6197,2280
650000.0,3,1.0,1430,0,7,1430,0,47.6595,1660
288000.0,5,2.75,2790,0,7,2140,650,47.3098,1056
209950.0,3,1.5,1180,0,7,1180,0,47.2857,2030
939000.0,3,3.5,2450,4,8,1960,490,47.5476,2620
320000.0,3,1.0,1330,0,7,930,400,47.5498,1440
283748.0,3,2.25,1940,0,7,1940,0,47.2998,1800
370000.0,3,2.25,1600,0,7,1280,320,47.774,1600
399950.0,4,2.75,3210,0,8,1610,1600,47.3493,2100
360000.0,5,2.5,2880,0,8,1680,1200,47.4332,2080
365000.0,2,1.5,1160,0,7,1160,0,47.5146,1500
396900.0,3,2.0,1360,0,7,1360,0,47.6943,1360
321000.0,3,2.5,2014,0,7,2014,0,47.3371,2014
245000.0,3,2.0,1440,0,7,1440,0,47.3702,1680
502000.0,2,1.0,1570,1,8,1570,0,47.5256,1820
257000.0,4,2.75,2330,0,8,1800,530,47.2946,2320
423000.0,4,1.75,1880,0,7,1010,870,47.7129,1710
485000.0,4,2.25,1850,0,7,1850,0,47.6019,1650
500000.0,4,2.5,2230,0,8,2230,0,47.4877,2400
442000.0,2,1.0,990,2,6,990,0,47.5677,1480
475000.0,3,1.75,1720,0,7,1720,0,47.666,2000
625000.0,4,2.25,3230,0,8,3230,0,47.7685,2820
194000.0,3,1.0,1180,0,6,820,360,47.4945,1070
410000.0,3,2.25,1450,0,7,1450,0,47.62,1710
1034500.0,4,2.5,2370,0,9,2370,0,47.6336,2510
490000.0,4,2.5,2570,0,7,2570,0,47.5389,2060
348500.0,4,1.75,1870,0,7,1480,390,47.7205,1670
380000.0,3,1.0,1220,0,6,1220,0,47.6506,1350
660000.0,3,2.0,1770,0,8,1770,0,47.6102,2010
525000.0,3,1.0,1500,0,7,1500,0,47.6706,1500
235000.0,3,2.0,1110,0,7,1110,0,47.3056,1390
1210000.0,4,3.75,4980,3,11,4980,0,47.5348,4080
397950.0,4,1.75,2360,0,7,1180,1180,47.7635,1670
268000.0,3,1.75,1600,0,7,1600,0,47.284,2100
525000.0,3,1.0,1450,1,8,950,500,47.5554,1880
549950.0,3,2.5,2680,0,8,2680,0,47.7557,2680
370000.0,3,1.75,1150,0,6,1150,0,47.6709,1530
299000.0,4,2.25,1870,0,7,1870,0,47.2774,1650
715000.0,6,2.75,3400,2,8,2860,540,47.6728,1800
430000.0,4,1.5,1810,0,7,1810,0,47.7207,2060
345000.0,3,1.75,1860,0,7,1260,600,47.4338,1850
1600000.0,3,3.25,3790,4,10,3790,0,47.724,2740
534640.0,3,2.5,2130,0,8,1210,920,47.736,2030
1225000.0,3,2.5,2860,2,8,1980,880,47.6463,2310
351000.0,4,2.5,2370,0,7,2370,0,47.3982,2090
745000.0,4,2.25,2290,0,8,2290,0,47.6351,2040
320000.0,2,1.0,1120,1,6,750,370,47.5421,1530
555700.0,3,2.0,1810,0,7,1810,0,47.5888,2230
690000.0,4,2.5,3220,0,9,3220,0,47.7547,3050
449000.0,3,1.75,1660,0,7,1660,0,47.7564,2060
308500.0,2,1.0,850,0,7,850,0,47.7352,1100
340000.0,4,2.5,2665,0,9,2665,0,47.3831,2665
937750.0,4,2.75,2580,0,7,1710,870,47.6753,1980
725126.0,4,2.5,3200,0,10,3200,0,47.5273,3770
135000.0,3,1.0,840,0,5,840,0,47.494,1010
635000.0,4,2.5,2970,0,8,2020,950,47.7118,1410
245500.0,2,1.0,790,0,6,790,0,47.7644,1970
230000.0,6,1.5,2140,0,8,2140,0,47.2668,1710
1770000.0,3,2.5,2580,2,9,2580,0,47.6199,2410
425000.0,5,2.5,2180,0,7,1200,980,47.7543,1840
220000.0,2,1.0,1060,0,7,1060,0,47.705,2240
370000.0,3,2.0,1860,0,8,1860,0,47.7522,1620
390000.0,3,2.0,1840,0,7,960,880,47.4837,1810
239000.0,3,1.75,1340,0,7,1340,0,47.364,1520
345000.0,4,2.25,2320,0,8,2320,0,47.4512,2170
289000.0,3,2.5,2110,0,7,2110,0,47.3558,1680
285000.0,5,1.5,1840,0,7,1840,0,47.3668,1690
147400.0,3,2.0,1080,0,7,1080,0,47.4842,1410
600000.0,2,1.0,1290,0,7,1290,0,47.6393,1940
245000.0,3,2.25,2210,0,7,1540,670,47.4911,2230
520000.0,3,2.25,2210,0,7,1540,670,47.4911,2230
352500.0,3,2.25,1410,2,7,1170,240,47.5336,1560
448000.0,5,3.5,3740,0,9,2760,980,47.3832,2880
270000.0,4,2.75,2440,0,7,1200,1240,47.3662,1790
872500.0,3,2.5,2040,0,8,1840,200,47.6334,1820
2152500.0,4,3.25,3840,3,10,2590,1250,47.6388,3280
225000.0,3,1.5,1660,0,7,980,680,47.4962,1770
735000.0,4,2.0,1640,0,9,1640,0,47.6505,1900
375000.0,3,1.0,1310,0,7,1310,0,47.7253,1680
169000.0,3,1.75,1720,0,8,1720,0,47.3731,1970
279950.0,3,1.75,1720,0,8,1720,0,47.3731,1970
1950000.0,4,2.75,4020,4,10,2830,1190,47.6042,3150
310000.0,3,2.25,1960,0,7,1750,210,47.5419,1760
975000.0,4,2.5,3240,0,9,3240,0,47.6337,3340
650000.0,10,2.0,3610,0,7,3010,600,47.5705,2040
930000.0,2,1.5,1800,2,7,1000,800,47.6305,2270
412000.0,4,1.5,1960,0,7,980,980,47.5688,1300
225000.0,3,1.0,1250,0,6,1250,0,47.4902,1800
507000.0,3,2.5,2120,0,8,2120,0,47.7174,1930
1755000.0,4,4.0,3860,2,12,3860,0,47.7469,4410
230000.0,3,2.5,1340,0,7,1340,0,47.3839,1060
316000.0,1,2.0,1780,0,10,1780,0,47.4506,1780
616200.0,5,3.25,3920,0,9,3030,890,47.5202,2660
509900.0,3,1.75,1690,0,8,1690,0,47.6546,2290
370000.0,4,2.5,2570,0,8,2570,0,47.4237,2140
619100.0,3,1.75,1870,0,7,1870,0,47.6999,1820
805000.0,3,2.25,2860,1,8,2290,570,47.4534,2030
612125.0,2,1.5,1670,0,7,1090,580,47.6517,1670
350000.0,2,1.5,1070,0,8,1070,0,47.6761,1100
225000.0,2,1.0,940,0,7,940,0,47.4312,1450
335000.0,3,2.5,2588,0,8,2588,0,47.3449,2389
972800.0,5,3.25,3500,0,11,3500,0,47.5198,3500
500000.0,3,1.75,1690,0,7,1690,0,47.6745,2070
2200000.0,4,3.75,3790,0,10,2530,1260,47.6264,3250
415000.0,3,1.5,1090,0,7,1090,0,47.6219,1320
399000.0,3,3.0,2240,0,7,1710,530,47.5529,1530
376000.0,2,1.0,1150,0,7,1150,0,47.6575,1150
340000.0,3,2.0,1870,0,7,1120,750,47.5371,1870
490000.0,5,2.75,2990,0,8,2990,0,47.4955,2710
374000.0,4,2.5,2580,0,7,2580,0,47.4858,2160
852000.0,4,1.0,2220,0,7,1470,750,47.6854,1740
473000.0,3,2.25,1620,0,7,1620,0,47.6188,2030
540000.0,3,1.75,2590,0,8,1970,620,47.5521,2590
431000.0,2,2.0,1390,0,8,970,420,47.7499,1940
435000.0,4,3.0,2270,0,7,1410,860,47.7722,1740
1051000.0,4,3.0,2920,3,8,1460,1460,47.6164,2970
450000.0,3,2.75,1250,0,8,1040,210,47.5826,1250
157500.0,3,1.0,1100,0,6,960,140,47.4963,1280
244000.0,3,1.75,1500,0,8,1500,0,47.3155,1940
550000.0,3,2.5,2800,0,9,2800,0,47.7528,2580
975000.0,4,2.5,3420,0,10,3420,0,47.633,2260
426500.0,4,2.75,2100,0,6,2100,0,47.399,2150
350000.0,3,1.0,1790,0,7,1090,700,47.575,1360
615000.0,3,1.0,1790,0,7,1090,700,47.575,1360
542000.0,3,2.25,2220,0,8,2220,0,47.7148,2320
710000.0,4,1.75,2000,3,7,1000,1000,47.6428,2610
289950.0,3,2.5,1770,0,8,1770,0,47.3196,2200
1900000.0,4,2.75,4280,0,9,3900,380,47.6185,3590
528000.0,2,1.0,1260,0,7,1120,140,47.6805,1260
471000.0,2,1.0,840,0,7,840,0,47.6779,1550
250000.0,4,2.75,1830,0,8,1830,0,47.2601,2400
155000.0,3,1.5,970,0,7,970,0,47.3284,1230
515000.0,4,1.5,1740,0,7,1400,340,47.7243,1600
336600.0,3,2.25,1654,0,7,1654,0,47.3618,1975
915000.0,3,2.25,2390,0,8,1580,810,47.6339,2200
350000.0,2,1.75,1080,0,7,1080,0,47.7065,1800
1300000.0,4,1.75,2610,0,8,2610,0,47.6245,2920
175000.0,3,1.0,1070,0,7,1070,0,47.3377,1320
545000.0,2,2.0,1430,0,7,1430,0,47.6844,1430
475000.0,4,3.0,2400,2,7,1600,800,47.5099,2400
390000.0,2,1.0,670,0,5,670,0,47.499,2180
645000.0,4,2.5,2860,0,8,2860,0,47.7306,2650
410000.0,3,1.5,2270,0,8,1420,850,47.7573,2020
480000.0,4,2.5,2180,2,8,2180,0,47.4817,2390
725000.0,3,1.75,1860,2,8,1860,0,47.5981,3030
1150000.0,6,4.5,6040,0,11,4100,1940,47.5622,2010
300000.0,2,1.0,1010,0,6,1010,0,47.7461,1220
752000.0,4,2.5,2570,2,8,1710,860,47.5483,2050
585000.0,4,2.5,1950,0,8,1950,0,47.5503,1720
678700.0,3,1.75,1970,0,8,1300,670,47.6669,2500
603000.0,4,2.25,2110,0,9,2110,0,47.6386,2660
715000.0,3,1.75,1650,4,7,1150,500,47.6989,2300
1395000.0,4,3.0,3520,2,10,3520,0,47.7448,3260
1085000.0,3,2.5,2840,3,11,2840,0,47.7049,2580
467500.0,2,1.75,1490,0,7,750,740,47.5496,1400
359000.0,3,2.25,1650,0,7,1230,420,47.7237,1690
745000.0,4,2.0,1960,0,8,960,1000,47.58,1680
450000.0,3,2.25,2450,0,7,2450,0,47.3549,1440
935000.0,3,2.0,1720,0,8,1060,660,47.6384,1590
615000.0,3,2.5,1980,0,8,1890,90,47.5456,2160
1031000.0,3,2.5,4110,0,7,4110,0,47.6642,2710
283500.0,4,2.5,1990,0,7,1990,0,47.3191,2020
340000.0,2,1.0,860,0,6,860,0,47.7042,1450
370000.0,4,2.5,2320,0,8,2320,0,47.4449,2320
1150000.0,3,2.5,4190,0,10,4190,0,47.5642,3650
265000.0,4,1.0,1940,0,7,1080,860,47.4139,1940
480000.0,4,2.25,2520,0,8,1690,830,47.6109,1530
667500.0,3,2.0,1880,0,7,1030,850,47.6841,1700
1398000.0,3,2.5,2910,0,10,2910,0,47.5845,2420
2300000.0,7,4.75,5310,0,10,3650,1660,47.6221,2920
465000.0,3,2.25,2670,0,7,1640,1030,47.4608,1970
192500.0,1,1.0,470,2,5,470,0,47.2163,1350
345000.0,3,1.0,1060,0,6,760,300,47.5116,1310
439800.0,3,1.5,1120,0,7,1120,0,47.6023,1300
468000.0,4,1.75,2250,0,7,1330,920,47.7633,2250
775000.0,4,2.5,2070,0,8,1250,820,47.6608,2070
684680.0,4,2.25,2370,0,8,2370,0,47.6518,2370
910000.0,4,3.5,3570,0,11,3570,0,47.7173,3800
3640900.0,4,3.25,4830,4,11,4830,0,47.6409,3820
375000.0,3,1.75,1160,0,7,1160,0,47.7595,1940
250000.0,3,2.5,1610,0,7,1610,0,47.2827,1660
3065000.0,5,3.0,4150,4,11,3510,640,47.6303,2250
442500.0,4,2.25,1840,0,7,1390,450,47.7328,1820
900000.0,3,3.5,4080,3,10,4080,0,47.2604,2710
699000.0,3,2.0,1820,2,8,1820,0,47.6735,2160
360000.0,4,2.0,2680,0,8,2680,0,47.3182,1230
1675000.0,4,4.75,4790,0,12,4790,0,47.603,3830
675000.0,5,2.0,2420,0,8,2420,0,47.677,1940
345000.0,2,1.0,1130,0,7,1130,0,47.7064,1220
229000.0,4,1.0,1320,0,7,1320,0,47.5457,1640
300000.0,3,1.0,1290,0,6,1290,0,47.3719,1620
392500.0,3,3.25,1600,0,8,1600,0,47.6957,1600
552000.0,3,1.0,1120,0,7,820,300,47.6797,1430
457000.0,2,1.75,2060,0,7,1420,640,47.7038,1860
518000.0,4,2.5,2830,0,8,2830,0,47.7334,2350
237000.0,3,2.0,1210,0,7,1210,0,47.4097,1560
399950.0,3,2.25,1560,0,7,1260,300,47.5378,1820
605000.0,3,2.25,2260,0,7,2260,0,47.7537,2360
295000.0,4,2.5,1850,0,7,1850,0,47.4079,1850
513000.0,4,2.5,1930,0,7,1380,550,47.7283,2080
772500.0,4,2.5,3230,0,9,3230,0,47.6874,3220
765000.0,4,2.5,3230,0,9,3230,0,47.6874,3220
696950.0,4,2.75,2450,0,7,1550,900,47.6865,1920
329000.0,3,1.0,1200,0,7,1200,0,47.5065,1610
339999.0,3,2.5,2360,0,8,2360,0,47.3257,1860
364500.0,3,1.0,1060,0,7,1060,0,47.7317,1520
607500.0,5,1.75,2220,0,7,1420,800,47.648,1550
550000.0,3,1.0,880,0,6,880,0,47.6855,1690
479900.0,4,2.0,2510,0,8,1630,880,47.7438,1980
1120280.0,4,4.0,2530,2,9,2100,430,47.6362,2160
192000.0,2,1.0,700,0,6,700,0,47.438,890
250000.0,3,2.0,1500,0,7,1060,440,47.3653,1640
340000.0,3,2.0,1130,0,6,1130,0,47.635,1900
340000.0,3,2.0,1420,0,7,830,590,47.5102,1420
635250.0,3,2.25,2210,0,8,1510,700,47.5904,2470
324800.0,2,1.0,1170,0,6,880,290,47.5492,1430
78000.0,2,1.0,780,0,5,780,0,47.4739,1700
400000.0,4,1.75,1770,0,8,1770,0,47.7438,2150
640500.0,3,1.0,1070,2,7,1070,0,47.5305,1380
570000.0,3,2.0,1930,0,8,1260,670,47.7657,2030
1330000.0,3,1.5,1940,2,8,1940,0,47.6308,2550
330490.0,3,2.75,1440,0,7,1040,400,47.4431,1510
325000.0,3,2.5,1740,0,7,1740,0,47.3777,2180
335000.0,3,2.5,1740,0,7,1740,0,47.3777,2180
314000.0,5,2.75,2210,0,7,1460,750,47.4468,1590
625000.0,4,2.0,2190,0,8,1990,200,47.6887,1450
809000.0,3,2.5,2590,0,9,2590,0,47.659,2600
535000.0,3,2.5,2790,0,9,2790,0,47.4688,2580
275000.0,5,1.75,2180,0,7,1140,1040,47.4364,2140
358000.0,4,2.75,2580,0,7,1620,960,47.4475,1570
297975.0,3,2.25,2820,0,7,1720,1100,47.4944,1040
492000.0,2,1.75,1300,0,7,1300,0,47.4801,1300
210000.0,2,1.0,720,0,6,720,0,47.4662,2300
622500.0,3,2.5,2260,0,7,1380,880,47.5714,1870
550000.0,3,2.5,1550,0,8,1390,160,47.6355,1550
190000.0,3,1.75,1390,0,7,1390,0,47.4559,1260
340000.0,4,2.5,2380,0,8,2380,0,47.3148,2190
678000.0,3,2.5,2640,0,9,2640,0,47.7043,2680
275000.0,5,2.0,2260,0,7,1250,1010,47.3896,1950
493000.0,3,2.75,1720,0,7,1270,450,47.6138,1690
147000.0,3,1.0,1070,0,7,1070,0,47.4971,920
334000.0,3,2.25,2000,0,7,2000,0,47.349,1950
605000.0,4,2.5,2800,0,8,1420,1380,47.5959,2140
365000.0,3,1.75,1450,0,8,1450,0,47.3343,2256
345000.0,3,1.0,1620,0,6,1620,0,47.474,1680
999000.0,3,2.5,2710,4,9,2080,630,47.7608,2430
470000.0,2,1.75,1520,0,7,840,680,47.6876,1120
599000.0,5,2.75,2730,0,7,2080,650,47.5951,2260
255000.0,3,2.25,1740,0,7,1740,0,47.3815,1420
295000.0,4,1.75,1800,0,7,1800,0,47.3926,1800
550000.0,4,3.5,4150,0,10,4150,0,47.3423,3618
1305000.0,5,3.5,3270,0,9,2180,1090,47.6754,1410
225000.0,2,1.0,1070,0,5,1070,0,47.495,1910
520000.0,4,0.75,1960,4,7,1320,640,47.3648,1940
345000.0,3,3.25,1600,0,8,1360,240,47.7151,1390
475000.0,4,1.75,1650,0,7,1150,500,47.715,1390
497500.0,5,1.5,2170,0,7,1230,940,47.6111,1670
649500.0,3,3.0,3730,0,9,2230,1500,47.4257,1940
734500.0,4,2.75,3280,0,10,3280,0,47.7042,3280
276000.0,3,1.0,870,0,7,870,0,47.7048,1440
235000.0,2,1.0,900,0,6,900,0,47.5245,1360
325000.0,2,1.0,1400,0,7,1400,0,47.7726,1560
425000.0,4,2.75,1680,0,7,1080,600,47.739,1890
307000.0,4,2.0,2390,0,7,1720,670,47.3197,1950
635000.0,3,2.5,2300,0,8,2000,300,47.5785,2100
223000.0,3,1.75,1340,0,7,1340,0,47.3087,1510
425000.0,3,2.75,2600,0,9,2600,0,47.3815,2800
190000.0,3,2.25,1640,0,7,1220,420,47.3576,1560
275000.0,4,1.75,1960,0,8,1960,0,47.3131,2010
450000.0,3,2.5,1480,0,8,1480,0,47.5478,1400
1468000.0,4,3.25,5010,0,12,5010,0,47.5469,4760
550000.0,4,2.0,1540,0,7,1540,0,47.6713,1790
835000.0,4,2.75,4030,2,8,3310,720,47.7168,2490
900000.0,6,3.0,3020,0,8,3020,0,47.5722,1720
290000.0,2,2.0,1590,0,7,910,680,47.4585,1560
1035000.0,4,2.5,2910,0,10,2910,0,47.6826,1880
780000.0,4,2.5,3020,0,8,1730,1290,47.5882,2600
572500.0,3,2.0,2290,0,9,2290,0,47.6517,2250
389000.0,3,1.75,2180,0,7,1090,1090,47.3547,2050
350000.0,4,1.75,2740,0,7,1440,1300,47.5112,1710
476000.0,4,2.5,2740,0,9,2740,0,47.3333,2740
1046250.0,2,3.0,2330,0,10,1870,460,47.6316,2950
287000.0,3,2.25,2300,0,8,1550,750,47.324,2000
707500.0,4,4.0,1550,0,7,1550,0,47.6711,1830
464500.0,4,2.5,1750,0,7,1610,140,47.7425,1080
720000.0,3,1.5,2180,3,8,1090,1090,47.5787,2070
319000.0,3,2.5,1610,0,7,1610,0,47.3714,1840
330000.0,3,1.0,1570,0,7,1570,0,47.7688,1380
120750.0,3,1.75,1140,0,7,1140,0,47.2933,1510
195000.0,3,1.75,1140,0,7,1140,0,47.2933,1510
650000.0,4,1.5,2480,0,7,1380,1100,47.6445,1440
530000.0,3,1.75,1690,0,8,1690,0,47.5857,1840
825000.0,4,3.0,2910,0,8,1800,1110,47.6939,2390
436000.0,4,2.0,1600,0,7,1600,0,47.72,1660
658000.0,2,1.0,1010,4,5,1010,0,47.5476,1820
547500.0,3,2.0,1850,0,7,950,900,47.697,1430
762000.0,3,1.75,2150,0,8,1400,750,47.6629,1610
340000.0,3,1.75,2650,0,7,1460,1190,47.7525,1600
880000.0,4,1.75,2510,2,9,1830,680,47.648,2190
1220000.0,4,2.5,3240,0,9,2060,1180,47.6405,1820
1950000.0,4,2.5,3440,4,8,2170,1270,47.7364,3170
382500.0,3,2.0,1150,0,7,1150,0,47.7489,2470
344500.0,3,1.75,1890,0,7,1210,680,47.4872,2040
375000.0,4,2.75,1430,0,7,1030,400,47.5346,1480
276000.0,1,0.75,370,0,5,370,0,47.6778,1340
500000.0,5,3.25,3130,0,8,2180,950,47.5336,2410
330000.0,4,2.5,2105,0,8,2105,0,47.3531,1930
328000.0,3,1.0,890,0,7,890,0,47.7518,1930
450000.0,3,1.5,1340,0,7,1340,0,47.718,1730
840500.0,4,2.25,2290,4,7,1490,800,47.5114,2290
679000.0,3,2.5,2770,3,8,2770,0,47.5253,2660
270000.0,3,1.5,1890,0,7,1090,800,47.4829,1470
757500.0,5,2.25,3160,0,8,3160,0,47.5678,2540
524950.0,2,2.5,1830,0,7,1830,0,47.5524,1850
424900.0,4,2.75,2950,0,8,2950,0,47.3596,1720
551100.0,3,1.0,1430,0,7,1430,0,47.572,1430
421000.0,3,2.0,1420,0,7,1420,0,47.5309,2020
635000.0,4,1.75,2460,0,8,2460,0,47.7256,2760
255000.0,3,1.0,1340,0,7,1340,0,47.5272,1260
419950.0,4,1.0,1530,0,7,1030,500,47.4544,1690
325000.0,6,3.0,2650,0,7,2650,0,47.2069,1450
281000.0,4,2.25,1677,0,7,1677,0,47.32,1677
655275.0,3,1.75,2050,0,7,1460,590,47.5735,2670
861000.0,3,2.0,2520,0,8,1270,1250,47.6693,1660
850000.0,3,3.5,2620,4,9,2060,560,47.5845,2590
246000.0,3,2.5,1650,0,8,1290,360,47.2899,1880
380000.0,2,1.0,700,0,6,700,0,47.7139,1190
813000.0,4,2.5,3430,0,10,3430,0,47.6866,3110
990000.0,4,2.5,3140,0,10,3140,0,47.5817,2750
650000.0,3,2.5,2350,0,7,1740,610,47.6767,1590
273000.0,4,3.0,1990,0,7,1990,0,47.3083,1910
398000.0,4,2.5,2050,0,7,2050,0,47.73,1920
200000.0,2,1.0,930,0,6,930,0,47.4822,1630
839000.0,3,1.0,1230,0,7,1230,0,47.6095,2100
502000.0,3,2.5,1870,0,7,1250,620,47.6269,1550
305000.0,3,2.25,2110,0,7,1360,750,47.3082,1660
574950.0,5,3.25,3160,0,8,3160,0,47.52,2130
311000.0,3,1.0,1120,0,7,1120,0,47.7077,1350
1650000.0,3,2.25,2750,4,7,1620,1130,47.6163,2570
387000.0,3,1.0,1230,0,7,1230,0,47.539,1270
375000.0,3,1.5,1190,3,7,1190,0,47.4459,2150
175000.0,2,1.0,740,0,6,740,0,47.2088,1160
248000.0,4,2.5,1770,0,7,1770,0,47.3483,1790
336750.0,4,2.25,1720,0,8,1350,370,47.5119,1720
685000.0,4,2.5,2770,0,9,2770,0,47.7751,2940
645000.0,4,2.75,2330,0,9,2330,0,47.5527,2620
279000.0,3,2.5,1660,0,7,1660,0,47.3865,2240
479000.0,2,2.5,1730,0,8,1730,0,47.5594,1280
466000.0,3,2.25,1880,0,7,1280,600,47.7574,2020
361500.0,4,2.75,2190,0,7,2190,0,47.3804,1950
404000.0,3,1.75,1720,0,7,1720,0,47.5044,1720
319000.0,4,3.25,2360,0,8,2360,0,47.4403,1860
320000.0,3,1.5,1490,0,6,1490,0,47.4779,1720
1311000.0,4,3.75,3490,0,9,2610,880,47.6685,1940
1000000.0,3,2.75,2370,4,9,1670,700,47.5648,2840
660000.0,4,2.5,2290,0,8,2290,0,47.5613,2290
546000.0,4,3.0,1790,0,8,1790,0,47.6117,1770
300000.0,4,1.75,1820,0,6,1190,630,47.5569,1530
500000.0,2,1.5,1760,0,7,1760,0,47.6288,2200
381500.0,4,2.5,2430,0,8,2430,0,47.3762,2430
990000.0,3,2.25,2630,0,9,2630,0,47.5479,3140
278226.0,4,2.5,2390,0,8,2390,0,47.3527,2390
340000.0,2,1.75,1500,0,7,1220,280,47.7006,1270
305000.0,4,2.5,2510,0,8,1520,990,47.3086,2210
760000.0,4,2.5,2420,4,8,1700,720,47.4871,2540
195000.0,4,1.5,2170,0,7,2170,0,47.4263,1500
564000.0,4,1.75,1960,0,7,1260,700,47.6968,2000
539500.0,4,2.25,2280,0,8,1660,620,47.701,2590
299980.0,4,1.5,1580,0,6,790,790,47.5002,1130
290000.0,4,2.5,1850,0,7,1850,0,47.3536,1750
257000.0,2,1.0,770,0,6,770,0,47.7482,1010
518500.0,4,3.0,2120,0,8,1420,700,47.7085,2020
657000.0,4,2.75,3060,0,9,1810,1250,47.6198,1980
590000.0,3,2.25,2680,0,7,2680,0,47.4817,1940
526000.0,4,1.75,2220,0,7,1110,1110,47.7136,1950
254500.0,2,1.0,1150,0,6,1150,0,47.486,1100
575000.0,2,1.0,980,0,7,980,0,47.6645,1620
464550.0,3,1.5,1690,0,7,1690,0,47.7018,1570
409950.0,3,1.75,1320,0,7,1320,0,47.6993,1840
100000.0,2,1.0,910,0,6,910,0,47.2777,1326
365000.0,2,1.5,820,0,7,820,0,47.5925,1130
208000.0,3,1.0,1300,0,6,1300,0,47.2899,1250
497950.0,4,2.5,1950,0,7,1550,400,47.565,1540
405000.0,5,3.5,3672,0,9,3006,666,47.3255,2140
568000.0,3,2.5,2740,0,9,2740,0,47.4597,2710
334000.0,2,1.0,890,0,6,890,0,47.5437,1090
235000.0,3,2.0,1090,0,6,1090,0,47.4942,1100
295000.0,2,1.0,1170,0,7,1170,0,47.497,1340
610000.0,4,3.0,2600,0,8,2600,0,47.746,1810
453500.0,4,1.75,2000,2,7,1300,700,47.5132,1930
1220000.0,4,3.75,3520,0,8,2200,1320,47.6424,2310
175000.0,2,1.0,1410,0,7,1410,0,47.4908,1540
335000.0,2,1.0,1410,0,7,1410,0,47.4908,1540
275000.0,3,1.5,1950,0,7,1010,940,47.4594,1850
400000.0,2,1.0,980,0,6,860,120,47.6769,980
915000.0,3,2.75,3390,3,8,1740,1650,47.5701,1770
619850.0,4,2.5,2270,0,8,1500,770,47.5602,2270
225900.0,3,1.0,1510,0,7,1010,500,47.329,1290
525000.0,2,1.5,960,0,7,960,0,47.649,1550
215000.0,4,2.25,1900,0,7,1900,0,47.4208,2040
802000.0,3,2.5,2580,0,9,2580,0,47.6616,2580
330000.0,4,2.5,2340,0,9,2340,0,47.384,2250
549800.0,3,2.25,1580,0,7,1580,0,47.5872,2270
195500.0,4,1.0,1230,0,6,1230,0,47.3231,1168
338000.0,3,2.5,1590,0,7,1590,0,47.4367,1790
3200000.0,4,3.25,7000,4,12,3500,3500,47.5928,4913
480000.0,4,2.25,1770,0,7,1770,0,47.7193,1780
383000.0,4,2.5,1850,0,7,1200,650,47.7717,1840
257000.0,3,1.75,1430,0,7,1430,0,47.4189,1220
335000.0,4,2.75,2190,0,8,2190,0,47.3341,2430
422000.0,4,2.5,2310,2,8,2310,0,47.4513,1800
560000.0,3,1.75,2000,0,7,1400,600,47.6616,2050
680000.0,4,2.75,3620,0,10,3620,0,47.4238,3310
320000.0,2,1.0,1210,0,7,1210,0,47.745,1210
665000.0,3,2.5,2330,2,10,2330,0,47.655,3320
751000.0,3,2.5,2840,0,9,2840,0,47.6006,2840
320000.0,6,2.75,2410,0,7,1310,1100,47.4429,1310
290000.0,4,1.75,1820,0,7,1820,0,47.7606,1880
250000.0,4,2.0,1470,0,7,1470,0,47.3702,1390
423000.0,3,1.75,1100,0,7,1100,0,47.5374,1340
601002.0,4,2.5,2050,0,8,1050,1000,47.6614,1990
352900.0,2,1.5,1240,0,7,1240,0,47.5915,1220
509950.0,3,2.5,2210,3,9,2210,0,47.6087,2000
360000.0,2,1.75,1340,0,8,1340,0,47.7053,1340
1075000.0,4,2.75,2580,1,8,1780,800,47.5387,2840
349950.0,3,2.5,2390,0,7,2390,0,47.3659,2180
395000.0,4,2.5,2250,0,9,2250,0,47.4398,2480
273500.0,3,1.5,2000,0,8,1540,460,47.387,1920
700000.0,4,1.75,1870,0,8,1670,200,47.6435,1710
699000.0,3,2.5,2370,0,9,2370,0,47.6679,2380
537000.0,4,2.25,2640,0,8,1620,1020,47.7552,2500
405000.0,3,1.5,1240,0,6,1240,0,47.5667,1390
269500.0,2,1.0,800,0,7,800,0,47.6969,806
260000.0,4,2.5,2050,0,7,1300,750,47.42,1790
266750.0,3,2.25,1650,0,7,1650,0,47.3862,1420
1800000.0,5,3.75,4320,4,8,4320,0,47.7519,1920
779000.0,2,2.25,2130,0,8,1830,300,47.6792,2130
500000.0,3,2.5,2840,3,9,1870,970,47.6832,2710
365000.0,4,1.75,3080,0,7,3080,0,47.498,1980
724000.0,2,1.0,1560,1,7,1560,0,47.7006,2620
890000.0,4,2.75,3220,0,11,3220,0,47.7128,3670
431000.0,4,2.5,1450,0,7,1250,200,47.5985,1680
242000.0,2,1.0,960,0,6,960,0,47.4122,1020
415000.0,4,2.5,2670,0,7,2670,0,47.4292,2290
727160.0,7,3.75,2310,0,8,2310,0,47.6781,1360
1110000.0,4,3.25,3520,2,9,2010,1510,47.5572,2630
265000.0,2,1.75,1090,0,8,1090,0,47.3794,1160
519000.0,3,1.75,2000,0,7,1080,920,47.6805,1230
262000.0,4,1.5,1840,0,7,1840,0,47.406,1390
1190000.0,4,2.5,3160,0,10,3160,0,47.5472,3490
295000.0,3,1.75,1520,0,7,1170,350,47.35,1520
615000.0,3,1.75,2110,0,7,1480,630,47.7701,2570
1100000.0,4,2.75,3410,4,8,1710,1700,47.5718,3080
575000.0,4,2.5,2630,0,8,2630,0,47.5662,2130
388000.0,3,1.75,1350,0,7,1350,0,47.6965,1520
750500.0,4,2.5,2860,0,8,1530,1330,47.6923,2070
527500.0,3,1.75,2310,0,8,1760,550,47.5406,2830
503000.0,3,2.0,2590,0,8,1980,610,47.4088,3170
1047000.0,4,3.5,3500,0,10,2560,940,47.628,1910
325000.0,2,1.0,800,0,7,800,0,47.5359,1010
402000.0,3,1.75,1580,0,7,1580,0,47.7192,1500
370000.0,3,1.5,1560,0,6,1060,500,47.7024,1320
329950.0,3,1.0,1750,0,7,1150,600,47.4596,1750
135000.0,2,1.0,600,0,5,600,0,47.5,1090
482500.0,4,3.0,1630,0,7,1110,520,47.7168,1630
259000.0,4,1.5,1260,0,7,1260,0,47.433,1300
210000.0,3,2.25,2140,0,7,1470,670,47.306,2050
459000.0,4,2.75,2790,0,9,2790,0,47.4362,2900
375000.0,3,1.75,2530,0,7,1800,730,47.3913,2460
295000.0,3,2.25,1330,0,7,900,430,47.5102,1380
910000.0,3,2.0,2700,0,8,1350,1350,47.6731,1700
470000.0,4,1.0,1740,0,7,1740,0,47.5651,1810
565000.0,4,2.0,2070,0,7,2070,0,47.5092,1600
339950.0,4,2.25,2670,0,8,2170,500,47.4666,1880
547000.0,5,3.0,2200,0,7,1160,1040,47.7726,2300
125000.0,2,1.0,810,0,5,810,0,47.5033,1040
2300000.0,4,4.75,3970,2,11,3390,580,47.6312,3970
348000.0,3,2.5,2370,3,8,1620,750,47.4091,1960
175000.0,3,1.0,1460,0,7,1460,0,47.3762,1310
439950.0,3,2.5,1770,0,8,1770,0,47.5631,1770
230000.0,3,1.0,1120,0,6,1120,0,47.447,1010
207000.0,3,2.5,1520,0,7,1520,0,47.5245,1460
320000.0,5,2.5,3020,0,8,1510,1510,47.3392,1610
1089000.0,5,3.25,5600,0,10,3440,2160,47.7341,3470
510000.0,4,1.5,1320,0,7,1320,0,47.7016,1720
730000.0,4,1.0,1870,0,7,1670,200,47.6437,2160
750000.0,3,3.75,2460,0,8,1940,520,47.7147,2000
237000.0,3,1.5,960,0,7,960,0,47.3798,1640
560000.0,3,2.5,3440,0,9,3440,0,47.3895,2710
745000.0,3,2.75,3010,0,8,1890,1120,47.6392,2500
1825000.0,3,3.75,6030,0,11,4440,1590,47.6055,4040
180000.0,3,2.25,1990,0,7,1990,0,47.3822,1220
309950.0,3,2.25,1990,0,7,1990,0,47.3822,1220
715000.0,4,1.0,1710,0,7,1410,300,47.5569,1560
620000.0,4,2.25,1890,0,7,1350,540,47.6649,1830
330000.0,3,2.5,1990,0,7,1990,0,47.383,1680
525000.0,4,1.75,1600,0,7,1210,390,47.7111,1640
611000.0,6,2.5,3820,0,9,2040,1780,47.5209,2510
294000.0,4,2.5,2210,0,8,1490,720,47.2647,2210
463000.0,3,1.75,2020,0,7,1480,540,47.7351,2030
320900.0,3,2.0,1770,0,8,1770,0,47.4087,2560
369950.0,4,2.5,2050,0,7,2050,0,47.5002,2480
565000.0,4,2.75,3130,0,9,3130,0,47.3535,2720
589500.0,4,1.5,3520,0,8,2270,1250,47.5655,1710
400000.0,4,1.75,1810,0,7,1810,0,47.7681,1570
458000.0,3,2.25,2150,0,8,1450,700,47.6647,2170
436000.0,4,2.5,2495,0,7,2495,0,47.7243,2490
310000.0,3,2.0,1290,1,6,1290,0,47.5181,1960
398000.0,5,2.5,3004,0,9,3004,0,47.3801,2665
625000.0,4,2.25,2070,0,8,1390,680,47.697,2110
1005000.0,5,3.25,4050,0,12,4050,0,47.5465,4770
435000.0,2,1.0,960,0,6,740,220,47.5378,1090
250000.0,3,2.25,1900,0,7,1300,600,47.3478,1900
430000.0,3,1.5,1450,0,7,1450,0,47.7725,1440
790000.0,4,3.5,2720,0,9,2250,470,47.5371,1600
1681000.0,5,5.25,4830,1,9,3930,900,47.5858,2880
250000.0,4,2.75,1920,0,7,1130,790,47.539,1830
1120000.0,5,1.5,2540,3,8,2340,200,47.5144,2460
383900.0,3,1.5,1600,0,7,1050,550,47.7471,1810
330000.0,4,2.5,2210,0,8,2210,0,47.35,2200
624000.0,3,2.5,2510,0,7,1910,600,47.7531,2510
383000.0,5,2.0,2280,0,8,1140,1140,47.5672,1780
687000.0,4,3.25,4400,0,9,4400,0,47.1593,2280
558000.0,4,3.25,3160,0,9,2460,700,47.5153,2900
275000.0,3,2.0,1380,0,7,1380,0,47.5558,1620
687500.0,5,2.75,3320,0,7,2020,1300,47.692,1840
275000.0,3,2.5,1870,0,7,1870,0,47.3065,1970
700000.0,3,3.5,3030,2,8,3030,0,47.5051,2340
342500.0,2,1.75,1210,0,7,1210,0,47.7078,1840
483500.0,4,2.5,2740,0,8,2740,0,47.74,2080
190000.0,3,1.75,1350,0,6,1350,0,47.5336,1440
300000.0,3,1.75,1350,0,6,1350,0,47.5336,1440
540000.0,3,2.0,1470,0,8,1000,470,47.6743,1660
140000.0,3,1.75,1270,0,7,1270,0,47.3563,1270
275000.0,4,1.75,1680,0,7,1560,120,47.4552,2000
370000.0,3,2.75,2120,0,7,2120,0,47.4923,1180
227000.0,2,1.0,1040,0,7,1040,0,47.7407,1950
312000.0,4,1.0,1730,0,7,1010,720,47.4586,1369
260000.0,2,1.0,1410,0,6,1410,0,47.5159,1430
797000.0,3,2.5,1370,0,9,1370,0,47.6375,1630
640000.0,6,2.0,2840,0,6,2720,120,47.7158,2330
605000.0,4,1.75,3280,0,7,2080,1200,47.6728,2510
329950.0,3,2.25,2070,0,7,1350,720,47.403,1620
180000.0,2,1.0,960,0,5,960,0,47.63,1940
220000.0,3,2.25,1470,0,7,1160,310,47.2725,1720
723000.0,4,2.25,2430,0,8,1630,800,47.5904,2430
375000.0,3,1.75,1430,0,7,1070,360,47.7218,1490
388000.0,3,1.75,1760,0,7,1760,0,47.4977,1760
249950.0,5,2.0,1730,0,6,1730,0,47.4953,1550
390000.0,5,1.75,2290,0,7,1190,1100,47.7577,1870
705000.0,4,1.75,1690,0,8,1690,0,47.552,2300
590000.0,4,2.5,3220,0,8,3220,0,47.626,1600
292000.0,4,1.75,2130,0,7,1370,760,47.4629,1850
506000.0,3,2.5,2100,0,8,2100,0,47.2984,1330
907500.0,4,2.5,2770,0,9,2770,0,47.6599,2670
2271150.0,4,3.25,4040,0,9,4040,0,47.6155,3000
319500.0,4,2.75,2500,0,7,1420,1080,47.523,1430
265000.0,5,1.75,1580,0,6,980,600,47.5677,1600
237000.0,3,1.0,1130,0,7,1130,0,47.4363,1320
235000.0,5,1.0,1500,0,6,1500,0,47.4702,1520
740000.0,4,2.25,2230,2,8,1810,420,47.6464,2840
359000.0,3,1.5,1550,0,7,1080,470,47.7035,940
334950.0,4,2.5,2230,0,7,2230,0,47.3533,1910
259950.0,2,1.0,790,0,6,790,0,47.7159,1420
253000.0,4,2.5,2230,0,7,2230,0,47.3848,2800
561000.0,3,2.25,1710,0,8,1710,0,47.5498,1730
455000.0,2,1.5,1260,0,7,1260,0,47.6914,1640
675000.0,4,2.5,2420,0,8,920,1500,47.6001,2690
267000.0,3,1.5,1090,0,7,1090,0,47.4551,1260
368000.0,4,2.5,2689,0,9,2689,0,47.3799,2665
599995.0,3,1.0,1620,0,7,1620,0,47.6888,1420
342500.0,3,1.0,940,0,7,940,0,47.7268,1660
252000.0,4,1.75,1940,0,8,1940,0,47.3215,2405
247200.0,3,1.0,1590,0,7,1590,0,47.2894,1560
910000.0,3,3.5,3020,0,9,2080,940,47.651,2060
419950.0,4,1.75,1870,0,8,1870,0,47.7482,1870
160000.0,3,1.0,880,0,6,880,0,47.3056,990
799950.0,4,3.5,3030,0,9,3030,0,47.7103,2910
400000.0,3,2.25,2140,0,7,2140,0,47.7267,2000
210000.0,5,2.0,2050,0,6,1430,620,47.4136,1940
475000.0,5,2.0,2050,0,6,1430,620,47.4136,1940
355900.0,3,2.5,2090,0,7,2090,0,47.3655,2040
420000.0,3,2.25,2520,0,7,1760,760,47.7728,2300
710000.0,4,2.5,2630,0,9,1700,930,47.5916,2430
518000.0,4,1.75,2560,0,7,1880,680,47.5952,2210
375000.0,3,1.0,1200,0,6,1200,0,47.6969,1200
185000.0,3,1.5,1010,0,6,1010,0,47.4238,1270
402000.0,3,2.5,1520,0,7,1520,0,47.6801,1640
585000.0,3,1.75,2170,0,7,2170,0,47.3694,2840
500000.0,4,2.0,1980,0,7,1980,0,47.6728,1550
1715000.0,4,2.5,3070,0,10,2670,400,47.6325,3190
1680000.0,5,3.5,5170,4,11,3520,1650,47.7561,3020
570000.0,2,2.0,1140,0,8,760,380,47.6205,1480
680000.0,8,2.75,2530,0,7,1390,1140,47.6241,1540
345000.0,3,2.25,1690,0,7,1690,0,47.4492,1390
355000.0,4,2.5,2150,0,7,2150,0,47.3658,2220
390000.0,3,1.5,1180,0,7,1180,0,47.6133,1510
128000.0,3,1.0,1400,0,7,1400,0,47.3201,1280
448500.0,3,1.75,1300,1,7,1300,0,47.5457,1300
346000.0,3,1.75,1590,0,6,1590,0,47.754,1800
779000.0,3,1.75,1990,1,8,1330,660,47.65,2630
335000.0,3,1.75,1510,0,7,1510,0,47.7728,1520
1850000.0,4,3.25,2910,3,9,1830,1080,47.616,3100
799990.0,3,2.5,2850,0,10,2850,0,47.6455,3020
1075000.0,3,2.5,2830,0,11,2830,0,47.7409,2830
371000.0,2,1.5,1110,0,8,1110,0,47.6711,1420
620000.0,4,2.5,1900,0,7,1900,0,47.6856,1990
343000.0,4,1.75,2290,0,7,1340,950,47.5045,1800
265000.0,3,1.0,1010,0,6,1010,0,47.4772,1510
1000000.0,5,2.5,4670,0,11,4670,0,47.63,3810
825000.0,3,2.5,3400,4,8,1870,1530,47.7611,3400
889000.0,4,3.5,4070,0,10,4070,0,47.5805,4080
305000.0,3,2.25,1630,0,8,1100,530,47.3801,1830
407000.0,2,2.5,1700,0,8,1700,0,47.6655,1700
613000.0,5,2.5,2070,0,7,1340,730,47.626,2090
1637500.0,3,3.5,4660,4,12,4660,0,47.4418,3140
645000.0,3,3.75,2050,0,7,1550,500,47.6873,1780
1160000.0,4,3.5,4680,0,10,3360,1320,47.5703,2800
610000.0,3,2.25,2320,0,8,2320,0,47.6645,2875
450000.0,3,2.5,3800,0,10,2730,1070,47.3076,2980
300000.0,3,2.0,720,0,6,720,0,47.5483,1080
1120000.0,5,2.75,4400,3,9,2250,2150,47.7424,3290
418200.0,3,2.5,2260,0,9,2260,0,47.2704,3110
250000.0,3,2.5,1650,0,7,1650,0,47.4328,1490
619000.0,3,2.5,2560,0,9,2560,0,47.7614,3000
500000.0,4,3.0,3720,0,7,3720,0,47.5116,2020
465000.0,4,2.5,2590,0,8,2590,0,47.3714,2320
322000.0,4,1.0,1750,0,7,1750,0,47.4442,1550
276900.0,3,2.5,1620,0,7,1620,0,47.3617,1550
660000.0,3,2.25,1700,0,7,1300,400,47.6965,1950
480000.0,3,2.5,2450,0,9,2450,0,47.4665,2440
925000.0,3,1.75,1610,0,7,1070,540,47.6272,1940
825000.0,3,3.0,3730,0,9,2960,770,47.5814,2280
326000.0,2,1.0,1210,0,6,780,430,47.7376,1070
205000.0,3,1.0,1300,0,7,1300,0,47.3352,2140
150000.0,2,1.0,850,0,4,850,0,47.2959,1550
593567.0,3,2.5,1770,0,9,1770,0,47.6658,2120
440000.0,3,2.5,2060,0,8,2060,0,47.7571,2140
751000.0,3,2.5,3090,0,10,3090,0,47.588,2980
295000.0,2,1.75,1050,2,6,1050,0,47.4727,1320
422500.0,3,2.0,1300,0,7,1300,0,47.6923,1300
480000.0,3,1.0,1160,0,7,1160,0,47.6112,1750
890900.0,4,2.5,3420,0,9,3420,0,47.5416,3350
672500.0,4,2.75,2620,0,9,2620,0,47.5965,2590
605000.0,4,1.5,1880,0,7,1080,800,47.6835,1690
1675000.0,5,3.25,4560,0,9,2490,2070,47.6291,3390
565000.0,4,2.5,2330,0,9,2330,0,47.6269,2460
725000.0,4,1.75,2350,0,8,1720,630,47.5634,2220
640000.0,3,3.0,1560,0,8,1560,0,47.6604,1530
253750.0,4,1.0,1380,0,6,1380,0,47.3846,1430
799950.0,6,2.75,3040,3,9,1760,1280,47.4488,2420
595000.0,4,1.5,1350,0,7,1350,0,47.5807,1930
850000.0,4,2.5,3180,1,9,3180,0,47.567,3110
366000.0,3,2.5,1790,0,8,1790,0,47.7344,2480
715000.0,4,3.0,1986,2,8,1746,240,47.5374,1930
300000.0,4,2.5,2400,0,8,2400,0,47.2944,2220
960000.0,4,3.0,4590,0,10,3490,1100,47.7234,2910
812000.0,3,2.0,1970,3,8,1970,0,47.6762,1770
234950.0,3,1.0,1360,0,6,1360,0,47.3422,1670
656500.0,4,2.0,2710,0,7,1460,1250,47.6756,1700
255000.0,2,1.5,920,0,7,920,0,47.7081,1110
538000.0,3,2.75,2000,0,7,1250,750,47.565,2480
260000.0,3,2.25,1920,0,7,1300,620,47.412,1500
546200.0,3,2.5,2678,0,9,2678,0,47.738,2780
280500.0,3,1.0,1220,0,7,890,330,47.5387,1670
295000.0,3,1.75,1440,0,7,1050,390,47.5329,1560
700000.0,4,1.75,2420,0,7,2420,0,47.6209,1200
560000.0,3,2.0,2090,0,9,2090,0,47.7296,1820
912000.0,4,2.75,4030,0,10,4030,0,47.5651,3720
437000.0,3,1.75,1310,0,7,1310,0,47.6844,1310
447000.0,3,2.5,1800,0,7,1800,0,47.7631,1610
500000.0,4,1.0,1160,0,6,820,340,47.5175,1670
508300.0,3,1.0,1160,0,7,880,280,47.6844,1550
485000.0,3,1.5,1870,0,7,1300,570,47.7045,1870
540000.0,7,5.75,3700,1,8,3700,0,47.7393,2510
356000.0,3,2.25,2280,0,8,2280,0,47.4419,1920
525000.0,4,2.0,1720,0,7,860,860,47.6765,1100
962800.0,4,2.75,3630,0,10,3630,0,47.6378,3800
315000.0,4,2.5,2040,0,8,2040,0,47.3918,2260
525000.0,3,2.25,1750,0,8,1750,0,47.6722,1750
325000.0,2,2.25,1550,0,8,1550,0,47.5398,1550
965800.0,4,1.75,2500,0,8,1500,1000,47.6304,1900
550000.0,4,1.0,1440,0,7,1440,0,47.5694,1010
182200.0,4,1.0,1130,0,6,1130,0,47.4939,1800
315000.0,3,1.0,1210,0,7,1210,0,47.5389,1430
500000.0,2,1.0,960,0,7,960,0,47.6755,1330
480000.0,5,2.5,2160,0,7,2160,0,47.5381,2460
1690000.0,3,1.75,3400,2,9,1820,1580,47.6569,3200
525000.0,5,3.25,3960,0,9,2690,1270,47.3984,2360
407500.0,4,2.5,1900,0,7,1900,0,47.7776,1800
443000.0,4,3.0,2620,0,9,2620,0,47.3067,2920
1256500.0,4,2.5,3150,0,9,3150,0,47.5309,3200
642000.0,3,1.0,1040,0,7,870,170,47.6461,1730
520000.0,3,1.75,1540,0,8,1540,0,47.6707,1540
750000.0,3,2.0,1820,0,8,1720,100,47.5845,2220
855000.0,5,1.5,1930,0,8,1930,0,47.6401,2083
275000.0,4,1.0,1430,0,5,1430,0,47.5372,1880
265000.0,5,2.75,2920,0,7,1800,1120,47.3072,1220
894400.0,3,2.5,3100,0,10,3100,0,47.6854,3340
546000.0,2,1.0,1200,0,6,1200,0,47.5321,1740
699950.0,2,2.5,2390,0,8,2390,0,47.7243,2170
435000.0,3,2.0,1270,0,7,1270,0,47.7247,1620
259500.0,4,1.5,1300,0,7,1300,0,47.4179,1420
359950.0,4,3.25,2290,0,9,2290,0,47.3833,2290
517000.0,3,1.75,1740,0,7,1740,0,47.617,1350
579000.0,3,1.0,1590,1,8,1280,310,47.5509,2140
525000.0,4,2.0,2420,0,7,2420,0,47.6899,1570
320000.0,4,2.5,2130,0,7,1500,630,47.4068,2000
635000.0,4,1.75,1950,0,8,1370,580,47.6196,2120
400000.0,4,2.5,2150,0,8,2150,0,47.4644,2260
455000.0,3,1.75,1270,0,7,1270,0,47.6711,1510
572000.0,3,1.75,1850,4,6,1850,0,47.6144,2700
650000.0,2,1.5,1440,0,8,1140,300,47.7608,1740
162500.0,3,1.5,1390,0,7,1390,0,47.3369,1390
400000.0,2,2.5,1340,0,8,1150,190,47.6858,1280
268300.0,3,1.0,1190,0,7,1190,0,47.77,1960
989000.0,6,4.5,3830,0,9,3050,780,47.6404,1990
342000.0,3,1.75,1780,0,7,1280,500,47.4627,1780
315000.0,4,2.5,3130,0,7,3130,0,47.3837,3020
485000.0,4,2.75,1830,0,7,1320,510,47.733,2190
277500.0,4,2.5,2550,0,8,1750,800,47.3165,2260
1295000.0,4,3.5,3790,0,11,3790,0,47.6587,3410
385000.0,4,1.75,1800,0,6,1800,0,47.5312,1530
426000.0,2,1.0,1630,0,7,830,800,47.7092,1250
310000.0,4,2.0,1870,0,7,1870,0,47.7155,1520
449000.0,4,2.0,1870,0,7,1870,0,47.7155,1520
375000.0,2,1.0,980,0,7,980,0,47.5589,1425
1187500.0,3,2.25,2860,4,10,1920,940,47.6915,2860
468000.0,3,2.25,1470,0,7,1470,0,47.5674,1610
336000.0,1,1.0,1160,0,7,1160,0,47.5883,2060
392000.0,4,2.75,1940,0,8,1940,0,47.3701,1840
412500.0,4,2.25,1630,0,7,1100,530,47.7336,1580
545000.0,4,2.5,2755,0,8,2755,0,47.7394,2820
133000.0,5,2.0,1430,0,6,1430,0,47.5192,1860
440000.0,5,2.0,1430,0,6,1430,0,47.5192,1860
294450.0,4,2.25,1400,0,7,1300,100,47.7565,2090
335000.0,4,2.5,2520,0,8,2520,0,47.343,2350
362000.0,3,1.0,1290,0,7,1290,0,47.7641,1760
322000.0,3,1.75,1400,0,6,1400,0,47.725,2240
230500.0,2,1.0,740,0,6,740,0,47.4793,850
380000.0,4,2.0,1710,0,7,1710,0,47.5472,1550
292000.0,4,2.75,2414,0,8,2414,0,47.3046,1500
172500.0,3,1.0,1040,0,6,1040,0,47.4206,1270
784000.0,4,2.75,3540,1,8,1970,1570,47.6467,2200
525000.0,4,2.75,2530,0,7,1700,830,47.6557,2530
600000.0,3,2.5,2320,0,8,2320,0,47.5391,2590
435000.0,3,2.5,2530,0,9,2530,0,47.371,2370
359900.0,5,2.75,2790,0,7,2790,0,47.4999,1480
700000.0,4,1.75,1950,4,7,1150,800,47.5121,1600
280000.0,3,2.0,1020,0,7,720,300,47.5434,1130
655000.0,4,2.5,3110,0,9,3110,0,47.4898,3080
2480000.0,4,5.0,5310,4,12,3090,2220,47.5515,5220
499950.0,3,2.5,2580,0,9,2580,0,47.2978,1660
540000.0,3,2.5,1380,0,8,1160,220,47.6148,1440
970000.0,4,2.75,3980,0,11,3980,0,47.6286,3800
330000.0,4,2.5,2080,0,8,1400,680,47.4252,2090
474000.0,3,1.75,1530,0,7,1530,0,47.6971,1530
670000.0,4,1.75,1930,0,9,1930,0,47.6158,2110
1300000.0,4,3.25,2330,3,9,2330,0,47.6264,3880
1160000.0,4,2.5,3860,2,10,2940,920,47.5517,3720
440000.0,4,2.5,2880,0,9,2880,0,47.439,2650
411000.0,2,2.5,1590,0,9,1590,0,47.6897,2320
500000.0,3,1.5,2150,0,7,1470,680,47.5733,1750
1335000.0,4,1.75,2300,4,7,2300,0,47.7308,2500
696000.0,6,3.25,2900,0,8,2300,600,47.6464,2480
465000.0,3,2.25,1970,0,8,1180,790,47.7651,1970
518000.0,4,2.5,1740,0,7,1220,520,47.6927,1790
251000.0,3,1.75,1220,0,7,1220,0,47.4887,1700
255000.0,3,2.0,1290,0,7,1290,0,47.3787,1290
319000.0,2,1.0,780,0,6,780,0,47.7,2220
719000.0,4,2.75,2210,0,7,1470,740,47.6826,1500
1520000.0,5,3.5,5930,2,11,3920,2010,47.5542,3860
322000.0,4,2.5,1950,0,7,1950,0,47.5066,1780
205000.0,4,1.0,1340,0,7,1340,0,47.2845,1090
229000.0,3,1.0,1590,0,7,1060,530,47.4936,1410
395000.0,3,2.25,1780,0,8,1350,430,47.7774,1860
183000.0,2,1.0,760,0,7,760,0,47.3205,1370
583500.0,3,1.75,1720,0,7,1170,550,47.6928,1760
312000.0,3,2.5,2070,0,6,2070,0,47.2032,1350
539000.0,3,1.75,1790,0,7,1410,380,47.6989,1820
409000.0,4,2.75,3230,0,8,3230,0,47.3157,2550
510250.0,3,1.75,1400,0,7,870,530,47.6913,1400
535000.0,2,2.0,1370,0,7,1020,350,47.652,1550
280000.0,3,2.5,1600,0,7,1600,0,47.3673,1830
286000.0,3,1.0,950,0,7,950,0,47.5104,1250
710000.0,3,2.75,2210,1,7,1460,750,47.5619,2110
395000.0,2,1.0,930,0,7,930,0,47.6915,1180
237500.0,2,1.0,810,0,6,810,0,47.7389,1050
464000.0,3,2.0,1630,0,7,850,780,47.5452,1440
495000.0,3,1.75,1770,0,8,1770,0,47.7218,1860
257500.0,1,1.0,710,0,6,710,0,47.5621,1440
570000.0,4,3.5,3990,2,10,2300,1690,47.3245,3410
362000.0,3,2.5,2310,0,8,2310,0,47.439,2310
640000.0,33,1.75,1620,0,7,1040,580,47.6878,1330
172500.0,3,1.0,1140,0,7,1140,0,47.2629,1270
596000.0,2,1.0,1040,0,7,1040,0,47.6809,1500
840000.0,4,2.5,2170,0,8,1650,520,47.5505,2350
1600000.0,3,2.25,3370,4,10,1920,1450,47.7434,3410
435000.0,2,1.5,901,0,7,901,0,47.6774,1138
251000.0,2,1.0,840,0,6,840,0,47.7389,1442
282500.0,4,1.0,1650,0,7,1650,0,47.4991,1650
265000.0,3,2.25,1380,0,7,1140,240,47.3677,1640
330000.0,3,1.0,910,0,6,910,0,47.6729,1140
435000.0,2,1.0,1230,0,7,1230,0,47.6797,1610
827235.0,3,1.75,1740,0,8,1500,240,47.6475,2240
249950.0,4,1.0,1290,0,7,1290,0,47.513,1440
400000.0,3,2.5,1950,0,8,1950,0,47.5647,1810
300499.0,4,2.5,2150,0,8,2150,0,47.259,2170
449000.0,4,2.0,1560,0,7,1560,0,47.6905,1300
500000.0,2,1.0,1120,0,7,1120,0,47.6588,1440
865000.0,3,1.5,1790,0,7,1790,0,47.6387,2080
899950.0,4,3.5,3290,1,9,2360,930,47.7074,1820
370000.0,4,1.0,1540,0,7,1540,0,47.7104,1290
442500.0,5,3.25,4240,0,8,3410,830,47.6472,2980
310000.0,3,1.0,1010,0,6,1010,0,47.5324,1390
1565000.0,4,2.75,2970,1,7,2130,840,47.6135,1980
245000.0,4,2.25,2190,0,7,2190,0,47.3241,1570
254950.0,2,1.0,700,0,6,700,0,47.7492,1230
510000.0,6,4.5,3300,0,8,3300,0,47.6796,2470
299950.0,3,2.25,1370,0,7,1370,0,47.7372,1600
379950.0,4,2.5,2680,0,8,2680,0,47.3561,2010
350000.0,3,1.0,1390,0,7,910,480,47.704,1320
300000.0,3,2.5,1700,0,7,1700,0,47.5418,1590
994000.0,3,2.25,2510,2,8,1810,700,47.6496,1820
315000.0,3,1.5,1700,0,7,1250,450,47.7384,1340
480500.0,4,2.5,2180,0,8,2180,0,47.7476,1790
373000.0,3,1.0,1770,0,7,1140,630,47.5546,1500
728000.0,4,2.5,3290,0,9,3290,0,47.5999,3240
415000.0,4,3.5,3040,1,8,2240,800,47.492,2220
427500.0,4,2.5,2460,0,9,2460,0,47.45,2490
339300.0,3,2.0,970,0,7,970,0,47.6205,1230
313000.0,3,1.75,1320,0,7,1320,0,47.7412,1210
431500.0,3,3.5,1900,0,8,1430,470,47.544,1780
415000.0,3,1.5,1220,0,6,1220,0,47.6981,1360
490000.0,3,1.75,1470,0,7,1470,0,47.6975,1800
1425000.0,4,5.0,4630,3,11,4630,0,47.587,4630
275000.0,3,1.5,1400,0,6,1400,0,47.3768,1160
325000.0,2,1.0,1070,0,6,1070,0,47.5224,900
1180000.0,5,3.75,3630,0,9,2470,1160,47.6816,2560
690000.0,4,1.5,1970,0,7,1970,0,47.666,1900
410000.0,4,2.0,2010,0,7,2010,0,47.4234,2140
960000.0,4,2.5,2820,3,9,1770,1050,47.5706,2230
299250.0,3,2.5,2530,0,9,2530,0,47.3073,2530
239000.0,2,1.0,710,0,6,710,0,47.4379,1500
235000.0,2,1.0,1210,0,6,1210,0,47.5342,1580
587000.0,3,2.25,2370,0,7,2370,0,47.6364,3100
431000.0,4,2.5,2300,0,7,2300,0,47.5125,1770
1636000.0,3,2.5,3110,1,9,2550,560,47.6886,2630
285000.0,3,1.75,1990,0,7,1090,900,47.488,2150
778000.0,3,3.0,2630,0,9,2630,0,47.5481,2660
415000.0,3,1.0,1300,0,7,1300,0,47.611,1570
550285.0,2,1.75,1680,0,8,1680,0,47.7132,1670
910000.0,3,2.25,2180,0,8,1660,520,47.5358,2600
860000.0,3,2.5,2770,0,10,2770,0,47.5605,2890
765000.0,3,1.75,2120,0,7,1980,140,47.6666,2020
782000.0,4,2.5,2830,0,10,1980,850,47.6462,2830
525000.0,3,3.5,1370,0,8,1180,190,47.6511,1400
745000.0,3,2.5,2810,0,9,2810,0,47.4816,2380
470000.0,3,3.5,3520,2,8,2760,760,47.2416,2860
345000.0,3,1.75,1990,1,7,1320,670,47.5086,2130
279000.0,3,2.25,2070,0,7,1170,900,47.3431,1570
500000.0,3,1.5,1320,0,7,1320,0,47.7194,1480
237000.0,3,1.0,1300,0,7,1300,0,47.511,1290
200500.0,3,1.75,1260,0,7,1260,0,47.3713,1800
387500.0,4,1.75,2400,0,7,1250,1150,47.4631,1960
392500.0,4,2.0,1950,0,7,1950,0,47.7074,1950
305000.0,3,2.0,1430,0,7,1430,0,47.4903,1200
981000.0,4,2.5,2110,2,8,2110,0,47.567,2230
680000.0,4,2.5,2980,0,10,2980,0,47.5814,2940
276000.0,4,2.5,2068,0,7,2068,0,47.3318,1560
655500.0,4,3.5,3380,0,8,3380,0,47.7741,2220
555000.0,5,2.75,2810,0,8,1440,1370,47.6199,2480
235000.0,2,1.0,930,0,6,930,0,47.4337,1520
325000.0,3,1.0,1300,0,7,920,380,47.7465,1530
268950.0,3,1.0,1320,0,6,880,440,47.4697,1000
264500.0,3,1.5,1580,0,7,1050,530,47.2932,2240
240000.0,3,2.5,1620,0,8,1620,0,47.3538,1650
819000.0,3,2.5,2750,0,9,2750,0,47.4376,1250
850000.0,2,1.5,2210,2,8,1530,680,47.6122,2700
294950.0,4,2.25,1740,2,7,1160,580,47.432,1630
693000.0,3,2.25,2120,1,9,1420,700,47.5574,2950
478000.0,4,2.5,2780,0,8,2780,0,47.509,2450
222000.0,2,1.0,830,0,7,830,0,47.7234,1470
635000.0,4,2.5,2070,0,8,2070,0,47.5284,2440
469000.0,3,3.25,1390,0,8,1140,250,47.6735,1390
350000.0,4,2.5,2610,0,8,2610,0,47.3441,2480
180000.0,5,1.0,1460,0,6,1290,170,47.5039,1460
490000.0,4,2.25,3390,0,8,1640,1750,47.461,2160
360000.0,3,1.5,1360,0,6,860,500,47.6846,1560
630000.0,4,2.5,2807,0,8,2807,0,47.7449,2028
615000.0,4,1.0,1340,0,7,1340,0,47.6357,2040
279950.0,3,2.25,1340,0,7,1340,0,47.3563,1470
317000.0,3,1.0,1160,0,7,1160,0,47.7257,1200
618000.0,4,2.25,2470,0,7,1600,870,47.6936,1970
620000.0,5,1.75,2000,2,7,1000,1000,47.5882,2040
345000.0,3,1.0,1110,0,7,1110,0,47.6977,2010
608000.0,3,1.5,2240,0,7,1220,1020,47.6624,1570
325000.0,4,2.25,1920,0,7,1920,0,47.4315,1840
475000.0,3,1.75,2270,0,8,2270,0,47.4474,2440
154000.0,3,3.0,1530,0,6,1020,510,47.2861,1410
1190000.0,5,3.0,3330,0,11,2610,720,47.5485,3330
376950.0,4,2.5,2643,0,8,2643,0,47.3519,2406
500000.0,2,2.0,1250,0,7,1250,0,47.6526,1250
499950.0,3,2.5,3230,0,8,2100,1130,47.682,2760
230000.0,3,1.0,880,0,6,880,0,47.476,1440
652600.0,4,2.5,2220,0,8,2220,0,47.6956,1620
185000.0,3,1.75,1130,0,7,1130,0,47.307,1830
274950.0,3,1.0,1450,0,6,1050,400,47.4698,1510
447000.0,2,1.0,760,0,6,760,0,47.5443,2110
129000.0,2,1.0,1150,0,6,1150,0,47.4492,1670
436000.0,5,3.0,2720,0,8,2720,0,47.4778,1420
825000.0,3,1.75,2080,0,8,2080,0,47.6717,1820
225000.0,3,1.0,1080,0,6,1080,0,47.2873,1610
265000.0,3,2.5,1890,0,7,1890,0,47.2886,1700
765000.0,3,1.5,1500,0,8,1500,0,47.6118,2380
509000.0,4,2.0,1960,0,7,1260,700,47.6545,1670
762450.0,4,1.75,2570,0,8,2570,0,47.5956,2520
465000.0,5,1.5,1830,2,7,1030,800,47.7488,2610
564000.0,3,1.75,1980,1,7,1090,890,47.554,1980
384500.0,2,1.0,1130,0,6,1130,0,47.5103,1010
415000.0,3,2.0,2010,2,8,2010,0,47.2133,1840
345000.0,2,1.75,1820,0,6,910,910,47.7538,1300
465950.0,4,2.5,2340,0,7,2340,0,47.4896,2950
325000.0,3,1.75,1780,0,7,1210,570,47.617,1780
500000.0,3,1.75,1780,0,7,1210,570,47.617,1780
450000.0,4,2.5,2450,0,8,1410,1040,47.5887,2450
475000.0,4,3.0,2410,0,7,1210,1200,47.7202,2050
1346400.0,5,1.75,3380,0,8,1690,1690,47.6395,3260
747000.0,3,1.5,1710,0,7,1710,0,47.6801,1530
395000.0,3,1.75,1740,0,6,1740,0,47.762,1630
505000.0,3,2.5,1995,0,8,1760,235,47.6025,1520
215000.0,3,2.0,1760,0,7,1100,660,47.3413,1730
775000.0,4,3.5,3970,0,9,3970,0,47.4614,1680
540000.0,4,2.5,3000,0,8,3000,0,47.4797,2730
392500.0,3,1.75,1540,0,7,1540,0,47.7762,1620
987000.0,3,2.0,2160,0,8,2160,0,47.6227,2260
1190000.0,3,2.0,2160,0,8,2160,0,47.6227,2260
252500.0,3,2.0,1810,0,8,1810,0,47.4619,2140
730000.0,3,3.5,2440,0,7,1970,470,47.589,2440
497300.0,6,2.75,3200,2,8,1600,1600,47.492,2220
640000.0,4,2.5,2970,0,9,2970,0,47.7365,3170
580000.0,5,2.0,2290,0,7,1190,1100,47.634,1460
377000.0,3,1.75,1820,0,6,1820,0,47.4616,2570
1280000.0,4,3.5,3010,0,9,2370,640,47.6341,2650
396500.0,3,1.5,1360,0,7,1120,240,47.6526,1360
300000.0,4,2.5,2080,0,8,2080,0,47.4909,1630
532000.0,3,1.0,1110,0,7,1110,0,47.6857,1510
579000.0,2,1.75,1560,0,8,1560,0,47.7128,1860
1400000.0,4,2.5,3520,3,10,3140,380,47.6429,2790
571000.0,5,1.75,2280,1,8,1380,900,47.4558,1940
301950.0,3,1.75,1370,0,7,1370,0,47.4824,1500
660000.0,3,3.0,2340,0,8,2160,180,47.6868,1370
455000.0,4,2.5,3170,2,9,3170,0,47.3179,3100
375000.0,3,1.75,1380,0,7,1380,0,47.7059,1030
470000.0,4,2.5,2700,0,9,2700,0,47.3753,2880
374990.0,3,2.5,1300,0,8,1300,0,47.7768,1380
541500.0,2,2.5,1900,0,8,1900,0,47.7082,1900
782500.0,3,2.5,3750,0,9,3750,0,47.6325,3210
264000.0,3,2.25,1552,0,7,1552,0,47.3205,1677
640000.0,4,2.5,2500,0,9,2500,0,47.6251,2770
660000.0,3,2.0,1770,0,8,1770,0,47.7232,1770
1365000.0,5,3.5,4210,3,12,4210,0,47.553,4630
389950.0,3,2.5,2170,0,9,2170,0,47.385,2390
226000.0,2,1.0,1510,0,7,1510,0,47.4924,1540
390000.0,3,1.75,1870,0,7,1870,0,47.4038,1870
485000.0,3,2.25,1570,0,8,1570,0,47.6324,1990
840000.0,4,2.5,2480,0,9,2480,0,47.6835,3480
600000.0,5,3.5,3580,0,8,2140,1440,47.7646,2430
331000.0,2,1.0,1480,0,7,1080,400,47.774,1290
780000.0,3,2.0,2610,0,7,1310,1300,47.675,2330
300000.0,3,1.75,1700,0,7,1700,0,47.2623,1830
361810.0,3,1.75,1240,0,7,1240,0,47.4576,1150
467000.0,3,1.0,1660,0,7,1000,660,47.7169,1110
399000.0,3,1.75,1620,0,6,1620,0,47.5091,1880
315450.0,3,1.75,1130,0,7,1130,0,47.5254,1240
600000.0,3,1.0,1310,0,7,1310,0,47.6624,1530
247500.0,4,2.0,1710,0,7,910,800,47.3634,1560
330000.0,3,1.0,2140,0,7,2140,0,47.5494,1630
500000.0,4,2.25,2350,0,7,2350,0,47.7407,1930
367500.0,3,1.0,1570,0,7,1570,0,47.736,2540
560000.0,3,2.5,2780,0,9,2780,0,47.4798,2780
655000.0,4,1.75,2540,3,8,1320,1220,47.5709,2540
530000.0,5,2.75,2500,0,7,1250,1250,47.6225,2230
270000.0,3,2.25,2080,2,7,1380,700,47.2846,1770
437500.0,3,2.0,1760,2,7,1290,470,47.5602,1760
575000.0,3,1.75,1760,0,8,1760,0,47.6347,1970
278000.0,4,2.5,1940,0,7,1940,0,47.2911,1870
568500.0,4,2.5,3010,0,9,3010,0,47.5212,2960
280000.0,4,3.0,2460,0,8,2460,0,47.4889,1730
250000.0,2,1.0,750,0,5,750,0,47.6938,920
247500.0,3,0.75,1300,0,6,680,620,47.567,3080
1250000.0,5,2.75,3710,3,9,2340,1370,47.5686,3370
535000.0,4,2.5,2360,0,9,1920,440,47.7363,2680
814842.0,3,2.5,3190,0,9,3190,0,47.7153,3190
340000.0,4,2.5,2181,0,8,2181,0,47.3503,2333
359950.0,3,1.75,1890,0,7,1890,0,47.7676,1640
750000.0,3,1.75,2610,0,8,1680,930,47.684,1330
1220000.0,4,2.0,3090,0,8,3090,0,47.6851,1560
370000.0,2,1.0,860,0,7,860,0,47.6977,1570
329950.0,3,1.0,1000,0,7,1000,0,47.4405,1610
500000.0,3,2.5,2760,0,9,2760,0,47.465,2720
734000.0,4,2.5,3490,0,9,3490,0,47.7406,2850
385000.0,4,2.5,2960,0,9,2960,0,47.3601,2960
230000.0,2,1.0,1280,0,6,840,440,47.5532,1660
1385000.0,4,3.5,3230,1,10,1640,1590,47.6838,2660
210000.0,3,2.0,1830,0,7,1230,600,47.5145,2050
293000.0,3,1.75,1420,0,7,1420,0,47.4608,1620
465000.0,3,1.0,1580,0,6,1580,0,47.6839,1580
449000.0,3,2.25,1960,0,7,1130,830,47.7769,1970
325000.0,2,1.75,1670,0,7,1670,0,47.4893,1600
180000.0,3,2.0,1670,0,7,1670,0,47.3139,1330
650000.0,6,3.0,2960,0,8,1790,1170,47.6971,1280
665000.0,4,2.75,2420,0,7,1670,750,47.7042,1620
324450.0,3,2.0,1420,0,7,1420,0,47.478,1900
588000.0,4,1.75,2170,2,7,1370,800,47.5668,1450
200000.0,4,1.0,1310,0,6,1160,150,47.5384,1090
383000.0,4,1.75,1830,0,7,1060,770,47.7333,1990
499950.0,3,2.0,1360,0,7,730,630,47.6753,1630
549000.0,5,2.5,3440,2,9,1760,1680,47.3427,3440
465000.0,5,3.0,2010,0,7,1290,720,47.6945,1510
450000.0,3,2.5,2450,0,10,2450,0,47.3746,2650
799900.0,4,2.5,3030,0,9,1580,1450,47.689,2840
495000.0,4,2.5,2480,2,7,1470,1010,47.4579,2540
1200000.0,3,3.5,4310,2,10,3140,1170,47.7735,2280
637000.0,4,2.5,2120,0,8,2120,0,47.7159,2170
589000.0,4,1.0,2210,0,8,2210,0,47.6105,1740
305000.0,3,1.75,1400,0,7,1400,0,47.479,1780
600000.0,4,2.25,2760,0,7,1790,970,47.589,1310
587000.0,4,2.5,2550,0,9,2550,0,47.7742,2460
1425000.0,2,2.5,2220,0,9,2220,0,47.6364,1870
250000.0,4,1.0,1320,0,6,1320,0,47.3098,1060
515000.0,3,3.0,2440,0,8,1640,800,47.7152,2440
833000.0,4,2.75,3780,0,10,3780,0,47.589,3500
860000.0,3,3.25,4720,2,10,3190,1530,47.508,3260
550000.0,4,3.0,2360,0,8,1760,600,47.6919,1640
180000.0,2,1.0,890,0,6,890,0,47.4976,1100
507000.0,4,1.75,1770,0,7,1170,600,47.6935,1540
427000.0,3,2.0,1720,0,7,1720,0,47.4487,2360
616950.0,3,3.5,2490,0,8,2020,470,47.5893,2490
372000.0,4,1.75,1890,0,7,1010,880,47.5147,1930
290000.0,2,1.0,1020,0,7,1020,0,47.6971,1380
329990.0,4,2.75,2420,0,8,2420,0,47.2089,2270
393500.0,3,1.75,1600,0,7,1600,0,47.7397,1200
1550000.0,5,3.25,3370,2,10,2000,1370,47.5591,4240
240000.0,4,2.25,1720,0,8,1720,0,47.3192,2010
285000.0,3,1.0,1090,0,6,1090,0,47.459,1260
382500.0,3,1.5,1090,0,8,1090,0,47.6256,1710
1925000.0,4,3.75,3600,0,9,3600,0,47.6308,3650
800000.0,3,2.5,2760,2,8,1760,1000,47.676,3040
550000.0,4,3.5,2770,0,8,2770,0,47.6585,1720
387846.0,4,1.75,2520,0,7,2040,480,47.7642,1680
367500.0,4,2.0,1960,0,7,1960,0,47.33,1960
780500.0,5,1.0,1760,0,8,1760,0,47.6246,2130
680000.0,3,1.75,1090,0,7,850,240,47.6934,1580
434400.0,5,1.75,1960,0,7,1960,0,47.7256,1800
370000.0,2,1.0,1220,0,6,1220,0,47.6934,1510
465000.0,3,1.75,1730,0,8,1350,380,47.7694,2500
323000.0,3,2.0,1830,0,8,1830,0,47.4445,2010
270000.0,4,2.5,1600,0,7,1600,0,47.3678,2140
1320000.0,3,1.75,2040,2,10,2040,0,47.6479,2640
560000.0,4,2.5,2710,0,9,2710,0,47.4922,2710
450000.0,3,1.0,1140,0,6,840,300,47.5897,1150
290000.0,2,1.0,930,0,6,930,0,47.7091,1250
354000.0,3,2.0,1010,0,8,1010,0,47.6223,1700
705000.0,5,3.0,2380,0,7,2380,0,47.6722,1800
445000.0,3,2.25,1860,0,7,1240,620,47.7332,1560
229900.0,3,1.0,1440,0,7,1440,0,47.2738,1440
610000.0,4,2.5,2980,0,8,2980,0,47.6872,2900
535000.0,3,3.25,2670,2,9,2670,0,47.5342,2670
437400.0,3,1.75,2150,0,7,2150,0,47.6253,1100
540000.0,5,2.75,3160,0,10,1740,1420,47.7477,3120
570000.0,3,2.0,1890,0,7,1470,420,47.5621,2580
533000.0,3,2.5,2810,0,8,2810,0,47.7735,2540
555000.0,3,2.5,2690,0,7,2690,0,47.5302,2360
239950.0,3,1.75,1230,0,7,1230,0,47.3675,1330
350000.0,3,1.0,950,0,7,950,0,47.7308,1480
245000.0,2,1.0,1200,0,6,980,220,47.5276,1040
456000.0,4,1.75,1670,0,7,1670,0,47.7249,2590
465000.0,4,2.25,2140,0,7,1470,670,47.7213,2130
445000.0,2,1.75,1440,2,8,1440,0,47.7092,1680
517850.0,5,2.75,3050,0,8,1800,1250,47.7249,2060
329000.0,5,2.75,2570,0,8,2570,0,47.2622,2200
512500.0,3,2.5,1840,0,7,1840,0,47.562,1240
365000.0,2,1.0,1250,0,7,1250,0,47.7294,1710
450500.0,3,1.0,1410,0,7,1410,0,47.7161,1990
915000.0,3,1.0,1560,0,7,1560,0,47.623,1930
205000.0,3,1.0,960,0,6,960,0,47.2891,990
314000.0,4,2.5,1870,0,8,1870,0,47.4435,2160
496000.0,2,1.0,900,0,7,900,0,47.6695,1230
329950.0,4,1.0,2050,0,7,1280,770,47.4916,2050
375000.0,4,2.0,2400,0,6,2400,0,47.7607,1780
623000.0,3,2.5,1850,0,8,1850,0,47.6908,1850
310000.0,4,1.5,1220,0,6,1220,0,47.6462,1180
532500.0,3,3.25,3140,0,9,1760,1380,47.5244,2100
960000.0,4,2.25,2410,2,9,1800,610,47.6796,2150
598000.0,4,2.5,3130,0,9,3130,0,47.4761,2760
683000.0,3,2.5,2300,2,9,2300,0,47.5504,2730
425000.0,5,2.5,2840,0,7,1590,1250,47.7609,1900
533000.0,5,2.75,1800,0,7,1400,400,47.6831,1400
375000.0,3,1.0,1190,0,7,1190,0,47.4319,2100
250500.0,3,2.0,1710,0,7,1710,0,47.2917,1710
257000.0,4,1.75,1900,0,7,1360,540,47.3102,1300
218000.0,3,1.0,880,0,6,880,0,47.5013,1110
460000.0,3,2.0,2060,0,7,1030,1030,47.5705,1750
255544.0,3,1.0,1360,0,6,760,600,47.7503,1610
560000.0,2,2.0,1680,0,8,1680,0,47.7088,1680
480000.0,4,2.5,2980,0,8,2980,0,47.734,2320
1300000.0,5,1.75,2130,0,8,1500,630,47.638,3650
580000.0,3,2.75,2650,0,9,2650,0,47.768,3030
475000.0,3,2.5,1700,0,8,1160,540,47.5369,1590
1309500.0,4,2.5,2680,4,9,1590,1090,47.4396,2960
700000.0,3,2.5,2530,0,8,2530,0,47.4188,2120
590000.0,3,2.5,2520,0,10,2520,0,47.631,2630
264500.0,3,2.5,1630,0,8,1630,0,47.2622,2110
465000.0,2,1.0,730,0,6,730,0,47.6751,1480
290000.0,3,1.0,910,2,7,910,0,47.5278,1660
1815000.0,4,4.5,4510,2,12,4510,0,47.6491,2200
416000.0,3,1.0,1110,0,7,1110,0,47.6034,1490
360000.0,4,2.0,1450,0,7,1450,0,47.7304,1310
585083.0,5,2.75,2910,0,8,1590,1320,47.5916,2910
840000.0,4,2.75,2600,0,7,1620,980,47.6413,1960
81000.0,2,1.0,730,0,5,730,0,47.4808,860
1285000.0,3,2.25,2440,1,8,2440,0,47.6629,2750
326000.0,4,1.75,2290,0,7,1390,900,47.5034,1170
447000.0,2,1.0,720,2,6,720,0,47.5185,1390
185000.0,3,1.0,940,0,7,940,0,47.3756,1170
439950.0,3,2.5,1540,0,8,1540,0,47.722,1630
234000.0,3,1.5,1140,0,6,1140,0,47.4452,1250
485000.0,4,2.5,2100,0,7,2100,0,47.5947,1840
750000.0,4,1.75,2670,0,8,2020,650,47.6499,1820
865000.0,4,2.0,2750,0,8,2130,620,47.6513,1290
287500.0,4,2.5,2570,0,8,1590,980,47.2986,2120
375000.0,3,1.75,1660,0,7,1130,530,47.7628,1260
565000.0,3,2.25,1700,0,7,850,850,47.6863,2180
260000.0,4,3.0,1530,0,7,1530,0,47.3528,1930
190000.0,3,1.0,1260,0,6,1260,0,47.491,1090
399950.0,5,2.0,2760,0,7,1380,1380,47.5396,1400
275000.0,3,2.5,1830,0,7,1830,0,47.2895,1820
528000.0,3,2.75,2160,0,7,1380,780,47.5352,1300
315000.0,3,2.0,1770,0,5,1770,0,47.4753,1520
614306.0,2,2.25,2210,0,8,1410,800,47.697,2140
1490000.0,3,3.5,4560,2,12,4560,0,47.6995,4050
590000.0,3,2.5,2110,0,9,2110,0,47.5513,2300
261500.0,3,1.0,1130,0,6,1130,0,47.5978,1710
300000.0,4,2.5,1960,0,8,1960,0,47.3834,2130
439000.0,3,2.25,2230,2,8,1450,780,47.5078,2060
277554.0,5,2.25,2350,0,7,2350,0,47.4939,1570
215000.0,3,2.0,1340,0,6,1340,0,47.4727,1370
1200000.0,2,2.25,2160,4,9,2160,0,47.502,2660
420000.0,4,2.0,1700,0,7,850,850,47.6973,1470
485000.0,3,2.5,1650,0,7,1650,0,47.6819,1680
202500.0,3,2.0,1540,0,6,1540,0,47.323,1250
710000.0,5,3.25,3920,0,9,3920,0,47.5427,3335
535000.0,4,2.5,3250,0,8,3250,0,47.4956,3030
260000.0,4,1.75,1360,0,7,1360,0,47.4558,1321
254000.0,3,2.0,1480,0,7,1480,0,47.3542,1680
600000.0,4,2.5,2360,0,8,2360,0,47.712,2440
285000.0,3,2.5,1800,0,7,1800,0,47.5401,1800
800000.0,4,3.75,2540,0,10,2540,0,47.5882,2490
165000.0,3,1.0,1200,0,6,1200,0,47.475,1960
216500.0,2,1.0,710,0,6,710,0,47.4886,940
387990.0,4,2.5,2640,0,8,2640,0,47.3551,1840
500000.0,4,2.5,3010,0,8,3010,0,47.709,1090
650000.0,4,2.5,2770,0,7,2770,0,47.686,2770
646000.0,4,2.5,2310,0,8,2310,0,47.6937,1220
323400.0,4,3.0,2060,0,8,1430,630,47.321,2250
300000.0,3,2.5,1880,0,7,1880,0,47.366,2090
712500.0,5,2.0,2280,0,7,1340,940,47.6674,1770
550000.0,3,1.75,1380,0,7,1380,0,47.6109,1500
400000.0,3,1.0,1180,0,7,1180,0,47.7233,1220
255000.0,4,1.75,1650,0,7,1100,550,47.3944,1620
660000.0,3,1.75,2030,2,7,2030,0,47.586,2350
925000.0,4,2.25,2110,2,8,1600,510,47.6819,2760
534000.0,4,2.25,2130,0,7,1330,800,47.629,1310
215000.0,3,1.0,1690,0,7,1690,0,47.3444,1590
1950000.0,3,2.5,2510,4,10,2510,0,47.6982,2810
1400000.0,5,4.25,3530,0,10,3530,0,47.5894,1750
212000.0,3,1.75,1470,0,7,1470,0,47.2587,1590
265000.0,3,1.75,1840,0,8,1840,0,47.3122,1920
400000.0,3,1.75,1860,0,6,1300,560,47.5586,1550
311500.0,4,2.5,1940,0,8,1940,0,47.3877,1940
2328000.0,4,3.5,4420,0,11,4420,0,47.6354,3020
225000.0,2,1.0,800,0,6,800,0,47.5001,880
1250000.0,4,2.5,3700,4,11,2620,1080,47.5662,3480
380000.0,3,1.0,1400,0,7,1400,0,47.5066,1460
600000.0,4,2.5,2250,0,8,2250,0,47.7115,2190
600000.0,3,2.25,2230,0,9,2230,0,47.6594,2390
315000.0,3,2.5,1950,0,7,1950,0,47.4938,1620
847000.0,5,1.0,2550,0,9,2550,0,47.6092,1570
730000.0,4,2.5,2750,0,10,2750,0,47.5894,3370
1058000.0,4,2.0,2290,0,8,2290,0,47.5887,2300
1620000.0,4,2.25,2350,0,9,2350,0,47.6232,3360
664000.0,2,1.75,1720,0,6,860,860,47.5554,1680
454450.0,4,3.0,2810,0,9,2810,0,47.3689,2790
341000.0,3,1.0,940,0,7,940,0,47.6878,1380
276693.0,4,1.0,1190,0,7,1190,0,47.7487,1190
185000.0,2,1.0,1390,0,7,1390,0,47.4969,1200
160000.0,2,2.5,1660,0,7,1660,0,47.3793,1740
270000.0,4,2.5,1920,0,8,1920,0,47.2608,1940
300000.0,4,1.5,1460,0,7,1460,0,47.4698,1610
264950.0,3,1.5,1370,0,7,1370,0,47.2027,1450
209950.0,2,1.0,1050,0,6,840,210,47.5024,1310
850000.0,3,2.5,3360,0,9,3360,0,47.7037,1810
645000.0,4,2.5,3160,0,9,3160,0,47.6318,2970
855000.0,4,2.25,2480,0,9,2480,0,47.6441,3160
632500.0,4,1.5,2720,0,10,2720,0,47.7402,3270
289950.0,3,2.5,2070,0,8,2070,0,47.3202,1670
850000.0,2,1.75,2170,2,8,2170,0,47.7542,3020
565000.0,4,2.75,3260,0,9,3260,0,47.4812,3260
792000.0,3,2.5,2250,0,8,2250,0,47.6569,2940
260000.0,3,2.25,1950,0,7,1200,750,47.2762,1760
585000.0,3,2.0,2220,0,7,2220,0,47.7586,1600
295500.0,3,1.75,1330,0,7,1000,330,47.4605,1320
329000.0,4,2.0,1190,0,7,1190,0,47.7538,1480
750000.0,3,1.75,2770,0,8,1570,1200,47.5706,2340
495000.0,4,2.5,2310,0,9,2310,0,47.7544,1980
672500.0,3,1.75,1580,2,8,1330,250,47.6339,2480
1307000.0,5,3.25,2800,0,10,1910,890,47.6421,2450
405000.0,3,2.5,1500,0,7,1500,0,47.75,1700
620000.0,3,1.75,2140,1,7,1070,1070,47.6435,1930
615000.0,4,2.25,2330,0,8,1450,880,47.562,2330
887000.0,6,2.25,3830,2,9,2440,1390,47.5849,2500
1057000.0,4,2.75,4510,2,8,3270,1240,47.6852,2010
753000.0,4,1.75,2160,0,8,1660,500,47.6378,2430
1600000.0,3,2.25,3170,0,10,2230,940,47.6349,3170
3710000.0,4,3.5,5550,2,12,3350,2200,47.6395,2980
365000.0,3,1.5,1520,0,7,1520,0,47.7712,1570
870000.0,4,2.75,3410,0,10,3410,0,47.5559,2490
321000.0,4,2.5,1830,0,7,1830,0,47.3541,1830
280000.0,3,2.5,1550,0,7,1550,0,47.3299,1700
288000.0,3,2.5,1520,0,7,1520,0,47.3842,1610
248500.0,3,2.0,1240,0,7,620,620,47.3219,1560
330000.0,4,2.5,2380,0,7,2380,0,47.4486,1230
740000.0,5,3.5,2720,0,9,1830,890,47.6466,2920
445000.0,3,2.5,2210,0,8,2210,0,47.4845,2430
198500.0,2,1.0,1050,0,6,1050,0,47.3274,990
280000.0,7,2.5,1940,0,7,1940,0,47.3191,1710
336500.0,3,2.25,1420,0,7,1420,0,47.7245,1150
267000.0,3,2.5,1690,0,7,1690,0,47.311,1580
315000.0,3,1.0,1160,0,7,1160,0,47.7427,1160
545000.0,4,2.5,2040,0,8,2040,0,47.6347,2050
274950.0,3,1.75,1840,0,8,1840,0,47.3207,1910
500000.0,2,1.0,1440,2,7,1210,230,47.6778,1970
299000.0,3,1.0,1390,0,7,1390,0,47.7758,1440
420000.0,3,2.5,1470,0,8,1160,310,47.5468,1470
620000.0,3,2.5,1776,0,8,1604,172,47.6539,1780
575950.0,3,2.25,1640,0,7,1180,460,47.6252,1620
666500.0,4,2.5,2860,0,9,2860,0,47.6067,2790
180000.0,4,1.5,1740,0,7,1020,720,47.4787,1740
261350.0,3,1.75,1390,0,7,1390,0,47.3208,1810
1030000.0,4,3.5,2730,0,9,1660,1070,47.6387,1720
390000.0,3,1.75,1435,0,8,1435,0,47.4525,2030
253500.0,3,1.0,1640,0,7,1090,550,47.3256,1550
625000.0,4,2.5,2630,0,8,2630,0,47.775,2680
255000.0,4,2.5,1580,0,7,1580,0,47.481,1320
257000.0,3,2.5,1740,0,8,1740,0,47.3363,2030
869000.0,2,1.75,1900,4,7,1100,800,47.5121,1650
745000.0,4,2.5,3130,0,10,3130,0,47.56,3130
1350000.0,4,3.5,3500,0,10,3500,0,47.5641,2630
350000.0,3,1.75,2130,0,7,1090,1040,47.4593,1590
475000.0,3,2.5,950,0,8,950,0,47.6226,1230
540000.0,3,2.5,1720,0,8,1720,0,47.6791,1890
175000.0,2,1.0,830,0,7,830,0,47.3839,1030
100000.0,2,0.75,660,0,4,660,0,47.3881,850
890000.0,5,1.0,2590,0,8,2310,280,47.6038,2360
280000.0,3,2.5,1600,0,7,1600,0,47.3303,1700
1050000.0,4,4.25,4390,3,10,3320,1070,47.5566,3850
486000.0,4,2.5,3560,0,10,3560,0,47.3019,3420
670000.0,5,2.5,2860,0,8,2860,0,47.5265,1670
480000.0,3,2.5,1640,0,8,1640,0,47.5684,1870
440000.0,3,1.75,1500,0,6,1060,440,47.5689,1740
1500000.0,3,3.25,3990,2,9,2870,1120,47.5744,3640
743700.0,4,2.5,2610,0,10,2610,0,47.6662,2870
449950.0,3,1.75,1470,0,7,1470,0,47.6964,1700
367000.0,2,1.0,700,0,7,700,0,47.701,2300
1185000.0,4,3.25,3960,0,11,3960,0,47.5211,3870
201000.0,3,1.0,900,0,6,900,0,47.2881,1220
575000.0,3,1.75,2010,0,7,2010,0,47.6408,1540
295000.0,3,2.5,1940,0,7,1420,520,47.3385,1810
190000.0,3,1.0,1510,0,6,1510,0,47.3015,1040
742500.0,2,3.0,2020,0,8,1350,670,47.6758,1160
875000.0,6,3.5,4430,0,9,3000,1430,47.5156,2730
1387000.0,4,3.5,4010,3,11,3150,860,47.5359,3530
600000.0,4,2.25,3070,0,8,3070,0,47.7316,1880
207000.0,3,1.5,1460,0,7,1460,0,47.3253,1460
650000.0,4,2.75,3260,0,9,3260,0,47.5414,3180
275000.0,2,1.0,830,0,6,830,0,47.5674,1310
1200000.0,4,2.5,2390,0,9,2150,240,47.6272,2800
262500.0,3,2.0,1130,0,6,1130,0,47.4779,1270
399000.0,2,1.0,1120,0,7,1120,0,47.7034,1470
139000.0,4,1.5,1410,0,7,1410,0,47.3736,1410
575000.0,3,2.5,1750,0,7,1750,0,47.6954,1750
580000.0,2,1.0,1040,0,7,1040,0,47.6558,1890
468000.0,3,2.25,1630,0,7,1630,0,47.6807,1630
230000.0,3,1.0,1380,0,7,940,440,47.3196,1240
675000.0,4,4.0,3680,0,10,3680,0,47.6193,3200
318000.0,3,1.0,1250,0,7,1250,0,47.7514,1640
332100.0,5,3.5,2660,0,8,1980,680,47.2631,2220
175000.0,2,1.0,620,0,6,620,0,47.4862,1050
817000.0,4,2.25,2600,0,8,2600,0,47.5533,3150
1200000.0,4,3.0,2150,0,8,2150,0,47.6335,1590
525000.0,3,1.75,1470,2,7,1070,400,47.5463,1440
189000.0,3,1.0,1380,0,6,1380,0,47.3006,860
629950.0,3,2.5,1680,0,9,1120,560,47.6425,1610
641500.0,1,1.0,1000,3,7,1000,0,47.5007,1090
490000.0,3,2.25,1630,2,7,1230,400,47.7273,1550
415000.0,3,1.75,1790,0,7,1360,430,47.7362,1910
250000.0,2,1.0,890,0,6,890,0,47.691,990
781000.0,3,1.5,1290,0,7,820,470,47.6296,2130
400000.0,4,2.25,2420,0,7,1400,1020,47.7583,2120
935000.0,4,3.0,3680,2,10,2890,790,47.6956,1580
575000.0,4,2.5,3020,0,9,1600,1420,47.7735,2500
1660000.0,4,3.25,4240,2,10,4240,0,47.6526,3390
302300.0,5,2.75,3130,0,8,1580,1550,47.3099,1900
355000.0,2,1.0,900,0,7,900,0,47.5467,1230
1538000.0,3,2.25,2880,2,9,1710,1170,47.6938,2920
926250.0,4,1.75,2390,0,8,2390,0,47.5755,2390
300000.0,3,1.75,1450,0,7,1050,400,47.4569,1380
361500.0,3,1.75,1070,0,7,1070,0,47.6984,1700
616000.0,3,1.5,1740,0,8,1740,0,47.5748,1930
395000.0,2,1.75,1210,0,8,1210,0,47.5513,1700
245000.0,3,1.5,2100,0,7,2100,0,47.4222,1300
206000.0,3,1.0,1060,0,6,1060,0,47.2878,1060
706000.0,4,2.5,3280,0,9,2190,1090,47.426,1570
578000.0,3,1.5,1660,0,7,1660,0,47.6409,1640
341950.0,5,3.0,3070,0,8,3070,0,47.3666,2760
305000.0,3,1.0,1150,0,7,1150,0,47.6755,1550
575000.0,3,2.75,1710,0,7,1590,120,47.642,1710
330000.0,3,1.0,1180,0,6,1180,0,47.5278,1410
445000.0,4,2.25,2130,0,7,2130,0,47.7152,1990
333000.0,3,1.0,1050,0,7,1050,0,47.525,1490
598500.0,4,2.5,2520,0,8,2520,0,47.5401,2610
225000.0,2,1.0,700,0,6,700,0,47.4671,1320
570000.0,4,2.5,2640,0,8,2640,0,47.6038,2460
630000.0,5,2.0,2330,0,7,1310,1020,47.6955,1930
779000.0,5,2.25,2830,0,8,2830,0,47.5582,2300
760000.0,4,3.5,3720,3,10,3720,0,47.536,4210
322968.0,5,1.75,1890,0,7,1890,0,47.7391,2350
595000.0,4,2.5,2910,0,8,2910,0,47.5354,2420
321000.0,4,1.0,1300,0,7,1300,0,47.5029,1540
653000.0,3,2.25,2770,0,8,2770,0,47.775,2720
750000.0,4,1.75,2520,4,8,1420,1100,47.4996,1700
530000.0,3,1.0,1340,0,7,1080,260,47.6633,1960
352750.0,2,1.75,1060,0,7,960,100,47.5999,1170
424950.0,4,2.5,2480,0,8,2480,0,47.381,2460
427000.0,5,2.75,2220,0,7,1230,990,47.5754,1580
558000.0,4,2.5,3220,0,9,2420,800,47.5434,1770
438200.0,2,2.0,1600,0,7,1600,0,47.6968,1600
340000.0,1,1.0,640,0,6,640,0,47.5551,1250
830005.0,4,3.75,3610,0,11,3290,320,47.6992,2460
548000.0,4,3.25,3420,0,10,2330,1090,47.732,2320
411715.0,3,1.75,1840,0,7,1040,800,47.5585,1340
865000.0,4,4.0,2790,0,9,2790,0,47.6033,2740
1750000.0,6,4.25,5860,3,10,4150,1710,47.5382,5790
688000.0,3,3.0,3450,0,10,3450,0,47.6319,3130
399950.0,4,2.5,2350,0,8,2350,0,47.3507,2190
555000.0,3,1.0,1250,0,6,970,280,47.6757,1830
677000.0,3,2.0,2000,0,7,1100,900,47.6561,1460
539000.0,3,2.0,2260,0,8,1780,480,47.6457,2250
410000.0,3,1.75,1510,0,6,950,560,47.5938,1460
472000.0,2,2.25,1800,0,9,1800,0,47.6104,1800
755000.0,3,2.5,2420,3,9,1620,800,47.5405,2650
269900.0,5,1.75,1750,0,7,1750,0,47.4007,1430
667400.0,4,2.5,2660,0,8,2660,0,47.7532,2650
1220000.0,3,2.25,2640,0,10,2640,0,47.6224,2650
544000.0,3,2.5,1460,0,8,1180,280,47.6781,1460
800000.0,2,1.0,1570,3,8,1570,0,47.5955,1760
315000.0,3,1.0,1010,0,7,1010,0,47.6172,1250
227000.0,4,1.0,1200,0,6,1200,0,47.4951,1070
765000.0,4,2.5,4040,0,10,4040,0,47.4579,3230
625000.0,3,3.0,1820,0,8,1540,280,47.6482,1720
1875000.0,4,5.0,5810,0,10,3790,2020,47.6878,3010
822600.0,4,2.5,3010,2,9,1510,1500,47.5519,2780
515000.0,4,2.5,1910,0,8,1160,750,47.7374,1920
377000.0,4,2.0,1640,0,7,930,710,47.5545,1600
600000.0,3,1.0,1480,1,8,1480,0,47.5179,2250
525300.0,4,1.75,2520,0,8,1680,840,47.7721,2340
760000.0,4,3.0,2840,2,9,1990,850,47.7153,2840
202000.0,2,1.0,840,0,5,840,0,47.3769,1030
470000.0,3,2.0,1730,0,8,1730,0,47.4164,2130
810000.0,3,2.5,3140,0,10,3140,0,47.5595,3140
175000.0,3,1.0,1480,0,7,1080,400,47.4585,1780
440000.0,4,1.75,1920,0,7,960,960,47.7209,1700
197000.0,2,1.0,770,0,6,770,0,47.5075,1110
254000.0,3,1.0,1010,2,6,1010,0,47.4905,1010
405000.0,3,1.0,1460,0,7,1460,0,47.6214,1910
416000.0,2,1.0,940,0,7,940,0,47.5314,1630
779950.0,4,2.75,2840,0,9,2840,0,47.7103,2990
200000.0,4,2.75,1910,0,7,1430,480,47.3693,1750
658100.0,4,2.5,2430,0,9,2430,0,47.5714,2760
397000.0,2,1.75,1610,0,7,950,660,47.5565,1510
815000.0,3,3.75,2780,0,10,2780,0,47.5939,3110
345000.0,2,1.0,1160,0,7,1160,0,47.7364,1320
305500.0,4,2.5,1850,0,7,1850,0,47.4031,1940
340000.0,3,2.25,2120,0,8,2120,0,47.296,1400
330000.0,5,2.5,2620,0,7,1400,1220,47.72,2390
269000.0,4,2.5,2060,0,7,2060,0,47.362,2060
349950.0,3,1.0,1060,0,7,1060,0,47.6855,1630
431000.0,3,1.0,1500,0,7,1500,0,47.7281,1230
735000.0,4,1.75,2380,1,7,1820,560,47.6656,2190
414000.0,5,3.0,3045,0,8,3045,0,47.4386,3045
619500.0,3,2.5,1700,0,8,1700,0,47.6078,1880
675000.0,3,1.75,1240,0,7,1240,0,47.6919,1970
380500.0,3,1.0,1410,0,7,1410,0,47.7303,1460
253000.0,3,1.5,880,0,6,880,0,47.5002,1020
157500.0,2,1.0,740,0,5,740,0,47.4217,1230
627000.0,4,2.0,2030,0,8,2030,0,47.6658,1800
469500.0,4,2.5,2090,0,7,1140,950,47.726,1510
319950.0,2,1.0,920,0,7,920,0,47.5015,2330
249500.0,3,1.0,1180,0,7,1180,0,47.4249,1180
485000.0,3,1.0,1260,0,7,1260,0,47.644,1700
1125000.0,5,3.0,3690,4,9,2070,1620,47.5919,3160
314500.0,3,1.75,1700,0,7,1200,500,47.3637,1900
220000.0,2,1.0,770,0,6,770,0,47.7467,880
444950.0,3,2.5,2020,0,7,1330,690,47.7368,1870
598000.0,4,2.5,2030,0,8,1330,700,47.6892,2180
699850.0,4,3.5,2690,0,9,2690,0,47.599,2910
595000.0,3,2.5,1750,0,7,1750,0,47.6953,1750
735000.0,4,2.5,3270,0,9,3270,0,47.6303,2670
542500.0,4,2.5,2330,0,8,2330,0,47.5916,2210
450000.0,3,1.75,1720,0,7,1140,580,47.6972,1720
298500.0,3,2.0,2420,0,7,1420,1000,47.4322,1546
403950.0,2,1.0,710,0,7,710,0,47.6414,1370
271000.0,2,1.0,710,0,6,710,0,47.5226,850
335000.0,2,1.0,1510,0,7,1510,0,47.7038,1170
305000.0,2,2.25,1610,0,7,1610,0,47.5184,1950
630000.0,3,3.0,1880,0,8,1520,360,47.6666,1500
253000.0,2,1.75,1220,0,7,860,360,47.4906,1120
395000.0,4,1.75,2060,0,7,1070,990,47.6028,1830
265000.0,3,2.5,1340,0,7,1140,200,47.3553,1760
225000.0,2,1.0,1030,0,6,1030,0,47.4565,1030
338500.0,4,2.5,2717,0,8,2717,0,47.3373,2550
300000.0,2,1.75,1360,0,7,860,500,47.7295,1830
255000.0,2,1.0,1260,0,6,1260,0,47.5003,1260
337000.0,4,3.0,2240,0,7,2240,0,47.7348,1570
324900.0,3,2.25,2080,0,8,2080,0,47.261,2080
821000.0,3,2.75,2760,0,8,1690,1070,47.5402,2610
500000.0,4,2.75,3000,0,8,3000,0,47.4032,2300
885000.0,4,3.5,3310,2,8,2200,1110,47.5511,1420
360000.0,4,2.0,1630,0,7,1630,0,47.7566,1360
304000.0,3,1.0,900,0,7,900,0,47.7314,1960
376000.0,2,1.0,880,0,6,760,120,47.5643,1180
425000.0,4,1.5,1620,0,7,1620,0,47.6041,1890
1180500.0,3,1.75,1610,0,8,1090,520,47.6279,3790
187000.0,3,2.5,1730,0,7,1730,0,47.4648,1190
710000.0,2,1.5,1640,0,7,1540,100,47.6624,1880
585000.0,3,1.75,1840,0,8,1370,470,47.6729,1920
1400000.0,5,4.0,4700,0,11,4700,0,47.5417,4730
1980000.0,4,3.5,4500,0,12,3340,1160,47.6323,2540
250000.0,3,1.75,1780,0,8,1420,360,47.2949,1950
950000.0,4,2.75,3800,3,10,3800,0,47.5689,3710
725000.0,3,2.5,2980,0,10,2980,0,47.595,2980
505000.0,4,2.5,2780,0,8,1590,1190,47.7284,2170
90000.0,1,1.0,560,0,4,560,0,47.5335,980
400000.0,4,2.0,2060,0,7,2060,0,47.5631,1630
407000.0,3,1.0,1140,0,8,1140,0,47.709,2080
651000.0,3,1.5,1890,0,7,1890,0,47.6662,1620
485000.0,3,2.25,2090,0,7,1350,740,47.7598,1740
460000.0,4,2.75,3460,0,8,3460,0,47.2046,1500
369000.0,2,1.0,1320,0,7,880,440,47.5265,1050
355000.0,2,1.0,1240,1,6,1000,240,47.5026,2140
155000.0,2,1.0,810,0,7,810,0,47.5313,1180
1000000.0,3,1.0,1880,0,8,1880,0,47.6453,2580
419625.0,4,2.5,2680,0,9,2680,0,47.4395,2580
435000.0,3,2.0,2040,0,7,2040,0,47.7601,1710
379000.0,4,1.75,2180,0,7,1290,890,47.5157,1960
293000.0,4,2.25,1870,0,7,1870,0,47.3844,2380
592100.0,4,2.75,2310,0,8,1790,520,47.5473,2230
362000.0,3,1.75,1120,0,7,1120,0,47.7372,2530
227000.0,3,1.0,1340,0,7,1340,0,47.4916,2090
335500.0,3,1.75,1260,0,7,1260,0,47.7664,1890
213000.0,3,1.75,1200,0,7,1200,0,47.3492,1910
338000.0,5,2.5,2400,0,7,2400,0,47.3692,1880
163500.0,3,1.0,940,0,7,940,0,47.2979,1090
199988.0,2,1.0,860,0,7,860,0,47.5005,1130
1185000.0,3,2.25,2390,1,10,1980,410,47.6515,3720
320000.0,4,2.5,3130,0,7,3130,0,47.3828,3020
450000.0,6,2.25,3550,0,8,2960,590,47.7218,2360
249900.0,2,2.0,1470,0,6,1470,0,47.3502,1310
223000.0,2,1.0,910,0,6,910,0,47.4572,1480
631000.0,4,4.0,2630,0,7,1470,1160,47.4496,2230
350000.0,4,2.25,1780,0,7,1060,720,47.4414,1780
279000.0,3,1.75,1430,0,7,900,530,47.5513,1430
310000.0,5,2.0,2730,0,7,1510,1220,47.4602,1730
185000.0,2,1.0,900,0,6,900,0,47.4217,1240
445000.0,3,2.5,1740,0,8,1130,610,47.3948,2000
365000.0,4,2.5,2905,0,9,2905,0,47.4084,2900
333500.0,3,1.5,2230,0,7,1390,840,47.5008,1420
385000.0,3,2.25,1680,0,8,1340,340,47.7575,1850
345000.0,3,1.5,1240,0,7,1240,0,47.5716,1240
1260000.0,3,3.0,3230,3,10,2220,1010,47.562,2330
440000.0,4,2.5,2560,0,7,1280,1280,47.5225,1740
444500.0,3,2.5,2600,0,7,2600,0,47.5359,2400
340000.0,4,1.0,1200,3,6,1200,0,47.4557,1670
680000.0,4,1.0,1660,0,7,1660,0,47.6755,1810
420000.0,3,1.75,1140,0,7,1140,0,47.7027,1490
438500.0,3,2.25,3050,0,9,3050,0,47.3326,2697
109500.0,2,1.0,800,0,6,800,0,47.496,1130
461000.0,4,2.75,1700,0,7,1200,500,47.7589,1650
968000.0,4,1.75,2630,0,9,2630,0,47.5459,2690
355000.0,3,1.75,1960,0,7,980,980,47.53,1380
249000.0,3,1.5,1180,0,7,1180,0,47.4502,1780
256500.0,5,2.5,1960,0,7,1360,600,47.4368,1900
1810000.0,5,2.5,4250,1,11,2490,1760,47.6377,3620
269000.0,3,2.25,1950,0,8,1950,0,47.3127,1950
1350000.0,4,3.5,3600,0,9,2720,880,47.6189,2270
885000.0,3,2.25,2060,0,9,1610,450,47.5402,2930
455000.0,3,2.0,1640,0,7,1090,550,47.7244,1500
980000.0,4,2.5,2730,0,8,2230,500,47.642,2190
412500.0,3,1.75,1530,0,6,1530,0,47.516,920
740000.0,4,3.5,3060,0,9,3060,0,47.555,3060
1298000.0,4,2.25,2860,3,10,2130,730,47.6395,2700
326000.0,2,1.5,1030,0,8,1030,0,47.6975,1020
568500.0,4,2.5,2460,0,8,2460,0,47.6041,2460
620000.0,4,2.5,2500,0,9,2500,0,47.5127,2500
283000.0,3,1.75,1830,0,7,1490,340,47.5317,1300
875000.0,6,3.25,2820,0,8,1930,890,47.6688,2820
1310000.0,4,2.25,3750,0,8,2440,1310,47.6747,2170
289950.0,3,2.5,2070,0,7,2070,0,47.3357,2070
252500.0,3,2.5,1780,0,7,1250,530,47.4093,1870
376000.0,4,2.25,2200,0,8,1480,720,47.5215,2710
635700.0,4,2.5,3240,0,9,1860,1380,47.6298,3150
710000.0,4,2.5,2880,0,10,2880,0,47.5879,3490
440000.0,3,1.75,1570,2,7,980,590,47.7166,2420
439000.0,3,2.5,3180,0,8,1810,1370,47.489,1950
455000.0,2,1.5,1310,0,6,1310,0,47.6487,2970
225000.0,2,1.0,910,0,7,910,0,47.4297,1410
250000.0,3,1.0,1460,0,7,1460,0,47.4511,1490
585000.0,4,3.25,3410,0,9,2470,940,47.459,2450
685000.0,3,1.75,2720,0,7,1580,1140,47.6691,1660
420000.0,5,2.75,2280,0,8,1300,980,47.7566,2370
245000.0,2,1.0,670,0,6,670,0,47.5918,1220
275000.0,4,2.0,1480,0,7,1480,0,47.4312,1450
270000.0,3,2.0,2330,0,7,1390,940,47.2958,1570
767250.0,4,3.0,2170,0,8,1710,460,47.6742,2170
229000.0,3,2.0,1760,0,7,1760,0,47.4783,1190
400000.0,3,1.0,1240,0,8,1240,0,47.5467,1200
2195000.0,5,3.25,5210,4,10,4940,270,47.5463,2590
665000.0,5,2.0,2800,0,8,1400,1400,47.6719,1760
500000.0,4,2.25,2060,0,7,2060,0,47.744,2160
355500.0,5,2.0,2360,0,7,2360,0,47.3299,1860
369000.0,4,2.5,2370,0,9,2370,0,47.423,2370
338500.0,2,1.0,720,0,5,720,0,47.7259,1480
256000.0,3,1.0,950,0,7,780,170,47.5232,1230
470000.0,3,2.5,1980,0,8,1980,0,47.4856,2070
675000.0,3,2.5,2540,1,9,2540,0,47.7175,2490
369950.0,4,2.75,2760,0,8,1400,1360,47.371,2340
615000.0,5,3.5,2950,3,9,2350,600,47.5339,2950
1200690.0,5,3.0,3640,0,10,3640,0,47.5502,3330
950000.0,3,1.75,2150,0,8,1870,280,47.6285,3920
799500.0,4,2.5,2760,0,8,2760,0,47.627,2760
187000.0,2,1.0,840,0,6,840,0,47.492,1610
598000.0,5,2.25,2890,0,9,2890,0,47.6295,2570
429950.0,3,2.25,2060,0,8,1340,720,47.7712,2320
347950.0,5,2.25,1700,0,7,1700,0,47.4611,1810
851000.0,3,2.5,3560,0,10,3560,0,47.6652,3660
205000.0,3,1.0,1210,0,6,1210,0,47.4873,1320
225000.0,3,2.25,1590,0,7,1110,480,47.2917,1880
705000.0,4,2.25,2620,0,8,1520,1100,47.5847,2760
535000.0,5,2.5,3190,0,8,3190,0,47.5104,2480
222500.0,3,2.0,1450,0,7,1450,0,47.1955,1450
313500.0,2,1.5,1270,0,8,1000,270,47.5581,1270
632000.0,3,2.25,2730,2,9,2730,0,47.7704,2700
467000.0,3,2.0,1840,0,7,1840,0,47.7368,1280
339000.0,3,2.25,1970,0,8,1380,590,47.3821,1970
712000.0,3,2.75,3200,0,9,3200,0,47.5884,3020
335000.0,3,1.0,1060,0,7,1060,0,47.7355,1570
470000.0,3,3.25,1740,0,8,1360,380,47.558,1130
367000.0,3,1.0,810,0,7,810,0,47.6591,1820
440500.0,3,2.5,2460,0,7,2460,0,47.5415,2060
305000.0,4,1.0,2100,0,7,1050,1050,47.4558,1600
635000.0,3,1.75,1530,2,7,1020,510,47.6806,1530
1020000.0,3,2.25,1670,3,8,1670,0,47.6356,2300
342000.0,2,2.5,1175,0,8,740,435,47.6962,1710
283000.0,3,2.25,2130,0,8,1270,860,47.383,1960
430000.0,4,2.75,2470,0,8,1280,1190,47.2504,2200
245000.0,4,2.5,1700,0,7,1700,0,47.3303,1700
355500.0,3,2.5,2600,0,8,2600,0,47.3446,2600
395000.0,3,1.0,1460,0,7,1460,0,47.6837,1790
324900.0,4,2.25,2010,0,8,2010,0,47.3585,1660
660000.0,3,1.75,1320,0,7,1320,0,47.5848,1440
570000.0,3,2.5,3150,0,10,3150,0,47.447,2920
552321.0,3,2.5,1960,0,8,1960,0,47.7236,2040
1100000.0,2,1.75,2050,0,8,2050,0,47.6209,2980
237000.0,3,1.5,1800,0,7,1800,0,47.2739,1400
402000.0,2,1.0,1210,0,7,1210,0,47.5322,1400
470000.0,3,2.25,1830,0,8,1830,0,47.4612,2020
395900.0,3,1.75,1880,0,7,940,940,47.7362,1880
442000.0,2,1.75,860,0,7,860,0,47.6901,1420
795000.0,4,2.75,2890,0,10,2890,0,47.7102,3170
190500.0,3,2.0,1390,0,7,1130,260,47.2575,1790
808000.0,4,2.75,3340,0,9,3340,0,47.549,3230
500000.0,4,2.5,2040,0,8,2040,0,47.7413,1890
775000.0,4,2.75,3010,0,11,3010,0,47.5895,3330
300000.0,5,1.75,2110,0,7,1100,1010,47.7737,2020
496000.0,5,1.75,2110,0,7,1100,1010,47.7737,2020
448000.0,4,2.5,2510,2,9,2510,0,47.3547,3400
645000.0,2,2.25,2770,3,8,1570,1200,47.5098,2310
464600.0,3,1.75,1120,0,7,1120,0,47.5445,1490
590000.0,3,1.0,1530,0,8,1530,0,47.6108,1310
399000.0,3,2.5,1800,0,7,1690,110,47.5491,1570
305000.0,2,1.0,1030,0,7,1030,0,47.5669,1510
478000.0,3,1.75,1210,0,7,1210,0,47.7291,1520
598800.0,1,1.0,1090,0,6,1090,0,47.6928,1870
430000.0,4,2.25,1790,0,7,1110,680,47.7709,2270
433000.0,4,1.5,1550,0,7,1180,370,47.5499,1450
420000.0,4,2.75,2400,0,8,1170,1230,47.4556,1690
585000.0,4,1.75,2470,2,8,2470,0,47.4421,1470
255000.0,3,1.0,1170,0,7,1170,0,47.4627,1430
305000.0,3,1.0,1120,0,6,1120,0,47.4794,1120
396000.0,4,1.0,1040,0,6,1040,0,47.6945,1310
347500.0,4,2.5,2460,0,9,2460,0,47.3061,2390
900000.0,4,2.5,3690,0,11,3690,0,47.5699,3370
425000.0,3,1.75,1960,0,7,1400,560,47.739,2010
429000.0,3,2.5,1920,0,8,1920,0,47.5015,1920
540000.0,3,2.25,1670,0,8,1220,450,47.6478,1630
324950.0,3,2.0,1340,0,7,890,450,47.5644,1460
1049000.0,3,2.25,2610,0,7,1980,630,47.638,1940
221000.0,4,1.75,1540,0,7,1260,280,47.3424,1540
405000.0,3,2.0,1640,0,8,1640,0,47.7216,1750
1150000.0,3,2.5,2100,0,8,2100,0,47.6201,3070
588000.0,4,1.75,1930,0,8,1510,420,47.6396,1880
234950.0,3,2.0,1430,0,7,1430,0,47.2671,1610
580000.0,4,1.5,2430,0,7,1730,700,47.5782,2240
637000.0,5,3.0,2460,0,9,1840,620,47.5486,2530
704000.0,4,2.25,2490,0,8,1490,1000,47.6516,1780
210000.0,2,1.0,880,0,6,880,0,47.4885,1220
772000.0,4,2.5,2110,0,8,2110,0,47.6789,1700
763000.0,4,1.75,1850,0,8,1850,0,47.6885,1410
213500.0,2,1.5,2060,0,7,2060,0,47.3722,1780
255000.0,2,1.0,1360,0,6,680,680,47.7689,1360
423500.0,3,2.0,2000,0,8,1430,570,47.6976,1530
520000.0,3,1.5,1810,0,8,1810,0,47.7617,2920
550000.0,3,2.75,2230,0,8,1460,770,47.5791,2200
795000.0,3,2.75,1820,0,9,1820,0,47.5705,2540
495000.0,4,3.0,2740,0,8,2240,500,47.7738,2740
455000.0,4,2.5,2710,0,9,2710,0,47.434,2710
85000.0,2,1.0,910,0,5,910,0,47.3897,1160
239000.0,4,2.0,1980,0,6,1980,0,47.4836,1360
184900.0,3,1.0,1040,0,6,1040,0,47.329,1000
386000.0,4,2.25,2810,0,8,1610,1200,47.4437,2400
415000.0,4,2.5,2000,0,8,2000,0,47.7695,1790
387000.0,3,1.0,1530,0,7,1210,320,47.535,1960
2140000.0,6,4.0,5110,0,11,5110,0,47.6285,4110
685000.0,4,2.25,3133,0,9,2533,600,47.4255,3090
340000.0,4,2.5,2020,0,7,1070,950,47.4969,1340
422000.0,2,1.0,750,0,6,750,0,47.5547,1120
442000.0,3,2.5,1980,0,8,1980,0,47.7433,2610
280000.0,3,1.0,1200,0,6,920,280,47.5095,1280
1150000.0,5,2.5,3580,0,9,3580,0,47.693,2710
279000.0,3,2.5,2010,0,7,2010,0,47.1956,1550
569000.0,4,2.0,1730,0,7,1060,670,47.6624,1360
1355000.0,5,3.5,5960,2,10,4770,1190,47.6151,2810
209950.0,2,1.0,860,0,7,860,0,47.39,1250
468000.0,3,1.5,1370,0,7,1370,0,47.7153,1370
237100.0,3,1.75,1360,0,7,1360,0,47.3959,2240
336000.0,4,2.5,2530,0,8,2530,0,47.2634,2220
500000.0,4,2.0,1680,0,7,1680,0,47.593,2540
290000.0,3,2.5,1580,0,7,1580,0,47.4447,1580
1185000.0,7,3.5,3890,4,9,2840,1050,47.7011,2870
365000.0,5,2.0,1600,0,7,1600,0,47.5297,1190
146300.0,3,1.0,1200,0,6,1200,0,47.3156,1200
554000.0,3,1.75,1760,0,8,1760,0,47.5938,2090
424000.0,3,2.0,1670,0,7,1170,500,47.725,1500
1348000.0,4,3.5,4640,2,10,3210,1430,47.5524,3810
508500.0,4,1.5,1800,0,7,1800,0,47.6868,1420
244500.0,3,1.75,1210,0,7,1210,0,47.3639,1510
206000.0,2,2.5,1280,0,7,1280,0,47.4336,1460
643500.0,3,2.0,1650,0,8,1650,0,47.7053,1730
372500.0,4,1.75,1590,0,7,1590,0,47.7358,1610
630000.0,5,2.0,1900,2,8,1720,180,47.6735,1770
418000.0,2,2.5,1500,0,8,1500,0,47.5472,2080
425000.0,4,2.5,2689,0,9,2689,0,47.3803,2665
800000.0,4,2.75,3250,0,9,3250,0,47.5398,3920
208000.0,2,1.0,960,0,7,960,0,47.4745,1630
476000.0,3,1.75,1650,0,7,1650,0,47.5779,2040
277500.0,3,2.5,1690,0,8,1690,0,47.2779,2550
478000.0,3,1.75,2790,0,8,1410,1380,47.4734,1900
890000.0,4,2.75,2310,0,8,2310,0,47.6154,2270
450000.0,3,3.5,1790,0,8,1390,400,47.651,1560
205000.0,3,1.0,1230,0,6,1230,0,47.3266,1230
665000.0,3,2.0,1620,0,8,1620,0,47.6884,1470
518000.0,4,2.75,2440,0,8,1440,1000,47.7456,2030
465000.0,4,2.25,2100,0,8,2100,0,47.7019,1780
330000.0,3,2.5,3040,0,7,3040,0,47.3355,2760
449400.0,4,3.0,2490,0,7,2490,0,47.5139,2470
829000.0,3,2.75,2690,0,9,2690,0,47.7185,1440
450000.0,4,1.75,2190,0,8,2190,0,47.7108,2040
310000.0,3,1.75,1490,0,7,1490,0,47.4806,1340
615000.0,3,2.25,2530,0,9,2530,0,47.7221,3110
605000.0,3,2.0,2060,0,8,1120,940,47.6798,1500
437500.0,3,2.25,1970,0,9,1970,0,47.4635,2340
545000.0,3,1.75,1400,0,7,1400,0,47.6902,1050
770000.0,3,2.5,3680,0,10,2390,1290,47.7213,3570
600000.0,5,2.25,3000,0,8,3000,0,47.6373,2270
560000.0,3,1.0,1440,0,7,1440,0,47.6741,1850
1920000.0,5,5.75,7730,0,12,6660,1070,47.7615,2660
457000.0,3,1.0,1170,0,7,1170,0,47.687,1590
585000.0,2,1.0,1770,0,6,1520,250,47.6926,1060
560000.0,3,2.0,1860,0,8,1860,0,47.5397,1960
345000.0,2,1.0,770,0,5,770,0,47.5686,1550
550000.0,4,3.5,3820,2,8,2440,1380,47.557,2520
589950.0,4,2.5,3190,0,10,3190,0,47.3555,3400
327000.0,3,1.5,1320,0,7,1320,0,47.5009,1730
800000.0,2,2.25,1730,2,7,1730,0,47.373,1400
150000.0,3,1.0,1010,0,6,1010,0,47.6927,2020
425000.0,2,2.5,1140,0,8,1140,0,47.6713,1290
350000.0,3,1.0,860,0,7,860,0,47.7151,1360
273000.0,3,1.75,1540,0,6,1540,0,47.4451,1540
750000.0,4,2.25,2160,0,8,1080,1080,47.5651,2780
240000.0,3,1.5,1450,0,7,1450,0,47.4215,1460
400000.0,3,1.75,1830,0,8,1830,0,47.3123,1990
230000.0,3,1.5,1630,0,7,980,650,47.29,1440
372000.0,4,2.5,2500,0,8,2500,0,47.4124,2360
459500.0,3,1.75,1470,0,7,1030,440,47.7325,1100
582000.0,3,2.5,2380,0,8,2380,0,47.5255,2450
465000.0,4,2.5,2170,0,7,1420,750,47.7216,1710
386000.0,3,2.0,2120,0,9,2120,0,47.435,2660
546000.0,3,2.5,1530,0,8,1530,0,47.6179,1530
278000.0,3,1.75,2710,0,7,2060,650,47.3073,1690
540000.0,3,2.5,2860,0,8,2860,0,47.5336,2650
529000.0,4,1.75,2800,0,7,2800,0,47.5204,1600
554000.0,4,1.0,1120,0,7,1120,0,47.7055,1370
210000.0,3,1.0,1730,0,7,1430,300,47.3404,1820
225000.0,2,1.0,1010,0,6,1010,0,47.3759,980
561600.0,4,2.5,2350,0,9,2350,0,47.6262,2590
300000.0,6,5.25,2860,0,7,2860,0,47.303,1390
1650000.0,4,3.5,4285,1,10,3485,800,47.6434,2960
1017100.0,4,3.75,4060,0,10,4060,0,47.6051,4020
150000.0,3,1.0,1310,0,7,960,350,47.2958,1310
400950.0,2,1.75,2320,0,7,1400,920,47.5468,1420
620000.0,4,2.25,2210,0,9,2210,0,47.6475,2330
449000.0,4,2.75,2090,0,8,1680,410,47.4333,1990
630000.0,4,2.5,2240,2,7,1250,990,47.6818,1380
336000.0,2,1.0,1180,0,6,1180,0,47.7475,1180
299950.0,4,1.75,1560,0,7,1560,0,47.3384,2460
352500.0,4,2.0,1970,0,8,1350,620,47.765,1980
150000.0,2,1.0,840,0,6,840,0,47.484,1480
175000.0,2,1.0,840,0,6,840,0,47.484,1480
305000.0,3,2.0,1830,0,8,1830,0,47.3066,2490
2574000.0,4,3.75,4475,4,12,2659,1816,47.6646,4340
607500.0,3,1.5,1800,0,7,1200,600,47.6858,1580
505000.0,2,1.0,1250,0,7,950,300,47.6959,1290
280500.0,3,1.75,2440,0,7,1220,1220,47.4118,1650
610000.0,3,2.5,2910,2,10,2910,0,47.4602,2680
381000.0,5,2.75,3060,0,8,3060,0,47.3809,2590
482000.0,5,2.25,2230,0,8,1320,910,47.7466,2080
379950.0,3,1.0,1270,0,7,1270,0,47.7279,1480
2500000.0,4,4.5,4300,0,11,4300,0,47.6218,3070
425000.0,3,2.25,1580,0,7,1180,400,47.6365,1580
580000.0,4,2.25,2570,0,8,2570,0,47.6555,2390
605000.0,2,1.0,860,0,7,860,0,47.6021,1740
194000.0,1,1.0,820,0,8,760,60,47.5472,1770
546200.0,4,2.25,2090,0,8,2090,0,47.6364,1850
1395000.0,4,3.5,3560,0,10,2560,1000,47.5569,3100
315000.0,3,1.75,1860,0,7,1240,620,47.4913,1940
465000.0,3,1.5,900,0,6,900,0,47.5751,1000
330000.0,2,1.0,1160,0,6,580,580,47.3537,1160
795000.0,4,2.75,3100,0,10,3100,0,47.6859,3140
265000.0,4,2.25,2300,0,7,1280,1020,47.4576,1640
1300000.0,4,2.5,3110,4,11,2040,1070,47.6952,3110
126500.0,3,1.0,1130,0,6,1130,0,47.4952,1190
760000.0,4,2.5,2920,0,9,2920,0,47.7036,3020
540000.0,2,1.25,1230,0,9,1050,180,47.6193,1100
446000.0,5,2.75,2190,0,7,1370,820,47.7762,2280
170000.0,1,0.75,850,2,6,850,0,47.7654,900
379000.0,3,2.5,1500,0,7,1000,500,47.7236,1840
1400000.0,9,4.0,4620,0,11,3870,750,47.6684,2710
800000.0,4,2.75,3150,0,9,3150,0,47.5979,3200
260000.0,3,1.0,1300,0,7,1300,0,47.3427,1260
820000.0,5,2.5,3160,0,7,1580,1580,47.5735,2440
449950.0,3,1.75,2070,3,7,2070,0,47.2853,1820
392000.0,3,2.25,1790,0,7,1220,570,47.7184,2040
465000.0,3,2.5,1650,0,8,1650,0,47.5997,1650
449950.0,4,2.5,2070,0,7,1230,840,47.6958,1770
520000.0,3,1.5,1580,0,7,1180,400,47.6931,1580
546800.0,4,2.25,2170,0,8,1420,750,47.6219,2390
825000.0,4,2.75,2220,0,7,1560,660,47.6381,2500
337000.0,3,1.75,1440,0,7,1440,0,47.743,1950
333000.0,2,1.0,720,0,6,720,0,47.7003,1200
380000.0,2,2.0,1120,0,8,760,360,47.5788,1120
280000.0,3,2.5,1970,0,8,1970,0,47.2674,1970
202000.0,3,1.5,1420,0,6,1420,0,47.1948,1090
585000.0,4,2.5,2250,0,8,2250,0,47.5973,2290
435000.0,4,2.0,2630,1,8,1330,1300,47.4841,1900
1200000.0,4,3.5,4740,0,11,4740,0,47.6779,2120
364000.0,2,2.25,1280,0,7,1280,0,47.5939,1250
300000.0,3,1.0,1260,0,6,1260,0,47.7,2100
558000.0,2,1.75,1930,0,8,1930,0,47.7196,1670
199950.0,1,1.5,1048,0,7,1048,0,47.4759,950
515000.0,3,2.25,1640,0,8,1640,0,47.5484,2110
590000.0,4,2.5,2380,0,8,2380,0,47.5382,1370
813500.0,4,2.0,2530,0,8,2220,310,47.613,2500
725000.0,4,2.5,2700,0,8,2700,0,47.6934,1540
490000.0,3,2.25,2330,0,8,2330,0,47.631,2050
277000.0,3,2.25,2160,0,7,2160,0,47.1927,1970
325000.0,4,1.5,1470,0,7,1470,0,47.3458,1810
649800.0,4,2.5,2280,0,8,2280,0,47.6883,1660
425000.0,3,1.0,1280,0,7,1280,0,47.6029,1320
460000.0,2,1.0,850,0,7,850,0,47.6926,980
750000.0,3,3.25,4610,0,9,4610,0,47.6217,2900
469000.0,5,2.5,2690,0,8,1790,900,47.7708,2670
566000.0,4,1.75,2440,0,8,1340,1100,47.6823,2170
407500.0,3,2.5,1930,0,8,1930,0,47.4938,2290
353500.0,2,1.0,800,0,6,800,0,47.7171,1470
524000.0,3,2.25,2430,0,8,2430,0,47.4749,2800
264950.0,4,2.5,1990,0,7,1990,0,47.3125,1500
547500.0,3,2.5,2550,0,9,2550,0,47.739,2550
264500.0,3,2.25,1370,0,7,1370,0,47.3504,1400
507500.0,3,2.0,2020,0,7,1020,1000,47.5866,1670
560000.0,3,3.5,1560,0,8,1180,380,47.5812,1550
995000.0,5,4.0,5610,0,11,4090,1520,47.7239,3860
835000.0,6,2.0,3560,2,9,3560,0,47.6056,2130
440000.0,3,1.5,2120,0,8,1220,900,47.5658,1620
1015000.0,3,2.5,2920,2,8,1460,1460,47.642,2380
300000.0,2,1.0,1340,2,7,1340,0,47.5094,2550
125000.0,3,1.0,1230,0,6,1230,0,47.6941,1230
986000.0,4,3.5,2840,0,10,1920,920,47.5543,1300
315000.0,4,2.5,2080,0,7,1680,400,47.5107,1270
320000.0,4,2.5,2070,0,7,2070,0,47.3968,2130
972000.0,4,3.25,4010,0,11,4010,0,47.5229,3980
760000.0,3,2.5,2190,0,7,1540,650,47.5419,2880
265000.0,4,3.0,1730,0,6,1730,0,47.4738,1500
355000.0,2,1.0,1250,0,7,1250,0,47.5318,1180
300000.0,3,1.0,1300,0,6,1300,0,47.5435,1210
474950.0,5,2.5,2080,0,7,1460,620,47.7334,1840
470000.0,4,2.0,2180,0,7,2180,0,47.698,1880
437500.0,3,1.0,1630,0,7,1630,0,47.6576,1880
520000.0,2,1.5,1840,0,8,1040,800,47.6808,1290
237600.0,2,1.0,1370,0,6,1370,0,47.4224,1330
162950.0,2,1.0,950,0,8,950,0,47.3793,1080
457000.0,3,1.75,1690,0,8,1690,0,47.5247,1270
635000.0,3,2.5,1780,0,8,1210,570,47.5574,2310
735000.0,4,3.0,2840,0,8,2060,780,47.5683,1840
910000.0,2,2.5,2000,4,9,2000,0,47.7056,2510
346500.0,3,3.25,1570,0,8,1290,280,47.548,1570
655000.0,4,2.5,2370,0,9,1630,740,47.6222,2440
425000.0,3,1.75,1610,0,7,1610,0,47.5659,2220
137000.0,3,1.0,1300,0,6,1300,0,47.2921,1300
557500.0,3,2.5,2620,0,9,2620,0,47.7378,2560
415000.0,4,2.25,3060,0,8,3060,0,47.3397,2090
830000.0,5,2.25,2780,0,9,2780,0,47.6134,2740
949000.0,4,3.0,4270,0,11,4270,0,47.7711,3760
420000.0,3,1.0,1310,0,7,1310,0,47.6826,1010
353000.0,2,1.0,1100,0,7,1100,0,47.7235,1920
560000.0,3,1.75,1480,0,8,1480,0,47.7192,1480
445700.0,3,2.5,1270,0,8,1270,0,47.6697,1320
226000.0,4,1.0,1270,0,7,1270,0,47.5441,1300
358000.0,3,1.0,890,0,7,890,0,47.5398,1270
501000.0,3,1.75,1480,0,7,740,740,47.5718,1600
609000.0,4,2.5,3240,0,9,1840,1400,47.7731,2290
734950.0,4,3.25,4280,0,10,3050,1230,47.3017,2820
725000.0,5,2.5,3210,0,8,1830,1380,47.6205,2450
350500.0,3,2.25,1870,0,7,1390,480,47.734,1830
610000.0,5,2.5,3990,0,8,1990,2000,47.6236,2090
605125.0,2,1.0,1160,0,7,910,250,47.6723,1220
1388000.0,4,2.25,2940,0,9,2940,0,47.6214,3410
550000.0,3,2.25,1850,0,8,1850,0,47.6486,2390
335000.0,2,1.75,1060,0,7,760,300,47.5426,1060
397000.0,3,2.0,1100,0,7,1100,0,47.7304,1510
240000.0,3,2.0,1190,0,7,1190,0,47.314,1700
240000.0,3,2.0,1030,0,7,1030,0,47.3463,1300
262500.0,2,1.5,1140,0,7,1140,0,47.7354,2140
440000.0,3,1.5,2260,0,7,1200,1060,47.6756,1950
160000.0,3,1.0,1140,0,6,1140,0,47.7093,1140
427000.0,4,1.0,1860,0,7,1860,0,47.6251,1800
920000.0,4,3.5,4080,0,9,4080,0,47.6818,3920
2300000.0,4,2.5,3280,4,10,2180,1100,47.6285,3240
480000.0,4,2.5,2870,0,9,2870,0,47.7568,2700
615000.0,4,1.75,2300,0,9,1960,340,47.6331,2840
736500.0,3,2.0,2230,0,7,1290,940,47.645,1650
542500.0,3,2.5,1920,0,8,1600,320,47.5901,1650
191000.0,2,1.0,700,0,6,700,0,47.4927,1040
730000.0,4,2.5,2740,0,8,2740,0,47.6315,2310
1225000.0,5,2.25,3440,2,9,3440,0,47.6127,2822
129000.0,1,1.0,650,0,5,650,0,47.3721,1630
284000.0,3,1.5,1500,0,7,1500,0,47.468,1500
645000.0,3,2.5,2490,0,9,2490,0,47.6298,2710
218000.0,3,1.5,1330,0,7,1330,0,47.3103,1500
675000.0,4,3.5,3190,2,8,2120,1070,47.7082,2550
575000.0,3,2.5,1590,0,7,1110,480,47.6855,1590
225000.0,2,1.0,830,0,6,830,0,47.7339,1150
626000.0,3,2.25,1810,0,8,1810,0,47.6882,1760
499950.0,4,2.5,2910,0,9,2910,0,47.4714,1730
405000.0,4,1.75,2180,0,7,1090,1090,47.7516,2000
152500.0,3,1.0,1090,0,6,1090,0,47.3161,1030
325000.0,4,2.5,2160,0,8,2160,0,47.4111,2020
475300.0,3,1.0,2110,0,7,1110,1000,47.688,1360
485000.0,3,1.75,2180,0,7,1210,970,47.5251,2140
720000.0,3,2.5,2100,0,7,1500,600,47.614,1750
465000.0,3,1.75,1410,0,7,1410,0,47.7183,1410
489000.0,3,1.5,1020,0,7,920,100,47.695,1620
3100000.0,5,5.25,5090,0,12,5090,0,47.6297,3830
288000.0,3,2.25,2090,0,7,1280,810,47.3951,1800
225000.0,3,1.75,1350,0,7,1350,0,47.1981,1690
499000.0,3,1.75,2650,1,8,2240,410,47.4909,2650
632000.0,5,3.0,3520,0,8,2100,1420,47.4658,3000
580000.0,3,2.5,2040,0,8,2040,0,47.6365,2230
730000.0,4,1.5,2340,0,8,2100,240,47.6065,2320
325000.0,4,2.25,1770,0,7,1770,0,47.4192,1770
421000.0,3,1.75,1100,0,7,1100,0,47.5368,1100
316000.0,3,2.5,1490,0,8,1490,0,47.4915,1310
415000.0,2,1.0,1460,0,6,880,580,47.6774,1540
401000.0,3,2.25,1350,0,7,1350,0,47.6824,1650
229950.0,3,0.75,1030,0,5,1030,0,47.3877,1140
539950.0,3,1.75,1820,0,8,1820,0,47.6243,2670
335000.0,3,2.0,1170,0,6,1170,0,47.5181,1180
339000.0,3,2.5,1450,0,7,1450,0,47.532,1970
414950.0,4,1.75,2200,0,7,1100,1100,47.7481,1940
650000.0,4,2.0,1610,0,8,1610,0,47.6011,1930
445000.0,3,2.5,2690,0,8,2690,0,47.6462,2370
295000.0,3,2.25,1850,0,9,1850,0,47.3146,2360
975000.0,4,2.25,2250,0,9,2010,240,47.643,1910
296500.0,3,1.5,1580,0,7,1580,0,47.4423,1650
440000.0,4,2.75,2030,0,8,1550,480,47.752,2510
420000.0,5,1.5,1890,0,7,1890,0,47.7196,1670
302000.0,3,2.5,2140,0,8,2140,0,47.3289,2180
350000.0,4,1.75,1770,0,8,1770,0,47.4265,2030
667000.0,3,1.75,3320,3,8,2260,1060,47.2407,2960
645000.0,3,2.0,1640,0,7,910,730,47.6546,1670
430000.0,4,2.75,1820,0,7,1220,600,47.5204,1630
413000.0,4,1.0,1410,0,7,810,600,47.566,1500
420000.0,3,1.0,1240,0,7,1240,0,47.6775,1240
495000.0,3,2.25,1780,0,7,1230,550,47.6977,1780
2187730.0,4,4.5,4240,0,10,4240,0,47.6193,3010
965000.0,4,2.5,3570,0,10,3570,0,47.5617,3510
500000.0,4,2.5,1900,0,8,1200,700,47.7289,1950
636100.0,3,1.0,1010,0,7,1010,0,47.6438,1960
720000.0,4,2.5,2870,0,9,2870,0,47.5632,2560
298000.0,3,1.75,1620,0,8,1340,280,47.3321,2076
409000.0,2,1.75,1480,0,6,740,740,47.6916,1060
370000.0,4,2.5,2650,0,9,2650,0,47.3515,2760
230000.0,5,1.0,1410,0,7,1410,0,47.3054,1200
290000.0,3,2.0,1360,0,7,1360,0,47.7365,1300
420000.0,4,2.25,2930,0,8,1560,1370,47.3103,2800
917000.0,4,2.5,3500,2,10,3500,0,47.5533,3820
957000.0,5,3.25,3160,2,10,2180,980,47.6464,3160
482000.0,3,2.25,1710,0,7,1710,0,47.6198,1680
488000.0,3,1.75,2180,0,9,2180,0,47.4831,2300
760369.0,5,2.5,2870,0,9,2870,0,47.5463,2870
170000.0,2,1.0,1500,0,8,1500,0,47.4727,1700
625000.0,3,2.5,2120,0,8,1230,890,47.5621,2690
357000.0,3,1.5,1590,0,7,1080,510,47.73,1590
583000.0,3,2.25,1830,0,8,1350,480,47.6336,1920
173250.0,3,2.0,1210,0,7,1210,0,47.4849,1360
414050.0,4,2.0,1590,0,7,1590,0,47.7273,1400
400000.0,3,1.75,1050,0,6,950,100,47.5715,1360
537000.0,3,2.0,1550,0,8,1550,0,47.606,2400
465000.0,4,2.25,2070,0,7,2070,0,47.727,2080
425000.0,3,2.25,1740,0,8,1740,0,47.5138,2100
445000.0,4,2.0,1700,0,6,1080,620,47.6289,2070
179950.0,2,1.0,1200,0,6,1200,0,47.3277,1040
275000.0,3,2.5,1710,0,7,1710,0,47.2778,1720
190000.0,4,2.5,1840,0,7,1840,0,47.2649,1430
385000.0,3,1.75,1900,0,7,1280,620,47.5549,1330
303000.0,4,1.0,2300,0,6,1220,1080,47.5671,1200
165000.0,3,1.0,970,0,6,970,0,47.4688,1230
600000.0,2,2.0,1270,0,6,1270,0,47.6729,2190
710000.0,3,2.25,3130,0,8,3130,0,47.5462,3130
875000.0,5,3.25,4230,0,10,2720,1510,47.6375,3280
269950.0,3,2.5,1480,0,7,1480,0,47.3293,1810
838000.0,4,2.5,3310,0,9,3310,0,47.7232,3350
670500.0,4,2.0,1590,0,7,1590,0,47.6406,2370
420000.0,4,1.5,1690,0,7,1290,400,47.7438,1780
370000.0,3,1.5,1690,0,7,1430,260,47.356,1930
360000.0,3,1.75,1500,0,7,1500,0,47.7748,1650
562500.0,4,2.5,2320,0,8,2320,0,47.7326,2260
360500.0,3,2.5,3300,0,8,1650,1650,47.4113,1950
389999.0,3,2.25,1445,0,7,1300,145,47.5342,1410
450000.0,4,3.0,1890,0,7,1270,620,47.5221,1900
247500.0,4,2.0,1760,0,7,1060,700,47.3258,1280
208000.0,3,1.0,1050,0,5,1050,0,47.4933,1410
455000.0,3,2.5,1980,0,7,1980,0,47.7257,2060
379400.0,4,1.75,2120,0,7,1060,1060,47.7172,1530
190000.0,3,1.5,760,0,6,760,0,47.5295,980
326188.0,3,1.0,1300,0,7,1300,0,47.64,1600
168000.0,2,2.5,1160,0,7,1160,0,47.5264,1380
314000.0,4,2.5,2340,0,8,2340,0,47.3781,2980
630000.0,4,2.75,2710,0,9,2710,0,47.4634,2390
550000.0,3,1.75,1440,0,7,1440,0,47.6008,1340
530000.0,4,2.25,1980,0,8,1980,0,47.647,2100
637500.0,3,1.75,1680,0,7,1680,0,47.6556,3340
400000.0,3,2.5,1390,0,8,1390,0,47.566,1390
700000.0,5,2.75,3100,2,8,3100,0,47.7188,2120
272000.0,3,2.5,1680,0,7,1680,0,47.1952,1580
600000.0,4,2.5,2710,0,8,2710,0,47.5383,2870
450600.0,2,1.0,840,0,7,840,0,47.5513,1310
550000.0,3,2.25,2090,2,10,2090,0,47.5287,1940
225000.0,3,1.0,1120,0,6,1120,0,47.2051,1250
132825.0,3,1.5,1210,0,6,1210,0,47.3615,1120
219950.0,3,1.5,1210,0,6,1210,0,47.3615,1120
580000.0,5,2.0,1940,0,7,970,970,47.6875,1700
568000.0,3,1.75,1930,2,7,1300,630,47.6751,2860
406000.0,3,1.75,1270,0,7,1030,240,47.737,1630
469000.0,3,1.75,1680,0,7,1170,510,47.6849,1080
415000.0,3,2.5,2090,0,8,2090,0,47.4947,2040
390000.0,3,1.5,1000,0,7,1000,0,47.5643,1520
251000.0,3,1.75,1350,0,8,1350,0,47.3334,1520
750000.0,3,2.5,3280,1,9,2440,840,47.5219,1770
845000.0,4,2.5,2390,0,9,1760,630,47.6144,1940
350000.0,3,1.5,1860,0,7,1860,0,47.484,1860
322000.0,3,1.0,1380,0,7,790,590,47.7049,1509
664500.0,4,2.25,3070,0,8,2740,330,47.7638,2580
988000.0,3,1.75,2190,2,8,2190,0,47.643,2190
625000.0,2,1.75,1990,0,7,1090,900,47.6889,1270
675000.0,2,1.0,930,2,6,930,0,47.5699,2800
503000.0,3,1.75,2070,0,7,1420,650,47.522,2150
431000.0,4,2.25,2170,2,8,1270,900,47.4394,2080
250000.0,3,1.75,1910,0,7,1290,620,47.4185,1590
268500.0,4,2.5,2100,0,8,2100,0,47.3901,2100
1070000.0,6,3.25,3560,4,9,3560,0,47.7602,3560
295000.0,4,2.5,2290,0,7,2290,0,47.4753,1710
780000.0,3,2.25,2130,0,8,1590,540,47.5423,2700
354000.0,3,2.5,2160,0,8,2160,0,47.4166,1990
305000.0,2,1.0,860,0,6,860,0,47.7206,1270
733000.0,5,2.75,2880,0,8,2880,0,47.7048,2940
640000.0,4,2.75,2100,0,8,1720,380,47.6006,2390
840000.0,4,2.5,2360,2,8,1630,730,47.5889,2140
1475000.0,5,3.25,3680,0,10,3680,0,47.6548,2690
525000.0,3,1.0,1560,0,8,1140,420,47.7261,2130
625000.0,4,2.75,1680,0,7,1680,0,47.6557,2400
350000.0,3,2.0,1380,0,8,1380,0,47.6074,1480
650000.0,4,2.75,2610,0,8,1910,700,47.6901,1470
435000.0,2,1.0,870,2,7,870,0,47.5682,1690
660000.0,3,1.0,1210,1,8,1210,0,47.5728,1580
350000.0,3,1.0,1150,0,6,1150,0,47.6614,1490
435000.0,3,2.5,3110,2,8,1560,1550,47.5331,2060
375900.0,6,1.5,2550,0,8,1750,800,47.3222,2010
272000.0,3,3.0,2430,0,8,2150,280,47.2579,1670
233000.0,3,1.75,1460,0,7,1040,420,47.3035,1310
500000.0,4,1.5,1330,2,7,1330,0,47.5681,1360
540000.0,4,1.75,2040,0,8,1440,600,47.7611,1910
712000.0,3,2.5,2375,0,9,2375,0,47.6627,2095
425000.0,4,2.5,2480,0,7,2480,0,47.4998,2950
242000.0,3,1.75,1580,0,7,790,790,47.4807,1330
515000.0,5,3.25,2740,0,7,1390,1350,47.7645,2150
415000.0,4,1.75,1920,0,7,1920,0,47.5381,1310
375000.0,3,2.75,2200,3,8,1570,630,47.3438,2680
182500.0,3,1.0,910,0,7,910,0,47.3337,1530
310000.0,3,1.5,1860,0,7,1240,620,47.3962,2240
360000.0,3,1.75,1510,0,7,1060,450,47.5535,1610
889000.0,4,3.5,3920,0,9,3920,0,47.6797,3920
450500.0,2,1.0,1330,0,7,1330,0,47.6866,1900
342000.0,4,2.25,1964,0,9,1964,0,47.3594,1757
413000.0,3,2.0,1520,0,8,1520,0,47.7753,1800
960000.0,5,4.0,3720,0,10,3720,0,47.5956,4100
180000.0,2,1.0,770,0,7,770,0,47.762,1060
770000.0,4,2.5,3210,0,10,3210,0,47.6073,3280
224400.0,3,1.75,1070,0,7,1070,0,47.3129,1280
280000.0,3,1.5,1430,0,7,1430,0,47.4454,1080
500000.0,3,2.5,1670,0,8,1670,0,47.531,1670
153000.0,2,1.0,710,0,6,710,0,47.4811,1230
385000.0,3,2.25,1920,0,7,1060,860,47.7067,1580
325000.0,2,1.0,750,0,7,750,0,47.7017,1050
315000.0,4,3.0,2210,0,7,2210,0,47.2959,890
294999.0,4,2.5,1660,0,7,1660,0,47.3635,1580
175000.0,3,1.75,1910,0,8,1910,0,47.3095,1820
299000.0,3,1.75,1910,0,8,1910,0,47.3095,1820
146000.0,2,1.0,780,0,6,780,0,47.4816,1670
290000.0,3,2.25,1650,0,7,1500,150,47.7757,1420
1776000.0,3,3.25,3230,3,10,3230,0,47.6348,3030
367500.0,2,1.0,810,0,6,810,0,47.5614,1040
535000.0,4,2.5,2750,0,8,2750,0,47.7298,2500
334999.0,3,2.5,1650,0,7,1650,0,47.6553,1630
655000.0,3,1.75,1960,0,7,1080,880,47.6535,1720
1298000.0,4,3.5,2790,0,8,2790,0,47.5651,2570
480000.0,4,2.25,2230,0,7,1300,930,47.7691,2090
465000.0,3,1.5,1280,0,7,850,430,47.5509,1280
297950.0,3,2.0,1240,0,7,1240,0,47.449,1480
590000.0,3,2.0,1860,0,7,1110,750,47.6102,1680
805000.0,4,2.75,2410,0,8,1410,1000,47.6707,1760
204250.0,3,2.25,1960,0,7,1490,470,47.2981,1580
500000.0,3,2.25,1710,0,8,1710,0,47.5691,1810
490000.0,4,2.5,3480,0,9,1980,1500,47.3816,3480
2500000.0,4,3.75,3480,4,9,1870,1610,47.6227,4780
750000.0,3,2.5,2960,3,9,2960,0,47.4,2350
405000.0,4,2.5,2670,0,9,2330,340,47.7735,2440
209995.0,2,1.0,700,0,5,700,0,47.4934,960
680000.0,4,2.5,2830,0,9,2830,0,47.5851,2520
355000.0,3,1.75,1120,0,6,860,260,47.7107,1240
280000.0,2,1.0,1310,0,6,1310,0,47.4834,1240
385000.0,3,2.25,1710,0,7,1210,500,47.7675,1800
505000.0,4,2.75,2200,0,8,1100,1100,47.5472,2140
429900.0,4,3.25,3310,0,9,2380,930,47.2655,2490
560000.0,4,2.5,2280,0,9,2280,0,47.7099,2670
231000.0,3,2.0,1640,0,7,1040,600,47.3661,1640
135000.0,2,1.0,750,0,6,750,0,47.5188,760
800000.0,4,3.0,3520,0,8,1980,1540,47.6678,1570
420000.0,3,2.5,2720,0,8,2720,0,47.4954,1950
360000.0,3,1.0,1660,0,7,1660,0,47.708,2020
642000.0,4,2.5,2560,0,9,2560,0,47.5717,2780
379950.0,3,2.0,1080,0,7,1080,0,47.6836,1070
745000.0,3,1.75,2050,0,9,2050,0,47.5968,2530
630000.0,4,2.0,2670,0,9,1780,890,47.5841,1820
250000.0,3,2.5,1730,0,7,1730,0,47.4029,1770
275000.0,3,1.0,990,0,7,990,0,47.767,1210
435000.0,6,3.0,3560,0,7,1780,1780,47.5282,3040
175000.0,2,1.0,700,0,5,700,0,47.5136,1250
560000.0,4,1.75,1880,0,7,1090,790,47.6635,1390
325000.0,4,2.25,1870,0,7,1170,700,47.7157,2000
1185000.0,3,2.75,2500,0,9,2500,0,47.6258,2810
399950.0,3,2.5,2570,0,9,2570,0,47.4188,2590
752000.0,4,2.5,2940,0,9,2940,0,47.5333,2980
1200000.0,4,3.5,3930,0,10,3930,0,47.7497,2860
400000.0,4,1.5,2150,0,7,2150,0,47.7635,1760
240000.0,3,2.0,1330,0,7,630,700,47.5255,1140
640000.0,5,2.5,3220,0,8,3220,0,47.5957,2550
564450.0,3,2.5,2710,0,9,2710,0,47.512,2730
300000.0,3,1.5,1630,0,6,1630,0,47.4743,1680
286000.0,3,2.5,1680,0,8,1680,0,47.3684,1800
531800.0,3,2.5,1930,0,7,1930,0,47.6783,2410
502000.0,4,2.25,2140,0,7,1550,590,47.7271,2350
993500.0,4,2.25,4070,0,10,4070,0,47.5563,2820
450000.0,3,1.0,1350,0,7,1350,0,47.5741,1450
997950.0,4,3.5,4270,0,9,4270,0,47.5352,2610
526000.0,3,1.0,1320,0,7,1320,0,47.5566,1490
335000.0,3,1.75,2100,0,7,1230,870,47.4601,1700
187250.0,2,1.0,710,0,6,710,0,47.4939,1320
735000.0,3,2.25,2350,0,7,1020,1330,47.6809,1570
425000.0,3,1.0,1180,0,7,1180,0,47.7028,1740
110000.0,3,1.0,1250,0,6,1250,0,47.4235,1820
305000.0,3,2.0,1490,0,7,1490,0,47.4852,1540
212000.0,3,1.0,1000,0,6,1000,0,47.4562,1300
1380000.0,5,4.25,4050,2,10,2150,1900,47.5323,3600
298950.0,5,2.25,2300,0,8,1300,1000,47.3812,2350
525000.0,3,1.75,1330,0,7,1330,0,47.7001,1330
707000.0,4,3.25,3200,0,9,3200,0,47.5886,3120
695000.0,3,2.75,2590,0,10,2590,0,47.5527,2850
796500.0,3,2.75,2590,0,10,2590,0,47.5527,2850
420000.0,4,2.5,2030,0,7,1150,880,47.7404,1770
625000.0,5,2.5,2700,0,8,1950,750,47.6078,2550
620000.0,3,1.75,1670,0,8,1670,0,47.595,2410
1450000.0,5,2.75,3090,0,9,3090,0,47.6232,2970
549950.0,5,2.5,2650,0,9,2650,0,47.7726,2560
275000.0,4,2.0,1440,0,5,1440,0,47.5049,1500
705000.0,3,2.5,2820,3,9,1780,1040,47.7691,2300
197000.0,3,1.75,1690,0,7,1060,630,47.3324,1580
265000.0,3,1.75,1420,0,8,1420,0,47.3871,1730
297000.0,4,1.75,1790,0,7,1050,740,47.4663,1540
207500.0,3,1.75,1320,0,7,1320,0,47.3234,1340
410000.0,3,2.5,1509,0,8,1509,0,47.7047,1509
268000.0,3,2.0,1610,0,7,1610,0,47.397,1600
330000.0,4,1.75,1550,3,6,1550,0,47.2194,1720
417500.0,3,1.0,1160,0,6,1160,0,47.7024,1800
760000.0,4,2.25,2500,0,8,2500,0,47.5569,2470
499000.0,3,2.5,1540,0,8,1390,150,47.6457,1680
620000.0,4,2.5,1910,0,8,1910,0,47.5644,1980
315000.0,3,2.5,2340,0,7,2340,0,47.3608,1850
624950.0,3,2.5,2060,0,8,2060,0,47.6874,1980
525000.0,3,2.25,1960,0,7,1960,0,47.5247,1920
300000.0,2,1.5,1150,0,7,1150,0,47.7248,1400
299900.0,4,2.75,2330,0,8,1560,770,47.3203,2350
299000.0,3,2.5,2210,0,7,1450,760,47.3783,2110
1880000.0,4,2.75,3260,0,10,2170,1090,47.6245,3480
265000.0,4,1.75,1900,0,6,1900,0,47.289,1530
280000.0,2,1.75,1610,0,6,1610,0,47.5319,1800
124740.0,3,1.0,1340,0,6,1340,0,47.3224,1320
1085000.0,3,2.75,3170,0,9,3170,0,47.6611,3920
1970000.0,8,3.5,4440,3,10,3140,1300,47.631,4440
219000.0,4,1.0,1370,0,6,1370,0,47.5046,1280
569950.0,5,1.0,1420,0,8,1420,0,47.5807,1420
212500.0,2,2.0,1030,0,6,1030,0,47.4905,1790
680000.0,3,2.25,1820,0,7,1320,500,47.5849,1780
1457000.0,4,1.5,2650,0,9,2400,250,47.6275,2420
300000.0,3,1.0,910,0,7,910,0,47.7303,1250
629950.0,3,2.5,1680,0,9,1120,560,47.6424,1610
349900.0,2,1.75,1550,0,6,970,580,47.4701,1550
690000.0,4,2.5,2780,0,8,2780,0,47.5976,2670
1454000.0,5,4.0,4070,0,10,4070,0,47.6771,2640
1288000.0,3,2.5,3240,0,11,3240,0,47.5327,3470
696000.0,4,3.5,3650,0,9,2550,1100,47.4776,2860
650000.0,3,2.25,2180,0,8,2180,0,47.6723,2060
640000.0,3,3.5,2480,0,8,2480,0,47.6083,2380
499950.0,5,2.5,3180,0,9,3180,0,47.3727,2500
490000.0,4,2.5,3630,0,10,3630,0,47.3623,3370
685000.0,5,2.5,3160,0,9,3160,0,47.5362,3670
387500.0,4,1.0,1370,0,6,1370,0,47.512,1090
401750.0,2,1.5,1070,0,8,1000,70,47.5619,1170
254950.0,4,2.0,2180,0,7,1170,1010,47.3676,1630
500000.0,4,2.25,2420,0,8,2420,0,47.4663,2410
856500.0,4,2.5,3290,0,10,3290,0,47.7048,3290
552000.0,3,1.0,1430,0,6,1080,350,47.6724,1630
506500.0,4,2.5,1890,0,7,1500,390,47.7278,2070
500000.0,3,2.25,1760,0,8,1760,0,47.5754,1960
280000.0,4,2.75,2230,0,7,1400,830,47.5123,1740
308000.0,3,1.75,1630,0,7,1330,300,47.4635,1630
613500.0,3,2.5,2350,0,8,2350,0,47.5713,2270
255000.0,3,1.75,1550,0,7,1050,500,47.3433,1550
545000.0,3,2.5,3550,0,10,3550,0,47.6223,3080
620000.0,4,2.5,2720,0,7,1360,1360,47.5832,1920
450000.0,3,1.75,1740,0,7,1740,0,47.5314,990
279000.0,4,1.75,1840,0,7,1090,750,47.4002,1840
625000.0,3,2.5,2010,0,9,2010,0,47.5463,2250
274950.0,3,1.75,1670,0,7,1320,350,47.3776,1650
423000.0,3,1.75,1820,0,7,1040,780,47.5233,1700
350000.0,2,1.0,720,1,6,720,0,47.7598,952
305000.0,4,1.75,2370,0,7,1460,910,47.3352,1450
368000.0,3,1.75,2120,3,7,1060,1060,47.4109,1830
232000.0,3,1.75,1290,0,7,1290,0,47.323,1440
250000.0,4,3.0,1800,0,7,1800,0,47.5333,1830
220000.0,3,1.75,1230,0,7,1230,0,47.4528,1420
435000.0,3,2.0,1380,0,7,750,630,47.6753,1630
350000.0,2,1.0,740,0,6,740,0,47.5245,1080
206325.0,5,2.5,1720,0,7,1720,0,47.4572,1720
339000.0,5,2.5,1720,0,7,1720,0,47.4572,1720
399000.0,4,2.5,2100,0,7,2100,0,47.5078,1750
529000.0,2,1.0,1210,0,6,900,310,47.6571,1330
640000.0,4,2.5,2210,0,9,2210,0,47.5992,2970
735000.0,4,2.5,2470,0,8,2470,0,47.6765,1270
378000.0,5,2.5,2760,0,8,1600,1160,47.7255,460
775000.0,3,2.0,2540,3,8,1600,940,47.5972,2040
2250000.0,3,4.25,5150,2,11,4170,980,47.6288,4270
1350000.0,4,4.5,3420,0,9,3420,0,47.6875,1360
380000.0,4,2.5,2270,0,8,1540,730,47.7089,2020
624900.0,4,2.5,2270,0,8,1540,730,47.7089,2020
379770.0,3,2.5,1470,0,8,1160,310,47.5472,1470
340000.0,3,1.75,1280,0,8,1030,250,47.7427,1160
515500.0,4,2.75,2830,0,8,2830,0,47.4863,2830
600000.0,4,2.25,1970,0,7,1500,470,47.6725,1980
400000.0,1,1.0,1390,0,6,1390,0,47.7652,1620
364000.0,4,1.0,1020,0,6,1020,0,47.7429,1290
440000.0,4,2.5,2250,0,8,2250,0,47.5123,1980
285000.0,2,1.0,800,0,6,800,0,47.7257,1530
669000.0,3,1.0,1560,0,7,1560,0,47.6204,1530
475000.0,4,2.0,2100,0,7,1050,1050,47.7139,1470
747000.0,2,1.0,990,0,7,990,0,47.6589,1560
317000.0,3,1.5,1060,0,7,1060,0,47.5532,1060
390000.0,2,1.0,1270,0,6,1270,0,47.7116,1580
1070000.0,4,2.5,2740,0,9,2740,0,47.674,1660
1205000.0,4,2.75,2470,3,9,1570,900,47.6586,1620
580000.0,3,1.75,1970,0,7,1130,840,47.6831,1250
518000.0,4,2.5,2070,0,8,1370,700,47.5592,2070
147500.0,3,1.75,1010,0,7,1010,0,47.375,1010
555000.0,4,2.25,2220,0,8,1450,770,47.5429,1980
427500.0,2,2.0,1090,0,8,1090,0,47.6341,1090
1735000.0,3,2.5,4310,4,10,2510,1800,47.7624,3810
265950.0,3,2.5,1490,0,7,1490,0,47.374,2060
247500.0,2,1.0,700,0,6,700,0,47.7172,990
244000.0,4,1.0,1450,0,6,1450,0,47.4972,1160
578550.0,3,2.5,2120,0,8,2120,0,47.5669,2330
451000.0,4,2.5,1670,0,7,1670,0,47.5532,1650
489000.0,2,1.75,1810,0,8,1810,0,47.7177,1350
190000.0,2,1.0,710,0,5,710,0,47.6888,1680
475000.0,3,3.0,2540,0,7,1580,960,47.754,2270
485000.0,3,2.0,1420,0,7,1420,0,47.6872,1420
530000.0,3,2.75,2440,0,8,1840,600,47.5453,2440
379000.0,4,2.5,2570,0,9,2570,0,47.3842,2770
1629000.0,5,2.5,3090,0,9,3090,0,47.6458,3740
739000.0,3,1.75,2050,0,8,1300,750,47.6374,2220
189950.0,3,1.0,920,0,6,920,0,47.3665,920
637500.0,4,3.0,2320,0,8,2160,160,47.546,2330
2225000.0,3,3.0,3450,4,9,1960,1490,47.7067,3220
209950.0,3,1.0,1660,0,7,960,700,47.3212,1370
460000.0,3,1.0,1130,0,6,830,300,47.7132,1050
543500.0,4,2.5,2550,0,8,2550,0,47.5373,2420
376000.0,4,2.75,2420,0,8,2420,0,47.3772,2420
430000.0,3,2.25,1470,0,8,1470,0,47.5478,1380
515000.0,4,2.5,2030,0,7,1530,500,47.4413,2400
580000.0,7,2.75,2310,0,6,2310,0,47.6775,1340
600000.0,5,3.5,3370,1,9,2650,720,47.5584,3330
476800.0,3,1.75,1900,0,6,1900,0,47.7265,2070
815000.0,3,1.5,1940,0,8,1740,200,47.6618,1580
455600.0,3,2.5,2420,0,7,2420,0,47.5382,2420
270000.0,3,1.0,1010,0,7,1010,0,47.4936,1010
1200000.0,5,4.0,2710,0,10,2380,330,47.6346,1530
525000.0,2,1.5,1340,0,7,1340,0,47.6358,1340
242000.0,3,1.75,1310,0,7,1310,0,47.4051,1440
715000.0,4,2.5,2650,0,8,1680,970,47.5535,2650
475000.0,3,2.75,1890,0,8,1890,0,47.5336,1890
370000.0,4,3.0,2580,0,8,2580,0,47.4286,2010
788600.0,4,2.75,3500,0,9,3500,0,47.6818,3920
160000.0,2,1.0,1040,0,6,1040,0,47.3877,910
800000.0,5,1.75,1930,0,7,1930,0,47.6294,1710
520000.0,4,3.0,2190,0,8,2190,0,47.5693,2130
725000.0,3,1.75,1530,0,8,1530,0,47.5239,2140
335000.0,4,1.0,1480,0,7,1480,0,47.5282,2380
919000.0,4,2.5,3620,4,10,2220,1400,47.5604,3530
425000.0,3,2.75,3370,0,9,2650,720,47.3411,2150
420000.0,5,2.5,2100,0,7,1140,960,47.7723,1830
905000.0,4,3.0,3370,0,10,3370,0,47.733,3370
435000.0,2,1.0,2240,0,7,1120,1120,47.5631,1390
438000.0,3,2.5,1650,0,7,1650,0,47.682,1560
725000.0,4,2.75,2630,0,8,2630,0,47.6846,2670
840000.0,4,1.75,2330,0,8,1300,1030,47.666,2040
425500.0,3,2.5,1970,0,8,1970,0,47.6345,1850
853505.0,3,2.5,2820,4,9,1770,1050,47.7019,3740
398000.0,2,1.0,590,0,5,590,0,47.3364,2020
418500.0,3,2.5,2060,0,7,2060,0,47.5415,2060
826000.0,3,1.5,1890,0,9,1890,0,47.6312,2560
742000.0,4,2.5,2810,0,10,2810,0,47.5943,3540
180000.0,4,1.0,1470,0,6,1470,0,47.4336,1770
286000.0,4,1.75,2190,0,8,2190,0,47.3003,2410
421200.0,3,2.5,1440,0,7,1440,0,47.6821,1650
390000.0,3,3.0,2480,0,8,1500,980,47.3778,2480
739000.0,4,2.5,2780,0,9,2780,0,47.5656,2750
499900.0,4,3.0,2180,0,7,2180,0,47.5338,1500
670000.0,3,2.25,3340,0,8,3340,0,47.744,2060
842500.0,3,2.25,2560,0,8,2150,410,47.6321,2970
492500.0,2,2.25,1600,0,7,1600,0,47.4422,1600
836500.0,3,2.5,2230,3,9,2230,0,47.558,2230
334000.0,2,1.0,900,0,7,900,0,47.6485,1570
179900.0,3,1.0,1010,0,6,1010,0,47.3238,1270
563000.0,3,2.0,1580,0,7,870,710,47.6881,1310
310000.0,3,2.5,1890,0,7,1890,0,47.3673,2100
335000.0,4,2.25,2160,0,7,1460,700,47.7595,1880
499950.0,4,2.25,2160,0,7,1460,700,47.7595,1880
658500.0,2,1.0,1410,0,8,1410,0,47.6872,1410
297000.0,2,1.5,1430,0,7,1430,0,47.7222,1430
725000.0,6,1.75,2380,0,8,2380,0,47.6629,2030
780000.0,3,2.25,2206,2,6,866,1340,47.6302,2590
252500.0,3,1.0,1030,0,7,880,150,47.7192,1610
330000.0,3,2.5,1070,0,7,720,350,47.5617,1120
525000.0,3,2.5,2320,0,9,1730,590,47.7394,2450
365000.0,2,1.75,1270,0,7,1270,0,47.6186,1280
500000.0,4,3.0,2570,2,7,2570,0,47.5821,1630
179950.0,3,1.0,920,0,6,920,0,47.3648,960
440000.0,3,2.0,1790,0,7,1790,0,47.4826,2290
145000.0,1,0.75,480,0,4,480,0,47.4982,1550
331000.0,4,3.0,2483,0,8,2483,0,47.3623,2075
780000.0,3,2.25,2140,0,9,2140,0,47.6767,1430
855000.0,3,1.75,1900,0,7,1300,600,47.6854,1880
225000.0,3,2.25,1650,0,8,1290,360,47.3532,1650
199000.0,3,1.0,1510,0,7,1510,0,47.3331,1180
550000.0,3,1.75,2910,0,8,2910,0,47.5747,2590
1425000.0,4,4.25,4960,0,11,3680,1280,47.6437,2160
805000.0,3,2.0,2710,0,8,1880,830,47.6747,2060
261000.0,3,1.5,1810,0,7,950,860,47.3585,1790
347000.0,3,1.0,940,0,7,940,0,47.6889,1430
390000.0,3,2.25,1600,0,7,1090,510,47.7281,1520
436000.0,4,2.5,2640,0,7,2640,0,47.754,2460
1802750.0,5,3.25,3890,0,10,2260,1630,47.6312,3450
557000.0,3,2.5,1630,0,8,1630,0,47.6693,1500
135000.0,3,1.0,830,0,7,830,0,47.3698,1240
425000.0,3,2.5,1800,0,8,1800,0,47.7334,2450
648752.0,3,2.25,2060,0,8,1070,990,47.5767,2340
1388000.0,4,3.0,4040,0,9,2020,2020,47.6408,2990
630100.0,4,2.75,1910,0,7,1160,750,47.6999,1770
739000.0,4,2.5,2800,0,9,2800,0,47.6586,2750
269000.0,3,1.5,1320,0,7,1320,0,47.7316,1230
250000.0,3,1.0,1220,0,6,1220,0,47.496,1140
475000.0,5,2.75,3100,0,7,3100,0,47.5369,2440
290000.0,1,1.0,550,0,6,550,0,47.6846,1100
219000.0,3,1.0,1080,0,7,1080,0,47.3171,1470
416000.0,2,1.0,880,0,6,880,0,47.6914,1250
179000.0,2,1.0,720,0,6,720,0,47.4488,1100
302000.0,4,2.75,2030,0,7,2030,0,47.282,1790
565000.0,4,2.0,2040,1,7,2040,0,47.6689,2560
281700.0,3,1.0,1570,0,7,1070,500,47.3943,2030
480000.0,2,1.0,1500,0,7,1500,0,47.661,2050
775000.0,4,2.5,3180,0,9,3180,0,47.5172,3020
375000.0,3,1.75,1260,0,7,1260,0,47.7444,1570
345000.0,3,1.5,1390,0,7,1390,0,47.4704,1390
300000.0,3,3.0,2850,0,8,2240,610,47.4655,1800
364950.0,4,2.5,2070,0,8,2070,0,47.4496,1900
410000.0,3,3.25,2650,2,8,1760,890,47.4821,2400
231000.0,3,1.75,1220,0,7,1220,0,47.3111,2000
445000.0,3,2.0,1630,0,9,1630,0,47.5168,2250
530000.0,2,2.5,1785,0,7,1595,190,47.5959,1780
353500.0,3,2.5,1260,0,8,840,420,47.5872,1270
209950.0,3,1.5,1380,0,7,1380,0,47.3146,1380
650000.0,3,1.75,2330,0,8,1320,1010,47.565,1820
325000.0,2,1.0,840,0,7,840,0,47.5319,1120
257000.0,3,2.25,1730,0,8,1180,550,47.3823,1870
337000.0,4,2.5,2230,0,7,2230,0,47.3745,1970
541000.0,3,2.5,1790,0,8,1790,0,47.5499,1700
577500.0,3,2.5,2280,0,9,2280,0,47.6217,2400
560000.0,3,2.5,2430,1,8,1270,1160,47.5198,2510
979700.0,5,3.0,3730,0,7,2160,1570,47.6507,1890
750000.0,5,3.0,2230,0,8,1150,1080,47.6154,2040
407500.0,2,1.0,770,2,7,770,0,47.6358,1440
530000.0,4,1.75,1814,0,7,944,870,47.684,1290
235000.0,4,1.75,1920,0,7,1000,920,47.292,1910
715000.0,4,2.5,1860,0,7,1170,690,47.6886,1400
795000.0,5,3.0,2750,0,7,1730,1020,47.5878,2520
465000.0,4,2.5,1930,0,9,1930,0,47.3367,2100
287600.0,3,2.5,1950,0,7,1950,0,47.343,1540
630000.0,6,3.0,2470,0,8,2470,0,47.6025,2470
445000.0,3,2.25,1630,0,7,1310,320,47.7275,1620
490000.0,4,2.25,2110,0,8,1630,480,47.752,2370
565000.0,3,1.75,1490,1,8,1250,240,47.5257,1980
330000.0,3,2.5,1740,0,8,1320,420,47.5248,1740
463000.0,4,2.75,1900,2,7,1300,600,47.495,2230
1870000.0,5,4.0,4510,0,10,4510,0,47.5309,3510
219500.0,3,1.0,1090,0,5,1090,0,47.3066,1170
622200.0,3,1.75,1720,0,7,1420,300,47.7062,1380
474800.0,2,3.25,1400,0,8,1400,0,47.6534,1400
465000.0,4,2.5,2090,0,7,1320,770,47.7467,1850
389950.0,3,1.75,1580,0,8,1580,0,47.7776,2100
650000.0,4,2.5,2620,0,8,2620,0,47.7014,2500
395000.0,3,2.0,1500,0,7,870,630,47.5962,1500
304500.0,4,2.5,2030,0,8,2030,0,47.388,2260
307000.0,3,1.0,1020,0,6,1020,0,47.7719,1180
485000.0,3,2.5,1540,0,7,770,770,47.3729,1000
1562000.0,5,3.0,3910,0,9,2890,1020,47.6326,3620
650500.0,5,4.25,3920,0,7,3920,0,47.5766,1400
960000.0,4,2.5,3180,0,9,3180,0,47.5328,2670
710000.0,3,2.5,2330,0,9,2330,0,47.5467,2460
540000.0,3,2.5,2600,4,8,2150,450,47.4997,1700
601000.0,4,1.75,1950,0,7,1040,910,47.6755,1450
463828.0,5,1.75,3250,2,8,1650,1600,47.4883,2620
293000.0,4,1.0,1130,0,6,1130,0,47.4669,1130
597500.0,3,2.5,2620,0,7,2620,0,47.6849,2400
240000.0,2,1.0,1120,2,5,1120,0,47.5105,2150
284000.0,3,1.75,1800,0,7,1800,0,47.6517,1410
440000.0,4,1.75,2180,2,8,2000,180,47.7638,2590
340000.0,3,1.75,1960,0,7,980,980,47.5208,1070
363000.0,3,1.75,1960,0,7,980,980,47.5208,1070
270000.0,2,1.0,1150,0,6,1150,0,47.5729,1160
365000.0,4,2.5,2800,0,7,2800,0,47.3695,2060
428000.0,3,2.0,1310,0,7,780,530,47.6911,1460
600000.0,3,1.75,2340,0,8,2340,0,47.6989,3260
405000.0,3,2.5,1430,0,7,1430,0,47.7012,1470
339900.0,4,2.5,2340,1,8,1610,730,47.3363,2070
275000.0,3,1.0,1290,0,7,1290,0,47.4743,1410
361600.0,2,1.0,760,0,6,760,0,47.6914,1590
325000.0,6,2.0,2780,0,7,2780,0,47.3738,2120
1050000.0,3,2.0,2090,0,8,1530,560,47.6433,2010
959750.0,4,3.0,3060,2,8,2460,600,47.6205,2740
210000.0,3,1.0,1110,0,7,1110,0,47.5035,1200
258000.0,3,2.0,1790,0,7,1790,0,47.2634,1790
468000.0,3,1.5,1830,0,7,1830,0,47.539,1830
710000.0,4,3.5,2850,2,8,1970,880,47.6855,1460
268000.0,3,1.0,1420,0,6,1420,0,47.4913,1480
115000.0,2,1.0,790,0,5,790,0,47.5048,1260
500000.0,3,2.5,2300,0,8,2300,0,47.7326,2010
431000.0,3,2.5,2440,0,9,2440,0,47.2689,3170
241500.0,3,2.0,1310,0,7,870,440,47.3639,1690
300000.0,3,1.0,1380,0,7,1380,0,47.3997,1890
982000.0,4,2.5,2790,0,9,2790,0,47.5483,2650
248500.0,3,2.5,1360,0,8,1360,0,47.3304,1540
665000.0,4,2.5,2510,0,9,2510,0,47.5847,2760
1215000.0,3,3.0,4560,2,10,4040,520,47.7024,2620
380000.0,2,1.0,780,0,6,780,0,47.566,1500
220000.0,3,2.0,1410,0,7,1410,0,47.4968,1780
631500.0,4,2.0,2530,0,8,1910,620,47.5778,1310
386100.0,3,2.0,1270,0,7,1270,0,47.7381,1550
1050000.0,4,4.5,3180,3,9,1990,1190,47.6402,2110
650000.0,2,1.75,1450,0,7,1350,100,47.6571,1310
545000.0,4,1.75,2040,0,7,1160,880,47.3844,2040
870000.0,4,2.5,2650,0,9,2650,0,47.5496,2880
380000.0,3,1.75,1240,0,7,1240,0,47.7175,1700
265000.0,2,1.0,820,2,6,820,0,47.4741,1960
645500.0,2,1.0,1890,0,7,1890,0,47.6786,1670
570000.0,3,2.0,1270,0,7,1270,0,47.685,1440
1200000.0,4,2.5,3350,2,10,1760,1590,47.5507,4240
605000.0,2,1.0,1550,0,8,1550,0,47.6368,1800
199500.0,3,1.0,920,0,7,920,0,47.2958,1188
445000.0,2,1.0,950,0,6,950,0,47.5864,1420
495000.0,4,1.75,2040,0,7,1020,1020,47.5754,1790
594000.0,4,1.75,1870,0,7,1200,670,47.6843,1790
465000.0,3,1.75,1720,0,8,900,820,47.6493,1600
160000.0,2,1.0,1020,0,6,1020,0,47.2848,980
340000.0,4,2.5,2690,0,9,2690,0,47.3314,2520
870000.0,4,2.0,3090,0,7,3090,0,47.6748,3300
249000.0,3,1.5,1070,0,6,1070,0,47.5335,1020
500000.0,4,2.25,2050,0,8,2050,0,47.7003,1970
220000.0,3,1.5,1660,0,7,1660,0,47.2589,1660
368500.0,5,1.75,2810,0,7,1520,1290,47.4361,1770
439950.0,4,2.25,2460,0,8,1720,740,47.3762,2460
179900.0,3,1.75,1230,0,6,1230,0,47.2878,1550
490000.0,4,2.5,2360,0,8,2360,0,47.7731,2360
425000.0,4,1.75,1730,0,7,980,750,47.5979,2100
533300.0,4,2.5,2770,0,9,2770,0,47.4815,2500
447500.0,4,2.0,1770,0,7,1630,140,47.5563,1640
768000.0,5,2.75,3030,0,8,3030,0,47.6186,2500
285000.0,3,1.75,2380,0,7,1320,1060,47.498,1290
336900.0,3,1.75,1780,0,6,1780,0,47.7731,1440
415000.0,4,1.5,1540,0,7,1540,0,47.734,1550
500000.0,3,2.25,1580,0,8,1580,0,47.5694,1770
337000.0,4,2.5,3200,0,8,3200,0,47.3486,3010
419950.0,4,2.5,2220,0,7,2220,0,47.49,2220
290000.0,4,2.75,2240,0,7,1380,860,47.7427,1550
349950.0,2,1.75,1640,0,7,1040,600,47.5162,1460
330000.0,3,1.5,1170,0,7,1170,0,47.6057,1570
965000.0,4,2.25,3160,0,10,3160,0,47.7337,3530
515000.0,3,2.5,2100,0,8,2100,0,47.7242,2100
665000.0,4,2.5,2600,0,9,2600,0,47.5283,2950
265000.0,3,1.75,1630,0,7,1630,0,47.3816,1540
545400.0,3,2.0,2850,3,8,2340,510,47.3378,2860
350000.0,4,3.0,2560,0,9,2560,0,47.3274,2667
260000.0,2,1.5,980,0,7,840,140,47.7075,1100
2510000.0,3,3.25,5480,4,11,5480,0,47.4558,2500
355000.0,3,2.0,2160,0,8,2160,0,47.3474,2190
879000.0,3,3.0,3030,0,9,2080,950,47.647,1910
833000.0,4,3.5,3560,3,10,2590,970,47.7054,3290
261590.0,2,1.0,760,0,6,760,0,47.4977,1050
512500.0,3,3.0,2260,0,7,2260,0,47.6094,1320
600000.0,2,1.75,1560,0,7,880,680,47.6419,2060
417500.0,5,3.0,2270,0,7,1340,930,47.7191,1870
970000.0,5,3.0,3480,0,8,3480,0,47.5757,3030
316000.0,3,2.25,1900,0,7,1900,0,47.3495,1520
397500.0,4,3.0,2350,0,9,1650,700,47.4194,2440
1350000.0,3,2.5,2390,3,9,1700,690,47.6389,2700
840000.0,4,2.5,3730,0,10,3730,0,47.587,3490
270000.0,2,1.0,1780,3,9,1780,0,47.2712,1780
312900.0,4,2.5,1630,0,7,1630,0,47.3546,1830
325000.0,2,1.0,1130,0,6,1130,0,47.745,1150
680000.0,3,1.75,2140,0,7,1070,1070,47.636,1620
763000.0,4,2.5,3220,0,10,3220,0,47.5849,2610
375000.0,1,1.0,800,0,5,800,0,47.4134,1790
475000.0,3,2.5,1800,0,7,1690,110,47.5491,1570
219000.0,2,2.5,809,0,7,809,0,47.5499,1260
415000.0,3,2.25,1820,0,7,1240,580,47.6157,1820
90000.0,2,1.0,580,0,5,580,0,47.4852,1700
220000.0,2,1.0,580,0,5,580,0,47.4852,1700
616000.0,3,2.0,2900,2,8,1520,1380,47.5789,1810
269500.0,2,1.0,1140,0,6,1140,0,47.2093,1730
395350.0,2,1.0,1060,0,6,1060,0,47.6931,1460
770000.0,4,3.0,2320,0,7,1260,1060,47.5893,1760
840000.0,4,2.5,3450,0,9,3450,0,47.7625,3030
428950.0,2,1.0,1760,0,8,1310,450,47.5311,1350
800000.0,4,3.75,3370,0,9,3370,0,47.7063,3530
401000.0,4,1.0,1940,0,7,1940,0,47.7188,2170
303697.0,4,2.0,2520,0,7,1600,920,47.7263,2040
355000.0,3,1.0,1360,0,7,1360,0,47.7105,1490
350000.0,2,1.0,800,0,6,800,0,47.6953,1020
754999.0,4,2.5,3010,0,10,3010,0,47.578,2840
982218.0,3,1.75,2340,2,9,2340,0,47.6451,2830
406500.0,3,2.0,1780,0,8,1780,0,47.5062,2470
1650000.0,4,3.25,4200,0,10,4200,0,47.5607,2370
565000.0,2,1.75,1720,0,7,860,860,47.686,1360
160000.0,2,1.0,830,0,6,830,0,47.5248,1092
220000.0,3,1.0,1090,0,6,890,200,47.4976,1460
1284000.0,5,4.25,5040,0,11,5040,0,47.5282,4300
970000.0,5,2.75,3500,2,9,2950,550,47.5527,1450
115000.0,3,1.0,1080,0,5,1080,0,47.5045,1070
124000.0,3,1.0,1080,0,5,1080,0,47.5045,1070
157000.0,3,1.0,1080,0,5,1080,0,47.5045,1070
183000.0,3,1.0,870,0,6,870,0,47.3702,870
527000.0,4,2.5,2830,0,9,2830,0,47.5227,2730
407193.0,4,2.0,1880,0,8,1880,0,47.6959,1750
970000.0,4,2.75,3600,0,9,2610,990,47.6487,1590
535000.0,4,2.5,2340,0,7,2340,0,47.5117,1310
245000.0,3,2.0,2040,0,6,810,1230,47.478,1460
337000.0,3,1.75,1310,0,7,1310,0,47.4695,1790
630000.0,3,2.0,1470,0,8,1090,380,47.6829,1880
320000.0,3,1.75,1370,0,7,1370,0,47.2575,1490
228500.0,3,1.0,1080,0,6,990,90,47.4838,1170
293000.0,3,2.5,1990,0,7,1990,0,47.2908,1900
447000.0,3,1.0,1310,0,7,1310,0,47.6019,1280
226500.0,3,1.75,1640,0,7,1130,510,47.3586,1680
436000.0,3,2.25,1770,0,7,1350,420,47.7358,1850
451000.0,3,2.5,2050,0,8,2050,0,47.7746,2320
315000.0,3,1.0,1170,0,5,1170,0,47.5104,1810
450000.0,2,1.0,1340,0,7,1340,0,47.7015,1450
635000.0,3,1.5,2240,0,7,1120,1120,47.6927,1740
292500.0,2,1.0,880,0,5,880,0,47.4115,1217
329900.0,3,2.5,2170,0,8,2170,0,47.3503,2300
531000.0,2,1.5,1260,0,7,1260,0,47.6792,2140
725000.0,3,1.75,1880,0,7,1380,500,47.634,3550
355300.0,3,2.5,1620,0,7,1620,0,47.7708,1450
280000.0,3,2.5,1610,0,7,1610,0,47.2583,1820
1095000.0,4,2.75,3330,0,10,3330,0,47.6821,2390
605004.0,4,2.0,1370,0,9,1370,0,47.6593,2010
260000.0,2,1.0,690,0,6,690,0,47.5621,840
748000.0,4,2.5,3170,0,7,2570,600,47.6655,2060
776000.0,2,2.0,1990,0,7,1010,980,47.6792,1470
425000.0,4,1.0,1080,0,6,1080,0,47.6962,1200
230000.0,4,1.0,1870,0,6,1090,780,47.5274,1650
418000.0,3,1.75,1670,0,7,1370,300,47.7681,1800
440000.0,4,2.5,2800,0,9,2800,0,47.3552,2530
858450.0,5,2.75,3460,0,9,3460,0,47.5908,3390
390000.0,3,2.0,1930,0,7,1930,0,47.4906,1400
957000.0,4,3.0,2370,0,9,1750,620,47.6718,1690
507000.0,3,1.0,1180,0,7,1180,0,47.6853,1680
575000.0,2,1.0,1320,0,7,1320,0,47.6729,1360
700000.0,3,1.75,1350,0,7,1350,0,47.6581,1880
239950.0,2,1.5,1068,0,7,1068,0,47.753,1078
253000.0,3,1.0,1580,0,7,1040,540,47.3542,1480
540000.0,4,1.0,1690,0,7,1690,0,47.663,1970
1550000.0,3,4.0,5120,2,11,4490,630,47.7052,2510
805000.0,4,2.5,3960,0,10,3960,0,47.7249,3290
920000.0,4,3.25,2420,0,9,1870,550,47.6567,1810
496600.0,3,2.5,1910,0,8,1910,0,47.5738,1940
246000.0,3,2.25,1440,0,8,1130,310,47.318,1510
350000.0,5,3.0,2320,0,7,1510,810,47.557,1200
585000.0,3,2.0,1670,0,8,1670,0,47.6854,1480
450000.0,3,1.75,1390,0,7,1390,0,47.7002,1060
746000.0,3,2.5,2620,0,9,2620,0,47.5523,2850
598555.0,3,2.5,3040,0,9,3040,0,47.5277,3040
820000.0,3,2.5,2990,4,9,1560,1430,47.3573,2870
266500.0,3,2.25,1740,0,7,1210,530,47.3648,1740
370000.0,2,1.0,2360,2,6,1180,1180,47.2495,2640
625000.0,3,2.75,2240,0,7,1650,590,47.6244,1716
243500.0,4,2.0,1610,0,7,1610,0,47.3833,1610
340000.0,2,1.0,700,0,6,700,0,47.6958,1160
559950.0,5,3.0,2730,0,8,1670,1060,47.7504,1150
315000.0,3,2.75,1780,0,7,1080,700,47.258,1792
753000.0,3,2.5,3070,0,9,3070,0,47.664,3640
800000.0,3,3.0,2060,0,8,2060,0,47.637,1760
550000.0,3,2.25,1360,0,7,1360,0,47.6988,1900
465000.0,3,2.0,1430,0,7,1430,0,47.701,1530
465000.0,3,2.25,1840,0,7,1840,0,47.7042,1670
710000.0,4,2.25,2000,0,8,2000,0,47.5584,2080
505000.0,3,2.5,1820,0,8,1820,0,47.6358,1860
690000.0,3,1.75,2330,0,9,2330,0,47.7037,2330
217500.0,2,2.0,1070,0,7,1070,0,47.4014,1430
500000.0,2,1.0,930,0,7,930,0,47.6733,1740
325000.0,2,2.0,1040,2,6,1040,0,47.7362,2300
500000.0,4,2.25,1960,0,8,1960,0,47.6276,1960
721500.0,3,3.25,2970,3,9,2040,930,47.5353,2970
924000.0,3,1.5,2200,0,9,2200,0,47.6404,2860
2005000.0,6,4.5,3810,4,10,3810,0,47.7612,3810
345000.0,2,1.5,830,0,8,830,0,47.5926,1130
825000.0,4,3.5,3920,0,10,3920,0,47.5416,3740
560000.0,3,2.0,2870,0,9,1350,1520,47.4834,2870
599000.0,3,2.0,2560,0,8,1330,1230,47.648,2390
211000.0,3,1.5,1350,0,6,1350,0,47.4565,1350
425000.0,4,2.25,1240,0,8,910,330,47.5123,1760
750000.0,4,2.75,3210,2,7,1810,1400,47.7743,2450
479000.0,3,2.5,1690,0,7,1690,0,47.6824,1650
612500.0,4,2.5,2550,0,9,2550,0,47.5695,2750
605000.0,5,1.75,3240,0,7,2690,550,47.5529,2650
1364000.0,4,2.5,3560,0,10,3560,0,47.6903,1660
389900.0,3,2.5,2160,0,7,2160,0,47.3304,2290
710000.0,4,2.5,3060,0,9,3060,0,47.5395,2870
295000.0,3,2.5,1690,0,7,1690,0,47.3518,1690
275250.0,3,2.25,1520,0,7,1520,0,47.3492,1410
250000.0,4,2.5,2040,0,7,2040,0,47.3522,1570
709000.0,3,2.0,2360,0,8,2180,180,47.7133,2600
399500.0,4,1.75,1360,0,7,1360,0,47.556,1320
225000.0,3,2.5,2000,0,7,2000,0,47.3516,1750
500000.0,3,2.5,1650,0,8,1650,0,47.5968,1800
364900.0,3,3.0,2500,0,8,2500,0,47.4022,2290
356000.0,3,1.5,1140,0,7,1140,0,47.619,1380
616750.0,3,1.5,2140,0,9,2140,0,47.5402,1060
755000.0,3,2.75,2870,2,8,2870,0,47.5745,2570
327500.0,2,1.0,830,0,6,830,0,47.7366,1180
605000.0,3,2.25,1960,0,8,1960,0,47.6481,2080
179950.0,4,1.5,1130,0,6,1130,0,47.3616,1140
633000.0,5,2.75,3630,0,11,3630,0,47.4243,3620
349950.0,4,2.0,1764,0,7,1764,0,47.4318,1490
1080000.0,3,2.75,2770,0,8,1650,1120,47.6496,2340
425000.0,3,2.5,2650,0,9,2650,0,47.3185,2920
990000.0,3,2.75,2500,0,9,2370,130,47.6035,2090
410000.0,3,1.0,2710,3,7,2710,0,47.4462,2150
590000.0,3,2.25,2490,0,8,2490,0,47.5666,2690
242000.0,3,1.75,1500,0,7,1500,0,47.3467,1500
775000.0,3,2.0,1160,0,5,580,580,47.585,2961
680000.0,4,1.5,1880,2,8,1440,440,47.5035,2070
217000.0,3,2.5,1340,0,7,1340,0,47.2942,990
395000.0,3,2.5,1960,0,8,1960,0,47.4904,1690
572500.0,3,2.25,2030,0,8,1500,530,47.534,2030
559900.0,5,3.0,2200,0,7,1440,760,47.7033,1960
845000.0,3,2.0,2540,0,9,1840,700,47.6838,2190
241000.0,3,2.0,1520,0,8,1520,0,47.3061,1890
1325000.0,3,2.25,2360,0,8,2080,280,47.617,2840
475000.0,3,1.75,1340,0,7,1340,0,47.5922,1650
575000.0,2,1.5,1400,0,7,1400,0,47.6843,1470
455000.0,4,2.75,3030,0,8,1680,1350,47.401,2060
839000.0,3,2.5,3200,0,10,3200,0,47.7614,3200
475000.0,4,1.5,1580,0,7,1030,550,47.5984,1520
600000.0,2,1.0,2120,0,7,1060,1060,47.5566,1900
515000.0,2,1.0,1640,0,7,1040,600,47.6426,1780
425000.0,3,2.25,1890,0,8,1520,370,47.7103,1830
565000.0,4,2.0,1710,0,7,1710,0,47.6086,1710
498000.0,2,2.0,1140,0,6,1140,0,47.6949,1650
739000.0,4,3.0,2720,0,8,1800,920,47.6756,1940
355000.0,2,1.75,1650,0,7,950,700,47.5622,1060
263000.0,3,1.75,1790,0,8,1330,460,47.3118,1970
375000.0,4,1.75,1680,0,7,1680,0,47.716,950
322000.0,3,1.75,2200,0,7,1250,950,47.5076,2200
325000.0,2,1.0,830,0,6,830,0,47.6932,1050
290000.0,2,1.0,770,0,7,770,0,47.527,1390
809950.0,4,2.5,3280,0,10,3280,0,47.6484,3110
969500.0,3,3.25,2080,2,8,1220,860,47.6051,2680
665000.0,4,2.5,2790,0,9,2790,0,47.7759,2750
635000.0,5,3.5,4150,0,11,4150,0,47.3417,3840
272450.0,3,2.25,1780,0,7,1780,0,47.3593,1510
427000.0,4,1.75,1460,0,7,1460,0,47.6205,1820
261500.0,3,1.0,1410,0,8,1410,0,47.4969,1500
488800.0,4,2.25,2170,0,8,1300,870,47.5444,2170
340000.0,2,1.0,690,0,6,690,0,47.556,1380
398950.0,4,3.0,3000,0,8,3000,0,47.3684,2520
217000.0,3,1.0,870,0,6,870,0,47.3701,1020
799000.0,4,2.5,3170,0,9,1910,1260,47.7648,2590
160000.0,4,1.0,1540,0,6,770,770,47.3318,910
447000.0,3,1.0,1270,0,7,1270,0,47.6703,1560
765000.0,3,1.75,2190,0,8,1480,710,47.5284,2190
1320000.0,4,3.5,4410,0,11,4410,0,47.5487,4760
445000.0,4,2.5,2790,0,9,2480,310,47.4492,2550
310000.0,3,1.0,1510,0,8,1170,340,47.5168,1125
380000.0,2,1.75,1800,3,7,990,810,47.4828,1940
325000.0,4,1.0,2410,0,7,1510,900,47.5692,1880
345000.0,4,2.75,2250,0,8,1480,770,47.4449,2070
300000.0,3,1.0,950,0,6,950,0,47.5236,1080
530000.0,4,1.75,2860,0,8,1710,1150,47.7605,2460
583500.0,4,1.75,2860,0,8,1710,1150,47.7605,2460
410000.0,2,1.0,1560,0,7,1130,430,47.7488,1680
535000.0,2,1.5,1940,0,7,970,970,47.6881,1250
2050000.0,4,3.25,3580,4,7,3480,100,47.7087,2410
345000.0,4,2.5,2040,0,7,2040,0,47.432,1720
539000.0,5,1.0,1700,0,7,1700,0,47.686,1740
590000.0,4,2.5,3700,0,8,1920,1780,47.5403,2020
187000.0,2,1.75,1050,0,8,1050,0,47.3811,1150
270000.0,3,2.0,1690,0,7,1690,0,47.4825,1690
546000.0,2,1.0,1120,0,7,1120,0,47.6824,1420
520000.0,3,1.75,1490,0,10,1090,400,47.6588,1460
515000.0,5,2.0,2220,0,7,1390,830,47.5822,1600
990000.0,3,2.5,2160,0,8,1880,280,47.6582,2300
382000.0,2,1.0,870,0,7,870,0,47.5467,1300
1210000.0,3,1.75,1900,0,8,1900,0,47.6163,2510
900000.0,4,3.5,3370,2,8,2470,900,47.5714,1820
675000.0,3,2.75,3370,1,7,2310,1060,47.5373,1720
460000.0,2,1.0,880,0,7,880,0,47.6566,1960
234000.0,2,1.0,940,0,5,940,0,47.4206,1200
399000.0,3,1.0,1340,0,7,1340,0,47.7148,1340
253500.0,3,1.5,1440,0,7,1440,0,47.3715,1720
475000.0,3,1.5,1750,0,7,1750,0,47.6736,1740
740000.0,5,3.5,3990,0,8,2910,1080,47.54,1310
799000.0,3,2.5,2860,0,8,2860,0,47.661,1440
390000.0,4,2.5,1940,0,8,1940,0,47.4507,1900
421000.0,2,1.5,1400,0,7,1400,0,47.7469,1220
296500.0,3,2.5,1770,0,7,1770,0,47.3764,1590
895000.0,4,2.0,1710,0,8,1710,0,47.6373,1760
386000.0,4,2.5,2810,0,8,2810,0,47.3251,1770
424000.0,3,1.0,1580,0,8,1580,0,47.7552,2130
749000.0,3,1.0,1580,0,7,1580,0,47.684,1280
523000.0,3,1.0,1440,0,7,1440,0,47.6976,1700
389000.0,4,2.5,2420,0,10,2420,0,47.3221,1400
270000.0,4,1.5,1930,0,7,1930,0,47.3864,1620
275000.0,3,1.0,1190,0,7,1190,0,47.4978,1450
287500.0,4,2.5,2240,2,7,1310,930,47.338,1780
345000.0,2,2.5,2550,0,7,2550,0,47.2584,1750
427000.0,2,1.0,920,0,6,920,0,47.6576,1570
508450.0,4,1.75,1520,0,7,1000,520,47.5763,1510
705000.0,3,2.0,1460,0,7,1460,0,47.6693,1690
550000.0,1,1.5,1900,0,9,1450,450,47.4718,2920
380000.0,3,1.5,1430,0,7,1430,0,47.5734,1520
539900.0,3,2.5,2500,0,8,2500,0,47.5346,2460
330000.0,2,1.0,720,0,5,720,0,47.5267,1760
455000.0,2,1.0,1140,0,7,850,290,47.6827,1410
510000.0,4,4.0,3530,0,10,3530,0,47.3016,3360
315000.0,3,2.0,1220,0,6,1220,0,47.4842,1980
206000.0,3,1.0,1320,0,7,1320,0,47.2787,1260
592500.0,4,3.0,2170,0,8,1370,800,47.6291,2020
744000.0,3,2.5,2020,0,8,2020,0,47.6927,2410
334500.0,3,2.5,1990,0,8,1990,0,47.3872,2110
886000.0,4,2.0,2660,0,7,1480,1180,47.6398,2350
600000.0,4,2.5,2360,0,8,1780,580,47.6315,2780
850000.0,3,2.0,2740,2,9,2740,0,47.5056,2140
550000.0,3,1.75,1360,0,7,1000,360,47.5711,1540
184900.0,2,1.0,1230,0,6,1230,0,47.2064,1230
245000.0,3,1.5,1260,0,7,1260,0,47.4307,1510
370000.0,2,1.0,1040,0,7,1040,0,47.6308,3120
480000.0,4,2.5,2700,0,8,1670,1030,47.7752,2470
579000.0,3,1.75,1800,0,7,1800,0,47.6842,1310
339275.0,3,1.5,1590,0,7,1080,510,47.7753,1590
425000.0,3,2.75,1360,2,7,1140,220,47.2069,1700
170000.0,3,1.75,1370,0,7,1370,0,47.4727,1370
950000.0,4,2.5,3320,0,10,3320,0,47.5541,3320
623000.0,4,2.5,2980,0,8,1690,1290,47.5513,2690
477000.0,3,2.5,1350,0,8,1350,0,47.6758,1350
330000.0,3,1.0,1160,0,7,1160,0,47.7419,1160
600000.0,3,2.25,1480,0,8,1480,0,47.6095,1280
570000.0,3,2.0,1640,3,7,820,820,47.5945,2270
515000.0,4,2.5,2680,0,8,2680,0,47.5325,2540
805000.0,4,2.25,2440,0,7,1540,900,47.6932,1710
555000.0,4,2.5,2920,0,9,2920,0,47.381,2760
245000.0,3,2.25,1780,0,7,1780,0,47.3718,1820
638150.0,4,2.5,2170,0,8,1820,350,47.5672,2390
1650000.0,4,4.5,5550,0,9,3880,1670,47.5455,3470
269950.0,4,2.5,2060,0,7,1260,800,47.4229,1610
195000.0,3,1.5,1050,0,6,1050,0,47.3608,1100
159100.0,2,1.0,790,0,6,790,0,47.4928,1150
550000.0,3,1.0,1010,0,6,1010,0,47.6648,1260
299000.0,2,1.0,1040,0,6,1040,0,47.5387,1390
1375000.0,4,3.5,3130,0,9,2060,1070,47.677,1500
249500.0,2,1.0,900,0,6,900,0,47.4881,860
700000.0,4,1.0,1470,0,7,1470,0,47.6458,2160
275000.0,4,1.0,1080,0,5,1080,0,47.3834,1720
565000.0,3,2.25,2440,0,7,1480,960,47.7705,2510
425000.0,4,1.75,2520,0,7,1320,1200,47.7604,1660
620047.0,4,1.75,1760,0,7,880,880,47.6508,2040
480000.0,3,2.25,1820,0,8,1220,600,47.5898,2050
515000.0,3,2.25,1820,0,8,1220,600,47.5898,2050
420000.0,4,2.5,3040,0,8,3040,0,47.2667,2420
610000.0,5,3.25,3490,0,8,1890,1600,47.5701,2660
849000.0,4,1.5,2440,0,8,1440,1000,47.7081,2140
718000.0,3,1.75,2280,0,8,2280,0,47.715,1610
295000.0,3,2.25,1980,0,9,1560,420,47.3149,2360
871000.0,5,1.75,2360,0,7,1180,1180,47.6732,2100
430000.0,3,3.75,3890,2,8,2390,1500,47.5073,1820
440000.0,4,2.5,2300,0,7,1190,1110,47.7341,1960
405000.0,2,1.0,910,0,7,910,0,47.6892,1040
340000.0,3,2.0,1140,0,7,1140,0,47.4991,1140
675000.0,4,2.5,2390,0,9,2390,0,47.6194,2600
480000.0,3,1.0,1150,2,7,1150,0,47.5663,1390
362500.0,5,2.0,2330,0,7,1270,1060,47.7671,1550
752888.0,3,2.5,2420,0,9,2420,0,47.6599,2630
255000.0,4,1.75,960,0,6,580,380,47.5372,1720
283700.0,1,1.75,1010,0,6,1010,0,47.7391,1410
335000.0,4,2.5,2370,0,8,2370,0,47.3732,2190
285000.0,3,1.75,2880,0,8,1580,1300,47.4881,1380
278000.0,4,2.25,2400,0,8,2400,0,47.4562,2170
731000.0,5,2.5,3670,0,8,3670,0,47.6654,2340
335000.0,3,1.5,1140,0,7,840,300,47.4752,1200
334200.0,3,1.75,1410,0,7,1410,0,47.7077,2240
642000.0,6,1.0,1530,0,7,1530,0,47.6862,1530
540000.0,4,1.75,1720,0,7,1460,260,47.579,1930
299000.0,3,2.5,1620,2,6,1620,0,47.2138,1620
560000.0,3,1.75,1570,0,7,970,600,47.5889,1790
852000.0,5,2.75,1990,0,7,1990,0,47.6733,1820
306000.0,2,1.0,930,2,7,930,0,47.5478,1340
440000.0,3,1.75,1550,0,7,1210,340,47.717,1550
517000.0,4,1.0,1650,0,7,1650,0,47.6366,2240
379000.0,2,1.0,800,2,7,800,0,47.691,920
360000.0,2,1.0,930,0,6,930,0,47.5289,1730
645000.0,4,1.5,2550,0,7,1760,790,47.6811,1840
217000.0,2,1.0,720,0,5,720,0,47.496,840
255000.0,2,1.0,620,0,6,620,0,47.5292,620
625000.0,3,2.5,2360,0,10,2360,0,47.5596,2400
680000.0,3,1.75,1760,0,8,1460,300,47.5355,1980
440000.0,3,1.75,2100,0,7,1080,1020,47.7622,2100
615000.0,5,2.25,2480,0,9,2480,0,47.631,2570
239000.0,3,1.0,1040,0,6,1040,0,47.5121,1030
462500.0,3,2.5,1656,0,7,1656,0,47.3758,2030
619400.0,4,2.0,2090,0,7,1790,300,47.6881,1660
975000.0,6,2.75,2520,4,7,2520,0,47.4969,2790
330000.0,2,1.0,700,0,6,700,0,47.5487,1060
985000.0,4,3.25,4030,0,11,4030,0,47.7235,4090
430000.0,2,1.0,760,0,6,760,0,47.7005,780
2458000.0,4,5.25,6500,0,11,5180,1320,47.6304,2270
778000.0,3,2.0,1840,0,7,1720,120,47.6828,1390
219000.0,3,2.0,1090,0,7,1090,0,47.3687,1490
1595000.0,4,2.5,2980,4,8,1800,1180,47.704,2340
715000.0,4,2.25,1900,0,9,1460,440,47.5803,2040
950000.0,4,2.5,2790,0,10,2790,0,47.5477,3520
425000.0,2,1.0,1280,2,8,1020,260,47.6938,1540
239000.0,3,1.0,1510,0,7,1510,0,47.3304,1510
310000.0,1,1.0,920,0,6,920,0,47.761,2260
400000.0,2,1.0,700,0,7,700,0,47.6962,1130
428000.0,2,1.75,1980,1,7,1280,700,47.4193,1680
600000.0,3,1.0,1440,0,8,1440,0,47.6847,1640
415000.0,4,4.0,2740,0,9,2740,0,47.3735,2290
401000.0,2,1.0,1400,0,7,1400,0,47.7228,1760
292000.0,3,1.75,2270,0,7,1370,900,47.4864,1210
291750.0,3,2.25,1310,0,7,1310,0,47.4515,1600
227000.0,3,1.75,1680,0,8,1680,0,47.3112,2040
675000.0,3,2.25,2260,0,9,2260,0,47.6385,2820
397500.0,3,2.25,1350,0,8,1050,300,47.5998,1350
206000.0,2,1.5,1820,0,7,1820,0,47.4764,1430
1190000.0,3,3.5,3380,0,10,2800,580,47.6162,2790
360000.0,4,1.75,2140,0,7,2140,0,47.3583,1720
427500.0,4,2.5,2430,0,8,2430,0,47.5048,2650
115000.0,2,1.0,940,0,6,940,0,47.4907,1310
559000.0,3,1.5,2070,0,7,1140,930,47.6896,1770
420000.0,4,1.0,1510,0,7,1510,0,47.6526,1560
550000.0,4,1.75,2550,0,8,1890,660,47.7707,2560
282150.0,2,1.0,700,0,7,700,0,47.7289,1070
260000.0,3,1.0,1150,0,6,1150,0,47.5506,1150
428000.0,3,2.5,2340,0,7,2340,0,47.5322,1970
319950.0,3,3.25,1510,0,7,1510,0,47.7293,1510
1350000.0,3,2.0,2070,1,7,1590,480,47.616,3000
552000.0,2,1.0,1150,0,7,1050,100,47.6846,1463
637000.0,4,2.75,2190,0,7,1470,720,47.6868,1600
213000.0,4,1.75,1980,0,7,1480,500,47.3071,1980
215000.0,3,1.0,960,0,6,960,0,47.4583,1060
590000.0,3,1.75,2180,2,8,1380,800,47.6501,2020
390000.0,4,2.5,2560,0,8,2560,0,47.3692,2130
287000.0,4,2.25,2270,2,7,1540,730,47.4095,1920
580000.0,5,2.75,3550,0,7,3550,0,47.6766,3370
424000.0,3,2.0,1330,0,8,1330,0,47.5745,1900
610000.0,4,2.5,2110,0,8,2110,0,47.5641,2050
1320000.0,4,3.25,3470,3,11,2270,1200,47.5513,3910
623500.0,4,3.0,1550,0,7,860,690,47.6583,1310
260000.0,2,1.0,570,1,6,570,0,47.4433,2040
906000.0,3,2.5,2030,0,9,2030,0,47.6199,1450
330000.0,3,2.0,1500,0,7,1500,0,47.7279,1580
275000.0,2,1.0,920,0,6,920,0,47.5281,1040
290000.0,3,1.0,1470,0,7,1040,430,47.7347,1420
599950.0,2,1.0,1150,0,7,1150,0,47.6539,2240
550000.0,4,3.0,4180,0,11,4180,0,47.4,3010
289000.0,3,1.75,1690,0,7,1690,0,47.4719,1530
411000.0,4,2.75,2150,0,8,1240,910,47.5378,1980
826000.0,3,3.25,2330,2,10,1730,600,47.5882,2080
400000.0,4,2.0,2680,2,7,2350,330,47.4887,1430
342000.0,3,2.5,1740,0,8,1320,420,47.525,1740
475000.0,2,1.75,1320,1,7,1080,240,47.6639,2070
1205000.0,4,3.5,3150,0,9,3150,0,47.6644,1550
455000.0,4,3.0,2480,0,7,2050,430,47.4701,1820
850000.0,4,3.0,3330,0,8,1790,1540,47.6559,1610
185000.0,3,1.0,1010,0,7,1010,0,47.3027,1820
850000.0,6,3.25,4920,3,9,2730,2190,47.5468,3700
239900.0,4,1.75,1570,0,7,1200,370,47.3999,1920
765000.0,5,3.75,3580,0,10,3190,390,47.5322,2740
437000.0,3,1.75,2220,0,8,2220,0,47.749,2070
240000.0,3,1.5,1010,0,7,1010,0,47.379,1640
395000.0,2,1.0,1440,0,7,860,580,47.7431,1550
320000.0,3,1.0,1230,0,7,1230,0,47.7633,1710
525000.0,3,1.75,1710,0,8,1280,430,47.699,2100
260000.0,3,3.0,2390,0,8,1680,710,47.3532,1820
450000.0,3,2.75,2840,0,9,2200,640,47.3076,2840
560000.0,4,2.5,2300,0,9,2300,0,47.6273,2280
310000.0,5,3.0,2270,0,7,1360,910,47.5539,1950
440000.0,3,2.5,2290,0,9,2290,0,47.435,2700
458450.0,4,1.0,1330,0,7,970,360,47.6038,1590
200000.0,3,1.0,1200,0,7,1200,0,47.5209,1380
430000.0,3,2.25,2160,0,7,1580,580,47.7292,1950
360000.0,3,1.0,1120,0,7,1120,0,47.7267,1320
311000.0,4,2.5,2090,0,7,1200,890,47.4759,1450
615000.0,3,3.25,1470,0,8,1470,0,47.6516,1470
575000.0,3,1.75,2270,0,8,2270,0,47.535,2260
2027000.0,4,3.75,4100,3,11,2540,1560,47.5648,3880
430000.0,3,1.75,1440,0,6,720,720,47.567,1500
400000.0,3,1.5,1200,0,7,1200,0,47.6084,1510
340000.0,3,1.75,1720,0,7,860,860,47.5092,1480
351000.0,1,0.75,930,0,6,930,0,47.7127,1590
440000.0,4,2.5,2400,0,8,2400,0,47.4881,2040
298000.0,4,2.5,1960,0,8,1960,0,47.3293,2360
300000.0,4,1.75,1890,0,8,1260,630,47.774,1430
310000.0,3,2.25,1590,0,7,1590,0,47.5432,1540
500000.0,4,2.5,2590,0,9,2590,0,47.7703,2730
399900.0,3,1.0,860,0,7,860,0,47.6761,1540
343000.0,3,2.5,1270,0,8,1270,0,47.5357,1420
415000.0,2,2.25,1130,0,8,1130,0,47.6861,1140
410000.0,3,2.5,1860,0,8,1860,0,47.7383,2040
320000.0,2,1.0,1802,0,7,1802,0,47.7205,1810
1990000.0,5,3.0,4480,0,12,3420,1060,47.6275,3220
253000.0,2,1.0,1310,0,7,940,370,47.3958,1400
630000.0,3,2.5,2320,0,9,2320,0,47.6304,2610
216000.0,2,1.0,1130,0,7,1130,0,47.4514,1270
540000.0,3,2.5,2180,0,8,1230,950,47.717,1930
212000.0,3,1.5,1830,0,5,1830,0,47.2057,1520
300000.0,3,2.75,2340,2,8,1470,870,47.7379,2640
969950.0,3,2.5,2830,0,10,2830,0,47.6798,1780
715000.0,3,1.0,1610,0,6,900,710,47.6038,1940
1321620.0,5,2.75,2410,2,10,2290,120,47.5549,2980
1444000.0,4,2.75,2660,1,8,1930,730,47.616,2410
305000.0,3,1.0,1030,0,7,1030,0,47.4905,1030
458000.0,3,4.0,1390,0,9,1150,240,47.671,1620
275000.0,3,1.75,1580,0,6,1220,360,47.4845,1180
550000.0,3,2.75,2330,3,8,1730,600,47.3459,1100
742000.0,3,3.25,1540,0,9,1540,0,47.6177,1540
700000.0,3,1.0,1570,0,8,1570,0,47.6575,1640
640000.0,4,3.0,2940,0,8,1640,1300,47.5589,2020
352000.0,3,0.75,1240,0,7,1240,0,47.7298,1210
301500.0,3,1.0,1410,0,7,1050,360,47.534,1800
630000.0,4,2.5,2190,0,8,1410,780,47.6926,2190
340000.0,3,2.5,3040,0,7,3040,0,47.3817,2670
477500.0,4,1.75,1860,0,7,1080,780,47.731,1800
285000.0,3,2.5,1690,0,7,870,820,47.4964,1900
255000.0,3,2.75,1900,0,7,1900,0,47.3144,1640
315000.0,3,2.5,1600,0,8,1600,0,47.3397,1890
830000.0,6,3.0,2530,0,6,2530,0,47.6716,1886
539950.0,3,2.25,1860,0,8,1860,0,47.7006,1760
980000.0,3,2.25,2390,0,8,2090,300,47.6615,2280
735000.0,4,2.5,3100,0,9,3100,0,47.6252,2710
536000.0,5,2.25,2650,1,8,1350,1300,47.7772,2700
575000.0,3,2.0,1520,0,7,1140,380,47.6733,1530
500000.0,2,1.0,1510,0,6,930,580,47.6917,1300
285500.0,4,1.75,1960,0,8,1960,0,47.3109,1960
498000.0,4,2.75,2270,0,7,1290,980,47.7222,1750
412000.0,2,1.0,910,0,7,910,0,47.6967,970
607000.0,4,2.5,2100,0,8,1300,800,47.6733,2160
199000.0,3,1.0,1000,0,6,1000,0,47.2151,1490
492500.0,4,2.75,2760,0,7,1630,1130,47.7302,2470
585000.0,4,2.5,2840,0,8,2840,0,47.7134,1934
326995.0,3,2.5,1860,0,7,1860,0,47.3848,1940
372500.0,4,2.25,1920,0,8,1920,0,47.4544,1890
528000.0,2,0.75,840,4,6,840,0,47.404,1850
400000.0,3,1.5,2390,0,7,2390,0,47.3028,1370
344000.0,4,2.5,2100,0,7,2100,0,47.1951,2130
409950.0,4,3.0,2430,0,8,2430,0,47.3558,2430
625000.0,3,2.0,1880,2,8,1280,600,47.6375,1920
304950.0,3,1.75,1350,0,7,1350,0,47.4487,1370
381500.0,2,2.0,2160,0,9,2160,0,47.312,2450
215000.0,3,1.75,1430,0,7,900,530,47.4787,1720
345000.0,5,1.75,2840,2,7,2840,0,47.4961,2170
363000.0,3,0.75,2510,0,7,2510,0,47.2871,2130
240000.0,3,1.0,1690,0,7,1690,0,47.3556,1700
548050.0,2,2.0,1930,0,8,1930,0,47.7054,1900
314000.0,2,1.0,720,0,6,720,0,47.5352,670
800000.0,4,2.5,2990,0,11,2990,0,47.7123,3340
400000.0,5,1.75,2300,0,7,2300,0,47.528,1200
247000.0,1,1.0,460,0,4,460,0,47.4868,990
540000.0,2,1.75,1240,0,7,890,350,47.6689,1640
410000.0,4,2.5,1900,0,8,1900,0,47.5015,1900
525000.0,3,1.75,2120,0,8,1260,860,47.6475,2040
820000.0,4,2.5,2440,0,8,1700,740,47.6472,2020
1250000.0,4,2.25,3300,3,8,2820,480,47.526,3250
244000.0,2,1.0,1180,0,7,1180,0,47.4358,1330
275000.0,1,1.0,520,0,5,520,0,47.5533,800
577000.0,2,1.75,2070,0,7,1260,810,47.6551,1690
446950.0,5,2.5,2250,0,7,1360,890,47.7316,1820
457000.0,3,2.5,2050,2,8,2050,0,47.5331,2680
320000.0,4,1.5,1310,0,7,1310,0,47.362,1310
210000.0,3,1.5,1250,0,7,1250,0,47.3675,1320
220000.0,4,2.5,2130,0,8,1290,840,47.3815,1770
589000.0,3,2.0,2250,0,7,1250,1000,47.5737,2250
435000.0,4,2.0,1880,0,7,970,910,47.5929,1670
375000.0,3,1.0,1520,0,7,1520,0,47.7635,1670
1735000.0,4,3.5,4010,0,10,4010,0,47.5891,1870
545000.0,2,1.75,1660,0,8,1660,0,47.713,1670
970000.0,3,2.25,3400,0,10,3400,0,47.6846,1860
705000.0,2,1.75,2320,0,8,1380,940,47.6398,1990
915557.0,5,3.25,3740,0,9,2540,1200,47.5599,2920
259000.0,4,1.5,1810,0,7,1810,0,47.4911,1520
1695000.0,2,2.25,3170,2,10,1990,1180,47.6291,2980
427000.0,3,1.75,1680,0,7,1290,390,47.7246,1640
390000.0,2,1.0,930,0,6,930,0,47.5943,1670
363000.0,3,2.5,2390,0,8,2390,0,47.3895,2070
612000.0,4,2.5,2680,3,7,1680,1000,47.6727,1950
380000.0,4,1.75,1790,0,8,1790,0,47.7769,1790
230000.0,4,3.0,1680,0,7,1150,530,47.2885,1820
580000.0,3,1.75,1570,0,8,1570,0,47.6867,1490
770000.0,3,1.0,2230,2,8,1630,600,47.6334,2280
207200.0,4,2.0,1260,0,6,1260,0,47.1946,1120
525000.0,3,2.0,1790,0,7,1190,600,47.6319,1700
925000.0,3,2.5,2440,0,7,1520,920,47.6857,2440
883000.0,4,2.25,2410,0,8,1650,760,47.6727,1820
455000.0,4,2.5,1780,0,7,1780,0,47.7633,1610
343500.0,3,2.5,1900,0,7,1900,0,47.4391,2230
244000.0,2,1.0,960,0,6,960,0,47.755,1090
397000.0,3,1.75,1640,0,7,1640,0,47.7351,1640
180500.0,2,1.0,850,0,6,850,0,47.3817,1160
310000.0,3,2.75,2150,0,7,1900,250,47.7539,2150
315000.0,4,2.5,2780,0,7,2780,0,47.3992,2260
718000.0,3,1.0,1030,0,7,1030,0,47.6647,2230
279950.0,3,1.75,1930,0,7,1330,600,47.3217,1600
689000.0,3,2.5,2080,3,8,1700,380,47.7293,2560
828000.0,4,2.5,3520,0,10,3520,0,47.6084,3490
150000.0,2,1.0,890,0,6,890,0,47.4839,1260
505400.0,3,1.75,1640,0,7,930,710,47.6694,1380
1680000.0,5,3.25,4860,2,11,3820,1040,47.5767,4040
217450.0,3,1.0,1040,0,7,1040,0,47.5122,1440
677000.0,4,2.5,2820,0,9,2820,0,47.7112,2560
361000.0,2,2.5,1320,0,8,1320,0,47.5157,1830
620000.0,3,2.5,2590,0,8,2590,0,47.7113,1670
176000.0,3,2.25,1540,0,7,1180,360,47.29,1460
330000.0,3,1.0,960,0,7,960,0,47.7278,1580
290000.0,3,2.5,1190,0,7,1190,0,47.4556,2230
711000.0,4,2.5,2770,0,9,2770,0,47.5688,2770
295000.0,3,1.75,1060,0,7,1060,0,47.3617,1410
1096500.0,5,3.25,4010,0,11,4010,0,47.5228,4010
257500.0,3,2.0,1140,0,7,1140,0,47.4057,1460
240000.0,4,1.0,1910,0,6,1910,0,47.5151,1380
645000.0,4,2.5,2340,0,9,2340,0,47.6283,2340
499000.0,2,1.75,1170,0,7,740,430,47.6653,1570
321000.0,3,1.0,1290,0,7,1290,0,47.7111,1290
449000.0,3,2.5,1810,0,8,1810,0,47.6955,1470
515000.0,3,2.5,1820,0,7,910,910,47.6892,1600
456000.0,4,1.5,2220,0,8,1270,950,47.6734,2030
865000.0,3,3.75,3830,0,9,3830,0,47.5432,2440
515500.0,4,2.5,2920,0,9,2920,0,47.7351,2920
576925.0,4,2.5,2630,0,8,2630,0,47.7735,2360
243000.0,3,1.75,1320,0,7,1320,0,47.3902,1670
253400.0,3,2.0,1400,0,7,1400,0,47.3182,1270
292000.0,3,2.5,1600,0,7,1600,0,47.4939,2020
271500.0,3,2.5,1490,0,7,1090,400,47.4359,1880
765000.0,2,2.5,2170,0,8,2170,0,47.7115,2150
375000.0,3,3.25,1280,0,8,1090,190,47.7032,1280
382880.0,3,2.0,1620,0,7,1620,0,47.474,1660
852500.0,3,2.5,2630,0,9,1580,1050,47.5638,2400
475000.0,3,1.5,1240,0,7,1240,0,47.5849,1440
462000.0,3,1.75,1300,0,7,820,480,47.674,1180
762400.0,3,1.75,2430,1,8,1230,1200,47.5588,2750
330000.0,4,1.5,1890,0,7,1890,0,47.7534,1890
473000.0,3,2.25,1890,0,8,1890,0,47.6232,2390
550000.0,3,1.5,2440,0,7,2440,0,47.5604,1920
449500.0,3,2.25,1780,2,7,1340,440,47.723,2060
744000.0,4,2.75,2830,0,10,2830,0,47.595,3840
700000.0,4,2.0,2490,0,7,1690,800,47.5254,2240
511100.0,4,2.5,1560,0,7,1560,0,47.5287,1920
317950.0,3,2.5,1980,0,7,1980,0,47.3671,2200
542950.0,3,2.5,2070,0,8,2070,0,47.7696,2740
490000.0,3,1.75,1490,0,8,1490,0,47.5896,2350
760000.0,4,3.5,3090,0,8,2420,670,47.5733,1720
475000.0,3,2.25,1580,0,7,1220,360,47.7599,1970
1702500.0,5,4.5,5190,2,11,3390,1800,47.5846,4460
435000.0,3,2.75,2692,0,9,2692,0,47.3569,2336
399000.0,3,2.5,1740,0,8,1740,0,47.5345,2100
627000.0,3,2.0,1940,0,7,1050,890,47.6842,1700
346500.0,4,2.5,2150,0,7,1290,860,47.5338,1920
412000.0,3,1.5,1320,0,7,1320,0,47.6027,1720
845000.0,4,2.5,3360,0,10,3360,0,47.742,3150
373000.0,3,1.75,1850,0,7,1100,750,47.7358,1480
725000.0,4,2.25,2880,0,8,2480,400,47.6999,2460
376000.0,6,2.5,2420,2,7,1420,1000,47.4459,1630
552500.0,3,1.0,2020,0,7,1520,500,47.5514,1200
365000.0,5,2.0,2280,0,6,2280,0,47.4683,1790
700000.0,4,2.5,3010,0,9,3010,0,47.6471,2590
315000.0,4,2.25,2550,0,8,2550,0,47.3193,1770
262500.0,4,2.0,1540,0,7,1540,0,47.5164,1540
660000.0,3,2.25,2280,2,8,2280,0,47.5423,1920
340000.0,4,2.5,2450,0,7,2450,0,47.4006,3300
660500.0,5,2.5,2950,0,7,1720,1230,47.5785,2200
280000.0,1,1.0,690,0,6,690,0,47.6849,1650
267000.0,1,1.0,800,0,6,800,0,47.5581,1490
230000.0,2,1.0,1470,0,4,1470,0,47.4878,1670
417000.0,3,2.25,1840,0,8,1840,0,47.4862,2150
252000.0,3,1.0,1170,0,7,1170,0,47.4562,1680
791000.0,5,1.75,2344,0,7,1544,800,47.6537,1770
415000.0,1,1.0,1230,0,6,830,400,47.6886,1300
339000.0,3,1.75,1150,0,7,1150,0,47.6384,1560
158000.0,3,1.0,1140,0,6,1140,0,47.4874,1190
535000.0,3,1.0,1660,0,7,1260,400,47.5323,1230
818900.0,3,1.0,1080,0,7,980,100,47.6771,1280
550000.0,4,2.0,1720,0,7,1420,300,47.6651,1350
240000.0,2,1.0,590,0,6,590,0,47.7343,1370
590000.0,3,3.25,1290,2,9,1090,200,47.6367,1710
369300.0,3,1.5,1480,0,7,1480,0,47.5234,1850
510000.0,4,2.5,2600,0,7,1400,1200,47.54,2440
542500.0,3,2.5,2040,0,8,2040,0,47.679,1940
262500.0,3,1.0,970,0,7,970,0,47.4899,1480
900000.0,6,3.0,2620,0,7,1760,860,47.678,1760
1100000.0,4,3.5,4560,0,9,4170,390,47.5589,2990
368000.0,3,1.75,1750,0,7,1750,0,47.4535,2030
825000.0,4,3.5,3620,0,9,3620,0,47.7326,2330
343500.0,3,2.0,1660,0,7,1660,0,47.4872,2380
273500.0,4,1.0,1360,0,6,1020,340,47.4783,1230
1000000.0,3,2.5,2044,0,9,2044,0,47.6791,2440
770000.0,5,3.0,2370,2,8,1340,1030,47.6645,1350
400000.0,3,2.0,1170,0,7,1170,0,47.5543,1400
225000.0,3,1.0,1660,0,7,1100,560,47.3394,1660
345000.0,4,1.0,2020,0,7,2020,0,47.739,1530
450000.0,3,2.5,2530,0,8,2530,0,47.7597,2280
334850.0,2,1.0,870,0,7,870,0,47.5676,1310
605000.0,5,3.0,3670,1,8,1980,1690,47.5648,1730
760000.0,5,3.5,3180,0,10,3180,0,47.5501,3670
390000.0,2,1.5,1870,0,6,1350,520,47.5234,1380
488000.0,3,2.5,1940,0,8,1940,0,47.7511,2110
3300000.0,3,3.25,4220,4,11,2460,1760,47.6083,3810
1063000.0,5,4.5,4820,0,11,3950,870,47.7295,3880
608000.0,3,2.0,2400,0,8,1590,810,47.4166,2340
1385000.0,3,2.25,2930,2,11,1920,1010,47.6301,1870
299950.0,2,1.0,800,0,6,800,0,47.5602,1640
818000.0,3,3.25,2200,2,7,1910,290,47.6551,1410
355000.0,3,2.5,2400,0,9,2400,0,47.3081,2400
1855000.0,5,3.25,5570,0,9,3860,1710,47.6708,3170
660000.0,3,3.25,1980,0,7,1980,0,47.6597,1630
2367000.0,3,2.25,3530,3,9,1840,1690,47.5358,3530
1211000.0,4,2.5,3430,0,10,3430,0,47.6484,3920
255950.0,3,2.5,1720,0,7,1720,0,47.4039,1720
475000.0,3,1.5,1930,0,7,1500,430,47.634,1230
362950.0,4,1.75,2140,0,7,1140,1000,47.4235,1830
452000.0,3,1.75,1110,0,7,1110,0,47.6563,1800
315000.0,3,1.75,1970,0,7,1270,700,47.4731,1890
330950.0,3,2.5,1630,0,7,1630,0,47.5413,1610
535000.0,5,2.25,2520,0,8,2520,0,47.4918,2780
479000.0,4,2.25,2270,0,7,1520,750,47.5007,1770
340000.0,3,2.5,1212,0,7,1212,0,47.7145,1256
312000.0,4,2.0,1890,0,7,1890,0,47.4377,1600
305000.0,3,2.25,1370,0,7,1370,0,47.3504,1370
270000.0,3,2.5,1770,0,7,1770,0,47.3639,1770
529999.0,3,2.5,1710,0,8,1300,410,47.6456,1470
587100.0,2,1.0,1190,0,7,1190,0,47.5896,1700
459800.0,3,2.0,1690,0,7,1690,0,47.6359,1280
451000.0,4,1.75,1680,0,7,1330,350,47.6286,1680
2475000.0,3,3.25,4340,3,11,3060,1280,47.6709,1680
525000.0,3,2.25,2040,2,7,2040,0,47.2328,2020
250000.0,2,1.0,1110,0,6,1110,0,47.4711,2240
475000.0,5,2.0,2040,0,7,2040,0,47.5503,1870
235000.0,4,1.5,1920,0,7,1920,0,47.2858,1400
230000.0,3,1.5,1330,0,7,1330,0,47.3675,1420
581000.0,4,1.0,1630,0,7,1630,0,47.6183,1220
415000.0,3,1.0,1520,0,7,1520,0,47.587,1470
522500.0,3,1.0,1520,0,7,1520,0,47.587,1470
383000.0,3,1.5,1340,0,8,1340,0,47.5389,1990
315000.0,3,1.75,2500,0,7,1250,1250,47.4973,1710
591000.0,3,2.0,1460,0,7,1460,0,47.6123,1590
750000.0,4,2.25,3140,0,9,3140,0,47.6361,2370
430000.0,3,1.75,2150,0,7,1200,950,47.5537,1480
712000.0,4,2.5,3140,0,10,3140,0,47.7412,2340
510000.0,3,2.5,2310,0,8,1340,970,47.7677,2660
480000.0,2,1.0,710,0,6,710,0,47.6212,1480
538000.0,3,1.0,1460,0,7,1260,200,47.6875,1430
464000.0,2,2.75,730,0,7,730,0,47.5381,980
476000.0,3,2.5,1440,0,7,1440,0,47.6873,1600
349500.0,3,2.0,1130,0,7,1130,0,47.7489,1600
270000.0,3,2.25,1810,0,8,1810,0,47.2994,1820
740000.0,3,2.5,2710,2,10,2000,710,47.7256,2710
395000.0,4,2.5,2740,0,9,2740,0,47.3904,2460
498000.0,3,2.5,1690,0,7,1690,0,47.6779,1950
339900.0,3,2.5,1470,0,7,1470,0,47.5261,1500
539000.0,3,2.5,2830,0,9,2830,0,47.7382,3557
400000.0,3,1.0,1410,0,8,1140,270,47.6203,1910
225000.0,3,2.5,2170,0,7,1410,760,47.4342,1860
330000.0,3,2.25,1340,0,6,1170,170,47.5722,1670
1387800.0,3,3.0,2480,3,10,1730,750,47.6466,2950
490000.0,3,2.75,1990,0,8,1990,0,47.5544,3120
260000.0,4,2.75,2240,0,7,1140,1100,47.3357,1580
469900.0,4,2.5,2990,0,9,2990,0,47.4353,2740
493000.0,6,1.75,2120,0,7,1220,900,47.6832,1850
740000.0,4,2.25,2920,0,9,2920,0,47.569,2310
148900.0,4,1.75,1700,0,7,1700,0,47.3252,1280
475000.0,2,2.5,1620,0,7,1620,0,47.6306,1470
415000.0,2,1.0,760,0,7,760,0,47.6896,1520
229500.0,3,1.0,1230,0,7,1230,0,47.3256,1240
1355000.0,5,3.75,4960,2,11,3760,1200,47.5491,5200
385000.0,4,2.5,2030,0,7,1330,700,47.7765,1500
230000.0,3,2.25,1830,0,7,1250,580,47.2899,2240
425000.0,2,1.0,970,0,7,770,200,47.6852,1570
189900.0,2,1.0,1000,0,5,1000,0,47.297,1010
238000.0,2,1.0,750,0,6,750,0,47.5195,1050
968060.0,4,2.5,2620,2,7,1570,1050,47.6623,3050
921000.0,4,1.5,2220,0,7,1490,730,47.6233,1800
380000.0,5,1.75,3000,0,7,1500,1500,47.492,2230
285000.0,1,1.0,1060,4,5,1060,0,47.4716,2258
449000.0,4,2.5,1980,0,8,1980,0,47.5182,1980
625000.0,4,1.0,1600,0,7,1600,0,47.6983,1900
318989.0,4,2.25,2000,0,8,2000,0,47.3125,2190
445000.0,3,1.5,1310,0,8,1120,190,47.5663,1310
750000.0,3,1.0,1120,0,7,1120,0,47.6294,1440
959000.0,3,2.5,3320,0,10,3320,0,47.7212,3730
330000.0,3,2.5,2370,0,9,2370,0,47.3067,2530
425000.0,2,1.5,830,0,7,830,0,47.6363,1610
280000.0,3,1.0,940,0,6,940,0,47.7657,940
476500.0,4,2.5,2250,0,8,2250,0,47.449,2040
556000.0,3,2.25,2020,0,8,2020,0,47.6678,2070
1862000.0,4,5.25,5240,2,10,5240,0,47.5605,1930
637000.0,4,3.5,4083,0,10,4083,0,47.3114,2430
405000.0,3,2.0,1450,0,7,1450,0,47.7522,1880
397000.0,5,1.0,1170,0,6,800,370,47.7332,1590
895990.0,4,2.75,3555,0,9,3555,0,47.6847,3625
259000.0,3,2.0,1610,0,7,1610,0,47.7704,2410
420000.0,2,1.0,960,0,7,960,0,47.7642,1210
518000.0,3,2.5,1680,0,8,1380,300,47.6904,1360
425000.0,3,1.75,1380,0,7,1380,0,47.7513,1300
182500.0,2,1.0,1040,0,6,1040,0,47.3756,1100
549900.0,3,1.5,1380,0,7,1380,0,47.6889,1440
445000.0,3,1.75,1850,0,7,1280,570,47.7166,1790
452000.0,2,1.75,1740,0,7,990,750,47.6971,1980
715000.0,5,1.75,1920,0,7,1260,660,47.6394,1970
559000.0,3,2.5,2010,0,8,2010,0,47.7142,1860
3300000.0,5,6.25,8020,0,11,8020,0,47.5675,4160
250000.0,4,1.75,1860,0,7,1090,770,47.3979,1710
1230000.0,5,4.0,4390,0,9,2930,1460,47.648,1560
276500.0,4,2.25,2380,0,7,2380,0,47.4253,1030
440000.0,4,2.5,2880,0,9,2880,0,47.4397,2420
543200.0,6,2.25,2820,2,7,1970,850,47.4635,2520
250000.0,1,1.0,750,0,6,750,0,47.5243,1770
625000.0,4,2.5,1750,0,8,1410,340,47.6403,2120
530100.0,3,1.0,1540,0,7,1200,340,47.6853,1500
549900.0,2,1.75,1140,0,8,940,200,47.6647,1160
430000.0,4,1.5,1560,0,7,1560,0,47.6012,1560
835000.0,3,2.5,2960,0,10,2960,0,47.5906,3320
409500.0,4,2.75,2140,0,7,1320,820,47.7683,2360
329000.0,4,2.5,1600,0,7,830,770,47.5469,1600
940000.0,4,2.75,2080,0,8,2080,0,47.6737,1730
539950.0,3,2.0,1560,0,7,1560,0,47.6398,1240
579950.0,4,2.5,2880,0,8,2140,740,47.2887,2810
881000.0,5,3.0,2510,3,8,1590,920,47.5968,2190
362500.0,3,1.0,960,0,6,960,0,47.6997,1550
243950.0,2,1.0,1120,0,6,1120,0,47.2411,1680
658000.0,4,2.75,3310,0,9,3310,0,47.521,3200
218250.0,3,1.5,1080,0,7,1080,0,47.3155,1190
655000.0,4,2.5,2860,0,10,2860,0,47.5832,3070
255000.0,3,2.0,1490,0,7,1490,0,47.3687,1560
215000.0,3,1.0,1210,0,7,1210,0,47.5339,1640
1265000.0,3,1.75,2240,2,8,1910,330,47.6621,2970
2920000.0,4,4.75,4575,2,10,3905,670,47.6263,3900
424305.0,3,2.5,1600,2,8,1600,0,47.4758,1410
494000.0,4,1.75,2090,0,7,1250,840,47.5555,1670
560000.0,4,2.5,2260,0,9,2260,0,47.7247,2260
130000.0,3,1.0,1200,0,7,1200,0,47.5883,3290
468000.0,4,2.5,2480,3,8,2480,0,47.1941,1640
480000.0,5,3.0,2240,1,7,1390,850,47.7426,2240
475000.0,3,1.75,1550,0,7,1550,0,47.6743,1510
285000.0,4,1.75,2130,0,7,1330,800,47.3932,1600
765000.0,5,3.0,2870,0,7,1950,920,47.6621,1730
208000.0,2,1.0,1160,0,6,1160,0,47.5322,1160
372000.0,3,2.5,2430,0,8,2430,0,47.3786,2910
470000.0,2,1.0,900,0,7,900,0,47.6877,1270
451000.0,5,2.75,2830,0,7,2830,0,47.731,1700
442200.0,4,1.75,1620,0,8,1620,0,47.6788,1920
330000.0,4,2.5,2510,0,8,2510,0,47.295,2290
335000.0,3,1.75,1790,0,6,940,850,47.5277,1160
280000.0,3,2.0,1640,0,7,1640,0,47.3589,1640
625000.0,3,1.75,2240,0,8,1250,990,47.5658,1720
345000.0,3,2.5,1870,0,8,1870,0,47.4521,1900
255950.0,4,1.0,1500,0,7,1500,0,47.4509,1970
570000.0,4,1.0,1490,0,7,1490,0,47.5518,1700
685000.0,3,1.5,2230,0,8,2230,0,47.5833,2200
273148.0,3,1.75,1710,0,7,1240,470,47.4094,1840
246500.0,3,2.5,1620,0,7,1620,0,47.3613,1370
349950.0,5,2.5,2250,0,7,1310,940,47.4486,1550
545000.0,4,2.0,1700,0,6,850,850,47.6865,1600
403000.0,3,2.5,1502,0,7,1502,0,47.6951,1377
299950.0,4,2.5,1900,0,7,1900,0,47.3767,2520
792000.0,3,2.5,3320,0,10,2600,720,47.5783,3230
418000.0,5,2.5,1980,0,7,1080,900,47.699,1310
332500.0,4,1.0,1670,0,6,1670,0,47.4692,1310
337000.0,3,2.5,2235,0,7,990,1245,47.3326,1460
212000.0,2,1.0,1070,0,6,1070,0,47.5434,1330
542000.0,2,2.25,1800,2,9,1800,0,47.6104,1800
622500.0,4,2.5,2980,0,9,2980,0,47.5389,2750
260000.0,3,1.75,1670,0,7,1340,330,47.3257,1580
525000.0,3,1.75,2620,0,8,1320,1300,47.4619,2170
975000.0,5,3.5,5470,0,11,4590,880,47.6368,3600
1140000.0,4,1.75,3080,0,9,1700,1380,47.6353,2960
500000.0,3,1.0,940,0,7,940,0,47.688,2019
554000.0,5,2.25,1870,0,8,1170,700,47.7445,2420
343000.0,4,2.5,2070,0,7,2070,0,47.3497,2760
515000.0,2,1.75,950,0,8,950,0,47.7723,1560
492000.0,2,1.0,1290,0,6,890,400,47.6777,1260
655000.0,4,3.0,2570,0,8,1370,1200,47.6956,2090
290000.0,3,2.5,1600,0,7,1600,0,47.3303,1700
952500.0,4,1.5,2550,0,10,2550,0,47.636,1970
235000.0,2,1.0,1010,0,7,1010,0,47.5283,1220
323000.0,3,1.5,1720,0,8,1720,0,47.5417,1730
1050000.0,3,2.5,2200,0,9,1610,590,47.6426,1890
265000.0,0,0.75,384,0,4,384,0,47.4177,1920
200000.0,2,1.0,1400,0,6,1400,0,47.2113,1230
419995.0,3,2.25,1830,0,7,1330,500,47.7574,1830
1500000.0,3,3.0,3110,4,10,1590,1520,47.6624,3150
455000.0,3,2.5,1600,0,7,1600,0,47.7288,1580
660000.0,3,3.5,3600,0,8,3600,0,47.6982,2050
319000.0,3,1.0,1390,0,7,1390,0,47.7438,1390
390000.0,3,1.75,2092,0,7,2092,0,47.2664,2092
718500.0,3,1.5,1200,0,8,1030,170,47.6222,2810
474000.0,2,1.0,1090,0,7,840,250,47.6385,1070
615750.0,4,2.0,2140,0,7,1840,300,47.687,1690
551000.0,3,2.5,2010,0,8,2010,0,47.6904,1920
230000.0,3,2.25,1500,0,7,1150,350,47.3124,1500
790000.0,4,2.5,3500,0,9,3500,0,47.6785,3990
1230000.0,3,2.5,2660,3,9,1870,790,47.6264,1640
325000.0,3,2.25,1440,0,7,1440,0,47.7471,1700
705000.0,4,2.75,2780,0,8,2780,0,47.6867,2660
259000.0,4,1.75,1580,0,7,1580,0,47.4694,1390
306000.0,3,1.5,1250,0,7,1250,0,47.4744,1300
315000.0,3,1.0,970,0,6,970,0,47.5476,1160
392500.0,3,1.0,1100,0,7,1100,0,47.7219,1430
1065000.0,4,2.25,3240,0,9,2730,510,47.5373,2610
350500.0,2,2.5,1290,0,8,1290,0,47.6955,1470
825000.0,4,3.5,3810,0,9,3810,0,47.5018,1950
235000.0,4,1.0,1500,0,6,1500,0,47.4979,1190
650000.0,3,2.0,2660,2,8,1530,1130,47.553,1710
675000.0,4,3.0,2400,0,7,1200,1200,47.6646,1520
265000.0,4,1.0,1860,0,7,1860,0,47.4406,1560
822500.0,2,1.0,1450,4,7,1450,0,47.63,2390
705000.0,3,2.75,2260,0,8,1540,720,47.6435,2120
2630000.0,6,4.75,5540,2,11,3950,1590,47.6361,2930
685000.0,2,1.5,1300,2,7,1300,0,47.6133,1260
630000.0,4,2.0,1610,0,7,1610,0,47.6775,1300
1250000.0,4,3.25,3820,1,11,3310,510,47.5263,2900
359000.0,4,2.5,1820,0,8,1390,430,47.4574,1990
784500.0,4,5.0,5820,0,11,3750,2070,47.3814,2980
850000.0,3,2.0,2470,0,9,2470,0,47.5753,2340
410000.0,3,2.5,3040,0,9,3040,0,47.3508,2650
252000.0,4,1.75,1120,0,7,1120,0,47.4555,1330
618000.0,5,1.75,1880,0,7,1880,0,47.6059,2180
265000.0,3,1.0,1070,0,6,970,100,47.5187,1120
465000.0,3,2.0,1560,0,8,790,770,47.7261,1410
240000.0,2,1.0,870,0,6,870,0,47.7188,1500
217000.0,3,1.0,1000,0,7,1000,0,47.3321,1490
415000.0,4,2.25,2520,0,7,1510,1010,47.5814,1460
274000.0,2,2.0,1700,0,7,950,750,47.3031,1700
420000.0,5,3.0,2150,0,7,1370,780,47.538,1990
1062500.0,4,2.75,1590,0,8,1590,0,47.6401,1590
1415000.0,4,5.25,4670,0,12,4670,0,47.5456,4900
618500.0,3,2.0,1800,0,7,1080,720,47.6738,1800
295000.0,3,1.5,1670,0,8,1670,0,47.2004,1670
400000.0,3,2.0,1010,0,8,1010,0,47.6224,1840
595000.0,3,2.5,2550,0,8,2550,0,47.7336,1930
1728000.0,4,3.0,3700,0,10,1850,1850,47.6212,3080
261000.0,3,1.75,1350,0,7,1350,0,47.3617,1370
780000.0,5,2.5,1660,0,8,1660,0,47.6452,1210
589000.0,3,1.5,1390,0,7,1090,300,47.6611,1910
230000.0,3,1.75,1720,0,7,1140,580,47.3173,1120
690000.0,4,3.5,2980,0,10,2490,490,47.5463,2880
524000.0,4,2.25,2190,0,8,2190,0,47.6299,2090
380000.0,2,2.5,1230,0,7,1060,170,47.6007,1290
357500.0,3,1.0,1000,0,7,740,260,47.5351,1480
330000.0,3,2.0,2500,0,8,2500,0,47.1927,2560
635000.0,5,1.75,2240,0,7,1120,1120,47.6727,1980
934000.0,9,3.0,2820,0,7,1880,940,47.6654,2460
358500.0,2,1.75,1400,0,8,1110,290,47.5478,1380
401000.0,3,1.5,1470,0,8,1470,0,47.7495,1470
270000.0,3,2.0,1820,0,8,1820,0,47.3169,2080
705000.0,4,2.0,2060,1,8,1370,690,47.5237,2060
325000.0,3,2.0,1670,0,7,1100,570,47.69,1660
384950.0,3,1.0,1540,0,7,1540,0,47.522,1220
310000.0,3,1.0,1210,0,7,1210,0,47.762,1470
829950.0,4,2.5,3430,0,10,3430,0,47.765,3190
353000.0,3,2.5,2550,0,7,2550,0,47.3828,2080
170500.0,2,1.0,1060,0,7,820,240,47.4599,1370
885250.0,4,2.5,3670,0,10,3670,0,47.6219,3040
2700000.0,4,3.25,4420,4,11,3150,1270,47.572,2760
245000.0,3,1.5,1550,0,7,1550,0,47.2012,1450
469000.0,3,2.5,1190,0,8,1190,0,47.6762,1410
455000.0,3,1.0,1300,0,7,1300,0,47.6696,1410
305000.0,4,2.5,2430,0,8,2430,0,47.3348,2100
840000.0,7,4.5,4290,0,10,4290,0,47.4812,2810
905000.0,5,3.5,3500,0,10,2570,930,47.5415,2940
219200.0,3,2.0,1680,0,7,1680,0,47.2775,1540
455000.0,3,1.5,1250,0,7,1250,0,47.6285,1450
195000.0,2,1.0,1020,0,6,1020,0,47.4971,1200
799000.0,3,1.0,1510,0,8,1510,0,47.6849,2140
285000.0,2,1.0,910,0,6,910,0,47.7399,1240
300000.0,3,1.5,1320,0,7,1320,0,47.7405,1250
83000.0,2,1.0,900,0,5,900,0,47.4727,2060
220000.0,2,1.0,890,0,7,890,0,47.7027,1010
174500.0,2,2.5,1240,0,7,1240,0,47.3236,1430
695000.0,4,2.5,2960,0,9,2960,0,47.5677,2480
255000.0,3,1.5,1020,0,7,1020,0,47.4811,1290
539000.0,5,2.25,2590,0,8,1510,1080,47.6398,1930
552700.0,2,1.0,1100,0,7,1100,0,47.6361,1110
571500.0,3,1.0,1300,0,6,1300,0,47.5851,1630
263700.0,3,1.0,1200,0,6,1200,0,47.7763,1340
3300000.0,8,4.0,7710,0,12,6090,1620,47.6263,4210
186950.0,2,2.0,1390,0,7,1390,0,47.3089,1390
520000.0,3,1.75,1430,0,8,1430,0,47.5577,2100
358000.0,3,1.5,1250,0,7,1250,0,47.7298,1340
210000.0,2,0.75,840,0,6,840,0,47.4727,1240
3650000.0,5,3.75,5020,1,12,3970,1050,47.6146,4190
543000.0,4,2.25,2060,0,8,2060,0,47.7228,1610
330000.0,4,2.25,2000,0,7,1350,650,47.4238,1650
529000.0,3,2.0,1530,0,7,990,540,47.6204,1880
295000.0,1,1.0,700,0,7,700,0,47.5662,1340
365000.0,3,1.0,950,0,7,950,0,47.6884,1610
473000.0,3,3.0,1380,0,8,1380,0,47.6692,1390
403500.0,3,1.0,1830,0,8,1200,630,47.7259,1860
544000.0,3,1.5,1790,1,7,1790,0,47.5768,1960
621000.0,3,1.0,1340,0,7,1340,0,47.6652,1510
672600.0,3,2.25,1520,0,8,1400,120,47.5787,1420
689800.0,2,1.75,1370,0,7,1090,280,47.6492,1730
613000.0,3,1.5,1470,0,7,1130,340,47.6693,2120
808000.0,4,2.25,2500,0,9,2500,0,47.6604,2630
301000.0,3,1.0,1060,0,7,1060,0,47.7465,1900
340000.0,3,1.75,1210,0,7,1210,0,47.7382,1550
206000.0,3,1.0,920,0,7,920,0,47.3771,1260
550000.0,3,1.5,1340,0,7,1340,0,47.5866,1590
325000.0,2,1.0,960,0,6,960,0,47.5752,1440
475000.0,3,2.5,1630,0,8,1630,0,47.5689,2090
432100.0,3,1.75,1840,0,8,1310,530,47.7089,1860
359000.0,3,2.0,3085,0,7,1560,1525,47.4956,1480
490000.0,3,1.0,920,0,6,780,140,47.6937,1370
648360.0,4,1.75,2260,1,7,1130,1130,47.6895,2330
340000.0,3,1.75,1730,3,6,1730,0,47.3595,2490
545000.0,3,2.0,1610,0,7,1090,520,47.5754,1510
115000.0,2,0.75,550,0,5,550,0,47.511,1330
705640.0,3,2.25,2400,0,8,1420,980,47.6533,2615
300000.0,3,2.25,1960,0,7,1750,210,47.5414,1760
1650000.0,4,2.75,3190,3,9,1940,1250,47.6178,2600
1137500.0,4,3.5,3160,4,8,2180,980,47.5963,2180
280000.0,3,1.75,1550,0,7,1550,0,47.4951,1250
245000.0,4,1.75,1930,0,8,1280,650,47.3078,1860
564000.0,4,1.0,1170,0,7,1170,0,47.6804,1430
849000.0,3,1.75,2520,0,9,1460,1060,47.6381,1870
698000.0,3,1.75,1220,0,7,1220,0,47.6886,1340
319000.0,3,1.0,960,0,7,960,0,47.7245,1320
1450000.0,3,3.5,4110,1,10,2230,1880,47.6996,2500
695000.0,4,3.5,3310,0,9,2400,910,47.5197,2260
680000.0,4,2.75,2220,0,7,1170,1050,47.5801,1540
287500.0,4,2.25,2250,0,8,2250,0,47.3715,2140
465000.0,3,3.25,1510,2,8,1230,280,47.6683,1540
335000.0,3,1.0,1350,0,6,1350,0,47.6606,1520
602000.0,4,1.75,2420,0,8,1880,540,47.6688,2780
482000.0,3,2.5,2950,0,8,2950,0,47.4828,2400
220000.0,5,1.0,1260,0,7,1260,0,47.5058,910
206000.0,4,2.0,1700,0,6,1700,0,47.3029,1320
1100000.0,4,3.0,3320,0,9,2120,1200,47.6474,2400
491150.0,3,2.5,1470,0,7,1470,0,47.6816,1650
390000.0,4,2.75,2500,1,8,2120,380,47.3364,2370
393000.0,4,2.5,2641,0,7,2641,0,47.4043,2641
635000.0,4,2.0,2260,0,9,2260,0,47.6251,2410
490000.0,2,1.0,1160,0,8,1160,0,47.6865,1750
770000.0,4,3.5,3680,0,9,2670,1010,47.6192,1350
665000.0,2,2.0,1615,0,8,1615,0,47.6886,1470
287000.0,3,1.0,1250,0,7,1250,0,47.426,1530
410000.0,3,1.0,1230,0,7,1090,140,47.5719,1390
562000.0,3,2.0,2510,0,8,1470,1040,47.5631,990
475000.0,2,2.0,1540,0,7,1540,0,47.638,2280
387500.0,3,3.25,1860,0,8,1860,0,47.7185,1860
580000.0,5,2.0,2700,0,7,1540,1160,47.6163,2040
930000.0,3,2.5,3290,0,10,3290,0,47.6702,3200
625000.0,3,1.75,2700,0,7,2110,590,47.3397,2260
325000.0,3,2.0,1570,0,8,1570,0,47.4286,2010
235000.0,3,1.75,1950,0,7,1950,0,47.4391,1820
450000.0,2,1.0,1380,0,8,880,500,47.6947,1390
745000.0,4,2.75,2410,0,8,2070,340,47.5651,1960
223000.0,4,2.0,1200,0,7,1200,0,47.3262,1110
630000.0,4,1.75,1770,0,7,1350,420,47.7004,1670
413450.0,3,2.5,1540,0,8,1470,70,47.6961,1540
720000.0,5,2.75,2860,0,9,2860,0,47.7082,2980
339000.0,3,1.5,1740,0,7,1740,0,47.3644,1400
1115500.0,4,3.5,2830,0,7,1840,990,47.5842,2340
839000.0,5,4.0,4280,0,10,2710,1570,47.5503,3080
2950000.0,4,3.25,3890,3,10,3030,860,47.6608,4140
568000.0,4,2.0,2340,0,7,1170,1170,47.5905,2470
269000.0,3,2.0,1410,0,7,1410,0,47.3642,1660
382000.0,2,2.0,1350,0,8,1350,0,47.6338,1800
574000.0,2,2.25,1100,0,8,900,200,47.6199,1230
405000.0,3,2.5,2070,0,7,2070,0,47.5307,2230
572000.0,3,2.5,2360,0,8,1690,670,47.5374,2280
675000.0,4,2.25,2760,0,9,2760,0,47.6285,2850
165000.0,4,1.0,1220,0,6,1220,0,47.4924,1210
260000.0,4,1.0,1220,0,6,1220,0,47.4924,1210
196000.0,3,1.0,1220,0,6,1220,0,47.4187,1580
515000.0,3,2.5,3020,0,8,3020,0,47.744,2980
810000.0,4,3.5,3470,3,8,2520,950,47.7146,2360
365650.0,4,2.25,2380,0,8,2380,0,47.4391,2100
651000.0,3,3.0,2260,0,8,1660,600,47.6111,2260
240000.0,2,1.0,720,0,6,720,0,47.5201,720
299000.0,3,2.0,1730,0,8,1730,0,47.3573,2000
768000.0,3,2.5,2660,0,9,1830,830,47.5442,2800
397380.0,2,1.0,1030,0,6,1030,0,47.6962,1220
476000.0,4,3.0,2890,0,7,1590,1300,47.6763,2180
315000.0,3,1.0,890,0,7,890,0,47.559,1420
240000.0,3,2.25,1410,0,7,940,470,47.5396,1550
325000.0,2,1.0,810,0,6,810,0,47.5337,1400
160000.0,3,1.75,1370,0,7,1370,0,47.258,1530
435000.0,3,2.5,2260,0,8,2260,0,47.7341,2260
427500.0,3,1.75,1430,0,7,1430,0,47.5223,1690
450000.0,5,2.5,2510,0,8,1410,1100,47.4732,2170
688000.0,3,1.5,1760,3,8,1290,470,47.5334,1840
285000.0,4,1.0,1430,0,6,980,450,47.5343,1170
530000.0,3,3.25,1510,0,8,1510,0,47.6711,1390
195000.0,4,1.75,1320,0,7,1320,0,47.4297,1620
250200.0,3,1.5,1180,0,7,1180,0,47.3838,1150
1100000.0,3,2.25,1560,0,7,1080,480,47.6155,2660
732500.0,3,2.5,2470,0,9,2470,0,47.6694,2450
194250.0,3,2.25,2190,0,7,1390,800,47.2633,1490
526000.0,4,2.0,1610,0,7,1190,420,47.6301,1560
520000.0,4,2.75,2700,0,7,2700,0,47.7671,2250
526000.0,3,1.75,1530,0,7,1120,410,47.5687,1360
1135250.0,5,4.0,7320,0,11,7320,0,47.4473,3270
202000.0,2,1.0,920,0,6,920,0,47.4951,1280
645500.0,4,2.5,2990,0,9,2990,0,47.5394,2980
570000.0,1,1.0,720,4,6,720,0,47.3509,1120
325000.0,3,2.0,1750,0,5,1750,0,47.7489,1830
725000.0,2,1.0,2410,0,9,1930,480,47.5657,1540
192000.0,3,1.75,1240,0,6,1240,0,47.37,1240
560000.0,2,1.0,1010,0,7,1010,0,47.6886,1610
283450.0,5,2.75,2770,0,7,1490,1280,47.4847,1920
863000.0,4,1.75,2800,0,9,1400,1400,47.6803,1490
815000.0,4,2.0,1400,0,7,1400,0,47.6168,1620
245000.0,2,1.0,1020,0,6,1020,0,47.4915,1280
1315000.0,4,3.0,2860,0,8,2860,0,47.6286,1840
1156000.0,4,3.5,4270,2,10,4270,0,47.5489,4190
480000.0,3,2.5,2270,0,7,2270,0,47.5329,2360
600000.0,4,2.5,2560,0,7,2560,0,47.6886,2800
329950.0,2,1.0,900,0,6,900,0,47.5105,1480
299500.0,4,2.5,2010,0,8,2010,0,47.3406,1910
460000.0,3,2.5,1690,0,7,1690,0,47.5234,860
515000.0,5,3.5,2310,0,8,1560,750,47.5463,1900
405000.0,3,2.25,1520,0,8,1520,0,47.6907,1520
483000.0,4,1.5,1220,0,7,1220,0,47.6667,1400
377000.0,4,2.5,2170,0,8,2170,0,47.3886,1900
568000.0,4,1.75,2790,2,7,1450,1340,47.4556,2790
355000.0,2,1.75,1760,0,7,850,910,47.5654,1150
640000.0,4,1.75,2100,0,7,1500,600,47.6721,1690
270000.0,4,1.0,1430,0,6,1070,360,47.7623,1460
559950.0,5,3.5,2450,0,9,2450,0,47.7721,2310
515000.0,4,3.0,1820,0,7,1420,400,47.7197,1920
352000.0,4,1.75,1850,0,7,1850,0,47.6966,1510
595888.0,3,1.75,1870,0,9,1870,0,47.7203,2030
588000.0,4,2.25,2580,0,8,2580,0,47.5647,2390
1050000.0,4,3.25,3680,3,10,1840,1840,47.5266,2700
260000.0,3,1.5,1750,0,8,1750,0,47.3108,1840
1600000.0,4,3.5,3890,0,9,2860,1030,47.6342,2460
380000.0,2,1.0,1000,0,6,1000,0,47.6926,1000
802000.0,2,2.5,2210,0,8,2210,0,47.7114,2170
1325000.0,4,3.25,2850,0,10,2700,150,47.6292,2850
710000.0,4,2.75,2460,0,8,1640,820,47.6093,1890
600000.0,3,2.5,2630,0,9,2630,0,47.745,2250
707900.0,3,1.0,1750,0,7,1750,0,47.6792,2240
179950.0,2,1.0,1100,0,7,780,320,47.2874,1410
683000.0,4,2.5,2620,0,9,2620,0,47.6732,2430
222400.0,3,2.0,1200,0,7,1200,0,47.2649,1590
517000.0,2,1.5,1920,0,7,960,960,47.6118,1130
410000.0,3,2.75,1690,0,7,1180,510,47.7336,1560
480000.0,3,1.75,1680,0,7,840,840,47.6848,1220
430000.0,3,1.75,3440,0,8,3440,0,47.449,2160
439950.0,5,1.75,2190,0,7,1290,900,47.7766,1790
797500.0,4,2.5,3270,0,10,3270,0,47.6018,3460
379000.0,4,1.5,1280,0,7,1080,200,47.5348,1470
575000.0,1,1.0,1310,0,6,1310,0,47.6059,1130
247500.0,3,1.0,1660,0,7,1110,550,47.3311,1890
385000.0,4,2.75,2700,0,9,2700,0,47.3496,2700
423000.0,4,1.75,1940,0,7,970,970,47.7108,1460
550000.0,3,1.75,1520,0,7,1170,350,47.68,1550
415000.0,4,1.0,1620,0,7,1620,0,47.5728,1220
693000.0,3,2.25,2090,2,8,1280,810,47.5538,3090
543000.0,2,1.0,1070,0,7,1070,0,47.6887,1370
465000.0,5,1.75,2000,2,7,1200,800,47.5084,2340
280000.0,3,2.5,1020,0,7,720,300,47.5343,1060
1388000.0,3,1.25,2400,2,11,2400,0,47.6019,1910
665000.0,6,3.0,2480,0,8,2480,0,47.6127,2480
237950.0,3,1.75,1310,0,6,1310,0,47.2888,1010
440000.0,4,2.75,2420,0,8,1220,1200,47.72,2240
618000.0,2,1.0,1890,0,7,1030,860,47.6747,2150
572000.0,3,2.25,1860,0,7,1020,840,47.5539,1180
725000.0,3,1.5,2500,2,7,1450,1050,47.6567,1300
454000.0,3,1.0,1970,0,7,1970,0,47.5234,1970
535000.0,4,1.0,1660,0,7,1180,480,47.5391,1120
249000.0,3,2.5,1850,0,7,1500,350,47.3063,2140
395000.0,4,2.75,1970,0,8,1970,0,47.4375,1970
690000.0,3,2.0,1890,3,8,1890,0,47.7016,2590
526500.0,3,1.5,1310,0,7,1170,140,47.6944,1680
325000.0,4,1.5,1870,0,7,1870,0,47.77,1550
495000.0,3,3.0,1520,0,7,1520,0,47.572,1320
825000.0,5,3.0,3070,0,9,3070,0,47.6852,3070
383000.0,3,1.5,1400,0,7,1400,0,47.4471,1350
320000.0,3,1.75,1960,0,7,980,980,47.5432,1460
475000.0,3,2.5,2680,0,7,1340,1340,47.5646,2580
275000.0,3,2.5,2030,0,7,2030,0,47.3491,1810
1150000.0,2,2.25,2320,4,9,1920,400,47.681,2790
455000.0,3,1.75,1760,0,8,1760,0,47.7616,2220
262000.0,5,1.0,1870,0,7,1580,290,47.5127,1740
390000.0,4,1.0,1280,0,7,940,340,47.5477,1360
300000.0,3,2.25,1730,0,8,1730,0,47.3108,2090
746300.0,3,1.75,2060,2,9,1140,920,47.5268,2060
267000.0,3,1.5,1030,0,7,1030,0,47.4282,1460
525000.0,3,2.5,1720,0,7,1720,0,47.7178,1790
570000.0,3,1.75,1210,0,7,1210,0,47.7,1610
360000.0,4,2.25,2620,0,7,1550,1070,47.4564,1650
1052000.0,3,1.0,1860,0,6,1860,0,47.6057,2000
699950.0,3,2.5,2510,0,9,2510,0,47.5494,2470
375000.0,4,2.5,2040,0,8,2040,0,47.4193,2370
625000.0,4,1.75,2410,0,7,1220,1190,47.6946,1440
464050.0,2,1.0,780,0,7,780,0,47.5842,1320
470000.0,5,2.5,2210,0,8,1460,750,47.7698,2080
330000.0,4,2.0,1590,0,7,1040,550,47.4465,1670
537000.0,4,1.75,2230,0,7,2230,0,47.5859,2230
250000.0,3,2.0,1560,0,7,910,650,47.3197,1470
835000.0,4,2.5,2950,0,10,2950,0,47.5938,2870
770000.0,4,1.0,1480,0,7,1480,0,47.6737,1570
650000.0,4,2.0,2850,1,7,1730,1120,47.5876,2450
335000.0,3,1.75,2390,0,7,1560,830,47.4789,1750
350000.0,3,1.75,1740,0,7,1740,0,47.481,1560
415000.0,5,2.75,2060,0,7,1220,840,47.5358,1840
788000.0,4,2.5,2680,0,8,2680,0,47.5516,2680
640000.0,4,2.75,3150,0,7,2430,720,47.6968,1990
388000.0,4,2.5,2440,0,8,2440,0,47.4501,2450
360000.0,6,1.75,2230,0,7,1390,840,47.7089,2110
692500.0,6,1.75,2230,0,7,1390,840,47.7089,2110
425000.0,4,1.5,1600,0,6,1600,0,47.5681,1410
645000.0,4,1.5,1600,0,6,1600,0,47.5681,1410
340000.0,3,1.0,1580,0,7,1580,0,47.5075,1200
713000.0,4,3.25,2840,0,8,2840,0,47.6707,2550
430000.0,3,2.75,2550,0,8,2550,0,47.7351,1020
280000.0,3,2.25,1700,0,7,1250,450,47.3546,2070
215000.0,3,2.0,1470,0,7,1470,0,47.3084,1390
306000.0,3,2.5,1680,0,8,1680,0,47.4482,2080
299900.0,3,1.0,1110,0,7,1110,0,47.7595,1780
534000.0,5,1.75,2120,0,7,1200,920,47.6118,1930
1160000.0,3,2.75,2380,4,9,1930,450,47.6626,3370
1165000.0,3,2.5,2670,3,9,2000,670,47.5855,2320
199990.0,2,1.0,890,0,6,890,0,47.2003,1460
946000.0,4,3.0,3140,0,9,2140,1000,47.5462,2760
295000.0,4,1.0,1260,0,7,1260,0,47.7334,1639
475000.0,2,1.0,920,0,6,920,0,47.5499,1700
750000.0,5,3.5,2990,0,8,2450,540,47.5298,1060
1225000.0,4,2.5,3120,4,9,2590,530,47.3535,2030
183500.0,3,1.0,1010,0,6,1010,0,47.2699,1370
450000.0,2,1.0,1010,2,6,1010,0,47.5873,1630
180000.0,3,1.0,1020,0,7,1020,0,47.5502,1160
707000.0,5,4.5,3540,0,8,2940,600,47.4274,1290
230000.0,2,0.75,900,0,6,900,0,47.5083,1220
192500.0,3,1.0,1100,0,7,1100,0,47.3248,1190
309000.0,3,2.5,1990,0,7,1990,0,47.36,1980
759000.0,3,1.5,1980,0,8,1520,460,47.6499,2280
1115000.0,4,3.75,4040,0,11,4040,0,47.5189,3940
462000.0,5,1.75,1250,0,7,1250,0,47.6101,1560
229000.0,4,1.5,1820,0,7,1820,0,47.7321,1770
399950.0,2,2.25,1140,0,8,1010,130,47.659,1140
325000.0,5,2.0,1730,0,5,1730,0,47.5076,1940
512000.0,2,2.25,1170,0,8,1170,0,47.6712,1310
410000.0,5,2.75,2910,0,7,2910,0,47.3591,2910
210000.0,2,1.0,970,0,7,970,0,47.556,1180
325000.0,4,2.25,2130,0,7,1600,530,47.3657,1890
685000.0,3,2.5,2520,0,8,1630,890,47.5652,2220
488000.0,2,2.0,1360,0,7,780,580,47.6874,1340
247500.0,3,2.25,1620,0,7,1280,340,47.2835,1710
489000.0,4,2.0,2120,0,7,1060,1060,47.7084,1540
725000.0,4,1.75,2700,0,8,1450,1250,47.6539,2080
199950.0,3,1.5,1370,0,6,1370,0,47.4731,1370
670000.0,5,3.0,2520,1,8,2010,510,47.6385,2170
275000.0,3,2.0,1540,0,7,1540,0,47.3662,1590
1000000.0,3,1.75,2610,2,8,2130,480,47.6287,3010
255000.0,3,2.0,1490,0,7,1490,0,47.3962,1350
465000.0,3,1.75,2760,0,7,1380,1380,47.6079,1980
259000.0,3,1.75,1260,0,7,1260,0,47.3612,1430
695000.0,3,3.5,2630,2,9,2030,600,47.5473,2450
505000.0,3,1.75,1800,0,7,1370,430,47.7346,1820
631500.0,2,1.0,1130,0,8,1130,0,47.6438,1680
630500.0,3,1.0,1180,0,7,1180,0,47.6337,1900
999000.0,4,2.75,2800,0,10,2800,0,47.5911,2010
740000.0,3,1.5,1830,0,7,1350,480,47.6453,1570
650000.0,3,2.5,2220,0,8,1660,560,47.6974,950
554000.0,2,2.0,1870,0,8,1870,0,47.7101,1670
400000.0,3,2.5,2580,0,8,2580,0,47.6465,2580
529941.0,3,2.0,1660,0,7,1010,650,47.5852,2020
310000.0,3,1.0,1330,0,6,1330,0,47.5502,1330
389000.0,3,1.0,1330,0,6,1330,0,47.5502,1330
731781.0,3,3.0,2630,0,9,2630,0,47.693,2880
502501.0,2,1.0,1100,0,7,1100,0,47.5772,1830
443000.0,3,1.75,1810,0,7,1810,0,47.6236,1680
607000.0,3,2.0,2060,0,7,1060,1000,47.574,1400
2147500.0,3,3.5,4660,4,10,3040,1620,47.6465,2980
585000.0,4,2.5,2370,0,8,1660,710,47.6295,2360
1027000.0,3,2.5,2430,1,9,2430,0,47.5818,3440
315000.0,3,2.5,1880,0,8,1880,0,47.4206,1880
180000.0,2,1.0,1150,0,6,1150,0,47.4989,1150
322500.0,3,2.0,1350,0,7,1350,0,47.7315,2100
568500.0,3,2.75,2180,0,7,1310,870,47.6959,1510
813000.0,4,2.75,3370,3,8,1920,1450,47.5887,2250
1085000.0,5,2.25,3650,0,10,1850,1800,47.5458,2760
424000.0,4,2.0,2100,0,8,2100,0,47.7521,1450
235000.0,2,1.0,670,0,6,670,0,47.5498,1960
740000.0,3,3.5,2420,0,9,1820,600,47.6054,2030
415000.0,1,1.0,760,0,7,760,0,47.6059,1270
432000.0,3,2.75,2200,0,6,1100,1100,47.6606,1520
1268890.0,5,3.25,4410,2,12,3880,530,47.7522,4410
676500.0,3,1.75,1300,3,8,880,420,47.6071,2440
419000.0,2,1.0,720,0,6,720,0,47.6534,1030
650000.0,3,2.5,2180,0,9,2180,0,47.722,2880
239000.0,2,1.0,1130,0,7,1130,0,47.3902,1490
900000.0,4,2.5,2230,0,8,1540,690,47.6698,2020
330000.0,5,1.75,2100,0,7,1070,1030,47.7751,2170
510000.0,3,1.75,2060,4,8,1100,960,47.4193,1230
465000.0,4,2.5,3060,0,9,3060,0,47.3689,3040
1700000.0,3,2.75,2810,4,10,2810,0,47.6361,3120
490000.0,3,2.25,2550,4,9,2550,0,47.7711,3050
2680000.0,5,3.0,4290,0,11,4290,0,47.6217,3620
1000000.0,3,2.25,3040,0,9,3040,0,47.7635,2070
469950.0,4,2.75,2530,0,8,2530,0,47.737,2530
536000.0,3,1.75,1300,0,7,1300,0,47.6988,1590
244950.0,4,2.5,1790,0,7,1790,0,47.3617,1760
575000.0,3,1.0,1530,0,7,890,640,47.6543,1240
361000.0,5,2.75,2380,0,7,1300,1080,47.5009,2400
650000.0,5,2.25,2400,0,7,1200,1200,47.6007,1950
230005.0,2,1.0,1030,0,7,830,200,47.5291,1770
293000.0,4,2.5,3250,2,9,3250,0,47.2582,1600
445000.0,3,3.0,1970,0,8,1970,0,47.7651,2150
280000.0,4,1.5,1940,0,7,1140,800,47.5533,1340
520000.0,3,2.25,1850,0,8,1370,480,47.5696,1850
780000.0,4,3.25,3900,0,10,3900,0,47.683,1730
625000.0,3,1.75,3160,0,8,2160,1000,47.274,1990
239950.0,3,1.75,1440,0,7,1440,0,47.4473,1640
335000.0,3,1.5,2040,0,7,1340,700,47.5218,1190
612000.0,3,2.5,2120,0,8,2120,0,47.5781,2010
200000.0,2,1.0,830,0,6,830,0,47.4215,1300
345000.0,3,1.75,3140,0,8,1670,1470,47.3074,2590
520000.0,4,2.5,2410,0,8,1550,860,47.7153,2330
855000.0,4,2.25,2190,0,8,1800,390,47.6425,2100
567500.0,4,1.75,2190,0,7,1190,1000,47.5846,1510
208000.0,3,1.5,1210,0,7,1210,0,47.328,1370
452000.0,3,1.75,1880,0,7,880,1000,47.7004,1260
555000.0,3,3.0,2410,0,9,2410,0,47.747,2540
519000.0,5,2.75,2620,0,8,1350,1270,47.5226,1940
474950.0,3,2.25,1850,0,9,1850,0,47.5525,1080
419000.0,3,2.25,1760,0,7,1190,570,47.6525,2260
390000.0,2,1.0,860,0,7,860,0,47.6334,2160
539000.0,7,2.25,2620,0,7,2620,0,47.6123,2070
569000.0,4,1.75,2400,0,8,1590,810,47.4282,2200
611000.0,3,1.0,1850,0,7,1850,0,47.6727,1850
760000.0,3,2.5,4040,0,9,4040,0,47.2711,3000
732000.0,3,2.0,1940,0,9,1940,0,47.5913,2330
1675000.0,3,2.5,3490,4,9,2150,1340,47.7265,2990
919950.0,5,2.75,3170,0,9,3170,0,47.5937,3210
400000.0,4,2.5,2530,0,7,1440,1090,47.7762,1960
785000.0,4,2.5,3230,0,9,3230,0,47.6318,3230
835000.0,3,2.25,2120,0,9,2120,0,47.6482,3280
640500.0,2,1.75,1640,0,8,1340,300,47.7068,1760
310000.0,4,2.5,2130,0,8,2130,0,47.3208,2350
355000.0,4,1.0,1440,0,7,1440,0,47.7133,1150
685000.0,3,1.75,1940,1,8,1440,500,47.5239,2160
202500.0,3,1.0,1120,0,6,1120,0,47.4896,1050
540000.0,3,2.5,2400,0,8,2400,0,47.5371,2420
295000.0,4,2.5,1810,0,8,1810,0,47.4088,1850
518000.0,3,1.0,1270,3,7,1270,0,47.5433,2100
250000.0,2,1.75,1350,0,7,1350,0,47.3493,1370
330000.0,2,2.0,1550,0,7,1550,0,47.5145,1600
481000.0,2,1.0,1620,0,7,920,700,47.6855,1330
898000.0,3,2.25,2650,3,9,1770,880,47.7209,2650
570000.0,5,1.75,2510,0,8,2510,0,47.6635,1900
475000.0,4,2.5,2040,0,8,2040,0,47.7366,2530
265000.0,3,2.5,1660,0,8,1660,0,47.3541,1630
380000.0,3,2.5,1980,4,10,1580,400,47.4551,2060
790000.0,4,2.5,2690,0,9,2690,0,47.6596,2420
620000.0,2,2.25,2910,2,9,2910,0,47.5279,2090
709050.0,4,3.5,2720,0,8,2670,50,47.7034,1960
296500.0,3,1.0,1280,0,7,1280,0,47.5259,1380
475000.0,3,2.5,2160,0,8,2160,0,47.7273,2230
440000.0,3,2.25,1760,0,8,1290,470,47.522,2050
405000.0,2,1.0,800,0,6,800,0,47.6913,1470
269500.0,2,1.0,930,0,6,730,200,47.5321,1100
520000.0,5,1.75,2040,0,7,1020,1020,47.5941,1720
229500.0,1,1.0,1180,2,6,1180,0,47.4007,1890
335000.0,4,1.75,2000,0,7,1390,610,47.3203,1520
680000.0,4,2.75,3310,0,9,3310,0,47.7249,3230
1389000.0,4,3.5,3130,0,9,2550,580,47.6849,1830
740000.0,4,2.5,2300,2,8,1600,700,47.5256,2510
270000.0,3,2.25,2140,0,8,2140,0,47.3484,2060
510000.0,4,2.0,2210,3,7,1760,450,47.5727,1760
300000.0,2,1.0,970,0,6,970,0,47.515,1570
1298890.0,5,2.25,2690,3,8,2020,670,47.5821,3380
675000.0,4,2.0,1890,0,7,1670,220,47.6633,1800
925850.0,6,3.25,3140,0,10,3140,0,47.5411,2980
255500.0,2,1.0,1440,0,7,1150,290,47.4916,1870
450000.0,3,2.5,2910,0,10,2910,0,47.2789,2910
280000.0,3,1.0,1310,0,7,1310,0,47.2574,1600
245000.0,4,2.25,2140,0,7,2140,0,47.3655,2060
344950.0,3,1.0,1090,0,7,1090,0,47.7155,1440
381000.0,3,1.75,1330,0,7,1330,0,47.7199,1500
1945000.0,4,4.0,4690,0,11,3480,1210,47.6165,2800
1500000.0,3,1.5,1910,0,8,1910,0,47.6453,2850
232603.0,3,1.75,1750,0,7,1750,0,47.3173,2140
220000.0,5,2.5,1760,0,6,1760,0,47.5271,1370
600000.0,4,1.75,1810,0,8,1390,420,47.6976,2080
239000.0,3,2.5,1360,0,7,1360,0,47.3645,1360
400000.0,3,1.75,1730,0,8,1730,0,47.7149,1440
2180000.0,6,2.75,4710,3,10,3690,1020,47.6622,2950
350000.0,3,1.0,1010,0,7,1010,0,47.7351,1310
562000.0,3,2.5,2400,0,8,2400,0,47.7361,2230
380000.0,3,1.5,1540,0,7,1540,0,47.5237,1690
511200.0,4,1.75,1480,0,7,740,740,47.643,1680
680000.0,4,2.5,2520,0,9,2520,0,47.5524,2910
350000.0,3,3.25,1210,0,8,1000,210,47.7114,1650
410000.0,5,2.5,2670,0,8,1410,1260,47.3429,1860
1050000.0,4,2.5,3030,0,10,3030,0,47.5806,2980
391265.0,3,2.0,1440,0,8,1440,0,47.7022,1350
1410000.0,4,2.25,3250,0,9,3250,0,47.6334,2890
575000.0,3,2.0,1750,2,7,870,880,47.5579,1750
316000.0,4,1.5,2120,0,7,2120,0,47.6503,2000
165000.0,3,1.0,1050,0,7,1050,0,47.5169,1050
850000.0,3,2.25,1950,0,8,1430,520,47.637,1950
210000.0,3,1.0,1020,0,5,1020,0,47.5281,2070
325000.0,4,2.5,1820,0,7,1220,600,47.4333,1860
682000.0,4,2.5,2390,0,8,2390,0,47.7066,2610
430000.0,3,2.5,1400,0,7,1400,0,47.7233,1710
325500.0,3,1.5,1540,0,7,1190,350,47.7329,1290
385000.0,3,1.75,2370,3,7,1280,1090,47.5039,1990
435000.0,1,1.0,670,0,6,670,0,47.654,1330
550000.0,4,1.0,2420,0,7,2420,0,47.5744,1630
400000.0,3,1.0,1000,0,6,860,140,47.7098,1700
503000.0,4,2.75,2100,0,7,1240,860,47.7194,2490
676000.0,4,2.5,2800,0,8,2800,0,47.6076,2790
180000.0,3,1.0,940,0,7,940,0,47.3732,1420
234000.0,3,2.0,1640,0,6,1640,0,47.3089,1160
734200.0,4,2.5,2760,0,7,1680,1080,47.6726,1850
920000.0,3,3.25,3660,0,10,3660,0,47.4087,3660
1920000.0,4,2.5,3070,3,9,2070,1000,47.64,3780
224000.0,3,1.75,1100,0,7,1100,0,47.3232,1520
1400000.0,3,2.75,3130,4,8,1690,1440,47.5895,2980
185000.0,3,1.0,1320,0,6,1320,0,47.2857,1070
554600.0,3,1.75,1470,0,7,1470,0,47.6755,1530
268000.0,3,1.75,1480,0,7,980,500,47.3657,1790
675000.0,4,2.25,2260,0,8,1530,730,47.6237,2220
620000.0,4,2.25,2210,0,8,1710,500,47.634,2070
396450.0,3,1.75,1540,0,8,1540,0,47.5172,1330
565000.0,5,1.75,1910,0,7,1390,520,47.5772,1750
410000.0,3,1.75,1760,0,7,1160,600,47.5773,1840
1190000.0,4,3.0,2240,0,8,1270,970,47.6369,2240
716125.0,3,2.25,2110,0,9,2110,0,47.6669,2130
225000.0,2,1.0,1396,0,7,1396,0,47.6374,2020
640000.0,4,2.75,3040,3,9,2320,720,47.7184,2830
374000.0,2,1.0,1140,1,6,980,160,47.5634,1220
415000.0,4,2.0,1780,0,7,1160,620,47.7746,1780
592500.0,4,2.5,3370,0,8,1770,1600,47.461,2920
365000.0,3,2.5,1484,0,7,1484,0,47.6844,1484
600000.0,4,2.5,2230,0,7,1180,1050,47.6297,1860
465000.0,4,2.5,2820,0,9,2820,0,47.3064,2910
254999.0,3,1.0,1580,0,7,1000,580,47.3318,1580
279000.0,4,2.5,2040,0,7,2040,0,47.3691,2040
460000.0,3,2.5,2720,0,8,2720,0,47.2619,2250
507000.0,4,2.25,1490,0,7,1020,470,47.6184,1510
291000.0,3,1.75,1560,0,7,1560,0,47.4876,1840
350000.0,2,1.5,830,0,7,830,0,47.6058,830
90000.0,3,1.0,980,0,6,980,0,47.317,980
329000.0,3,1.75,1980,0,8,1360,620,47.4442,1880
909000.0,4,2.5,3680,0,10,3680,0,47.5604,2830
187000.0,2,1.0,860,0,5,860,0,47.492,960
580000.0,3,1.75,1850,0,7,1020,830,47.6605,1850
345000.0,3,2.5,1620,0,7,1620,0,47.736,1620
497000.0,4,2.5,2240,0,8,2240,0,47.5636,1860
345000.0,3,1.0,1010,0,6,1010,0,47.5657,1330
313500.0,3,1.75,1610,0,8,1610,0,47.4503,2120
910000.0,3,2.5,2720,0,9,2720,0,47.6894,2870
399950.0,3,1.5,2080,0,7,1190,890,47.7144,1850
268000.0,4,2.0,1930,0,7,1030,900,47.482,1220
559000.0,4,1.75,2250,0,8,1450,800,47.5235,1950
309000.0,3,2.25,1980,0,7,1300,680,47.3922,2030
410000.0,3,2.5,1960,0,7,1960,0,47.5384,2060
259000.0,3,1.0,1320,0,7,1320,0,47.4902,1370
950000.0,5,2.0,2940,0,9,2340,600,47.6466,2940
320000.0,4,1.0,1460,0,7,1460,0,47.7602,1690
1150000.0,4,2.5,2330,1,8,1490,840,47.6843,2430
394250.0,3,2.0,2620,3,7,2620,0,47.4096,1730
315000.0,1,1.0,700,0,6,700,0,47.6886,1150
480000.0,2,2.0,1140,0,6,1140,0,47.5277,1880
556000.0,3,2.5,2750,0,9,2750,0,47.4745,2710
450000.0,3,2.5,2480,0,7,2480,0,47.5355,2510
420000.0,3,1.5,1130,0,7,940,190,47.7021,1400
890000.0,6,3.75,2770,0,8,1870,900,47.669,1570
295000.0,4,2.0,1710,0,7,1030,680,47.395,1710
410000.0,4,2.25,2150,0,8,2150,0,47.469,2200
308900.0,3,2.5,2250,0,8,2250,0,47.2636,2140
1161000.0,4,2.5,2960,3,8,1480,1480,47.6846,2500
665000.0,2,2.5,2300,0,8,2300,0,47.7087,1820
577000.0,3,1.75,1740,0,7,970,770,47.577,1740
959000.0,3,2.5,2830,0,10,2830,0,47.6799,1780
471000.0,2,1.75,1240,0,7,1240,0,47.5439,1800
560000.0,3,2.5,2180,0,8,2180,0,47.5714,2150
955000.0,5,2.25,2510,0,8,2510,0,47.5339,2510
1240000.0,7,5.5,6630,0,10,4930,1700,47.5399,4470
579000.0,3,2.5,2300,0,8,1800,500,47.7767,2460
335000.0,4,2.25,3220,0,8,3220,0,47.3112,2120
485000.0,3,2.5,2270,2,8,2270,0,47.5326,2550
552000.0,3,2.5,1840,0,9,1840,0,47.6131,2730
950000.0,4,3.25,3820,0,10,3820,0,47.6097,2790
203700.0,3,2.0,1660,0,7,1130,530,47.3187,1550
412000.0,4,3.5,3360,0,9,2450,910,47.3047,2580
237500.0,3,2.0,1350,0,7,1350,0,47.3614,1470
866800.0,4,3.5,2970,2,9,2200,770,47.6772,1470
425000.0,3,1.0,1000,0,7,860,140,47.6857,1000
200000.0,3,2.0,1190,0,7,1190,0,47.3191,1540
280000.0,3,1.75,1670,0,7,990,680,47.5209,1230
140000.0,3,1.5,1200,0,8,1200,0,47.4659,1270
370000.0,5,2.5,2250,0,8,1280,970,47.4501,2140
550000.0,2,0.75,1040,0,7,930,110,47.6489,1700
1411600.0,2,2.5,3180,4,10,2610,570,47.5617,3760
1505000.0,2,2.5,3180,4,10,2610,570,47.5617,3760
510000.0,4,1.5,2040,0,7,1020,1020,47.5965,1490
351000.0,3,1.0,1160,0,7,1160,0,47.7343,1670
210000.0,3,1.0,880,0,6,880,0,47.4949,1100
449999.0,4,1.75,2290,2,7,1690,600,47.2034,2170
137000.0,3,1.0,950,0,6,950,0,47.5178,1260
270000.0,3,1.0,1010,0,7,1010,0,47.3437,2020
540000.0,3,2.5,3100,0,7,1820,1280,47.3928,2430
565000.0,5,3.0,2560,0,8,1590,970,47.7657,2500
940000.0,4,1.5,2430,0,8,2430,0,47.6351,2020
385000.0,2,1.0,830,3,6,830,0,47.4012,2030
400000.0,3,3.0,2090,0,8,1450,640,47.7408,2090
365000.0,3,2.0,2030,0,7,2030,0,47.5082,1760
353250.0,2,1.0,1060,0,7,1060,0,47.5888,1360
455000.0,2,1.5,1090,0,7,950,140,47.6836,1640
475000.0,4,3.5,3400,0,8,2500,900,47.4335,1300
571500.0,4,1.75,1920,0,7,960,960,47.7106,1920
441000.0,2,1.0,1150,0,6,780,370,47.5624,1150
810000.0,6,2.75,3970,0,10,2180,1790,47.5956,2490
550000.0,3,2.25,1880,0,8,1880,0,47.6283,1880
736000.0,2,1.0,1500,0,8,1100,400,47.6409,1980
375000.0,3,1.75,2190,0,7,2190,0,47.6984,1700
717500.0,3,2.5,2530,0,8,2530,0,47.6853,2140
581000.0,2,1.75,1930,2,8,1430,500,47.7576,2840
629000.0,3,2.0,1510,0,7,1510,0,47.5689,1990
3800000.0,3,4.25,5510,4,13,4910,600,47.7296,3430
225000.0,3,2.0,1100,0,6,1100,0,47.3606,1050
315000.0,3,2.5,1730,0,7,1730,0,47.3505,1780
425000.0,3,2.5,1480,0,8,1480,0,47.5468,1470
346500.0,3,1.0,1150,0,7,1150,0,47.5624,1880
550000.0,3,2.25,1950,0,8,1570,380,47.5784,2160
565000.0,3,1.75,2380,0,8,1400,980,47.6409,2150
1001000.0,4,2.0,3100,0,7,2040,1060,47.6852,1650
400000.0,2,2.0,2010,0,7,1450,560,47.5596,1660
724950.0,4,2.0,2270,0,8,2270,0,47.5809,1420
623000.0,3,1.75,2050,0,8,2050,0,47.5743,3180
295000.0,2,1.0,650,0,6,650,0,47.6185,1310
700000.0,4,3.25,2780,0,9,2780,0,47.7294,1000
482000.0,2,1.5,1300,0,8,1160,140,47.6727,1430
770000.0,3,2.5,2730,0,10,2730,0,47.58,2800
310000.0,4,2.5,3140,0,8,1820,1320,47.319,2700
720000.0,4,2.25,2410,0,8,2410,0,47.626,1910
355000.0,3,1.0,1180,0,6,1180,0,47.7281,1270
512000.0,4,2.5,2600,0,9,2600,0,47.5146,2470
303000.0,2,1.5,1400,0,7,1400,0,47.7222,1430
299000.0,5,2.5,2220,0,7,1110,1110,47.4341,1780
285000.0,3,2.5,1660,0,8,1660,0,47.3507,2190
680000.0,3,1.75,2330,0,8,1590,740,47.5714,2420
285000.0,4,1.75,1440,0,6,720,720,47.4571,1820
707000.0,4,2.25,2920,0,9,1690,1230,47.5585,2710
690000.0,3,2.0,1760,0,7,980,780,47.6388,1760
872000.0,4,2.25,2860,0,10,2860,0,47.7308,2670
290000.0,4,1.75,2090,0,8,1360,730,47.4792,2040
425000.0,4,1.75,1910,0,7,1110,800,47.7474,1590
925000.0,3,2.75,3280,2,9,2040,1240,47.5606,3150
340500.0,3,1.0,1770,0,7,1770,0,47.7715,2000
365000.0,2,1.0,920,0,6,920,0,47.5572,1370
725000.0,3,1.75,1690,0,7,1690,0,47.6079,1850
811000.0,3,3.0,2470,0,8,1860,610,47.6937,2390
299000.0,3,1.0,1040,0,7,1040,0,47.4936,1040
287500.0,4,2.0,1220,0,7,1220,0,47.5011,1220
879950.0,4,2.25,3500,4,9,1830,1670,47.5083,2960
135900.0,2,1.0,760,0,6,760,0,47.5019,1220
1225000.0,4,2.25,3070,3,9,1870,1200,47.5271,3070
522500.0,4,1.75,2100,0,7,1300,800,47.7049,1840
399500.0,4,1.5,1660,0,7,1660,0,47.739,950
450000.0,3,1.0,1430,0,7,1430,0,47.562,1140
218000.0,4,1.0,1620,0,7,1620,0,47.3021,2400
289999.0,3,2.0,1490,0,8,1490,0,47.3248,2040
540000.0,2,1.0,1170,0,6,1170,0,47.6729,1170
324950.0,3,1.0,1240,0,7,1240,0,47.6199,1240
718500.0,3,2.0,2910,0,7,1920,990,47.5576,1370
495000.0,3,2.0,2660,0,9,2660,0,47.2098,2570
260000.0,6,2.0,2220,0,7,2220,0,47.2977,1170
430000.0,4,1.5,1920,0,7,1070,850,47.5725,1450
402500.0,3,3.25,2780,0,8,2780,0,47.7348,1890
1415000.0,4,3.0,3110,3,10,2510,600,47.6583,3250
275000.0,3,2.25,1820,0,7,1450,370,47.397,1860
250000.0,3,2.25,1765,0,7,1765,0,47.3072,1765
665000.0,3,2.75,1800,0,7,1320,480,47.5679,1890
425000.0,3,2.5,2650,0,8,2650,0,47.4212,1940
760000.0,2,1.0,1410,0,7,1310,100,47.6695,1740
447000.0,3,2.5,1650,0,7,1650,0,47.682,1560
205000.0,3,1.0,1180,0,7,1180,0,47.3325,1180
191000.0,3,1.5,800,0,6,800,0,47.3266,820
350000.0,2,1.75,1430,0,7,1430,0,47.5088,1290
789888.0,5,3.5,3300,0,9,2410,890,47.5463,2540
443000.0,2,1.0,1220,0,7,980,240,47.7297,1990
695000.0,4,3.5,3530,0,9,2660,870,47.7339,2810
560000.0,4,2.0,1380,0,7,1380,0,47.6583,1440
550000.0,3,1.75,1410,0,7,810,600,47.6727,1760
850000.0,2,2.5,3360,0,9,3360,0,47.7112,2510
352750.0,4,2.75,2270,0,7,1360,910,47.4672,2050
550000.0,4,2.5,2890,0,8,2890,0,47.7385,2840
774900.0,5,1.0,1750,0,7,1750,0,47.6075,1700
250000.0,3,1.0,1010,0,6,1010,0,47.4914,1250
962800.0,4,2.5,3780,0,9,3780,0,47.559,3370
299500.0,3,1.75,1880,0,7,1880,0,47.3213,2230
250000.0,2,1.0,800,0,6,800,0,47.7037,1910
745000.0,5,4.0,4720,0,9,3960,760,47.4536,2160
279475.0,2,1.0,1060,0,6,1060,0,47.5375,1560
450000.0,3,2.25,2530,0,8,2530,0,47.527,2160
307700.0,5,2.25,1980,0,7,1260,720,47.3984,1880
665000.0,3,1.0,1650,0,8,1300,350,47.6524,1440
375000.0,3,2.75,1890,0,8,1890,0,47.5337,2100
420000.0,4,2.5,3360,0,11,3360,0,47.3018,3530
148000.0,2,1.0,630,0,6,630,0,47.5329,970
707000.0,3,1.5,1980,0,8,1980,0,47.6364,1980
399000.0,3,1.0,990,0,7,840,150,47.5392,990
570000.0,4,2.5,3420,0,9,3420,0,47.3932,3250
853000.0,4,2.25,3440,0,10,3440,0,47.6674,3210
400000.0,3,1.0,1300,0,7,1300,0,47.593,2440
615000.0,2,1.75,2040,3,7,2040,0,47.3979,2040
463000.0,3,1.0,1250,0,7,1250,0,47.5974,1520
600000.0,4,2.5,1960,1,8,1290,670,47.4947,2490
429000.0,5,2.5,2720,0,7,1360,1360,47.557,2020
980000.0,4,4.25,3250,0,8,2360,890,47.6322,1800
359500.0,6,3.75,3190,0,8,3190,0,47.3724,2680
715000.0,4,2.5,2570,0,9,2570,0,47.6378,2760
240000.0,3,1.75,1420,0,7,980,440,47.3748,1430
455000.0,4,2.0,2120,0,7,1060,1060,47.7675,1290
610000.0,3,2.5,2080,0,7,2080,0,47.4032,2080
675000.0,3,2.75,2740,0,9,2740,0,47.6862,2210
283500.0,3,1.75,1250,0,7,1250,0,47.3787,1320
235000.0,2,1.0,2150,0,7,1260,890,47.5158,1590
827000.0,4,2.5,3230,0,9,1870,1360,47.562,2670
353000.0,2,1.0,860,0,7,860,0,47.7312,1554
747500.0,4,2.5,2810,0,9,2810,0,47.5303,2990
341000.0,2,1.0,1040,0,6,1040,0,47.5753,1740
182000.0,3,1.0,1160,0,5,1160,0,47.4772,1340
250000.0,3,2.0,1470,0,6,1470,0,47.349,1360
655000.0,4,3.5,2350,3,8,1670,680,47.6947,2250
405000.0,3,2.25,1660,0,8,1660,0,47.7575,2510
390000.0,4,1.75,2020,0,7,1100,920,47.6192,1670
275400.0,2,1.0,890,0,7,890,0,47.737,1130
791000.0,3,2.25,2430,0,8,1810,620,47.6812,2040
424500.0,3,1.75,1460,0,7,1460,0,47.6981,1720
430000.0,3,1.0,980,0,7,980,0,47.5718,1180
865000.0,4,2.5,2580,2,9,2580,0,47.6993,4220
163000.0,2,2.0,1250,0,7,1250,0,47.4051,1250
920000.0,4,2.75,3140,2,8,1570,1570,47.5675,2430
1028950.0,5,3.25,2680,0,9,1870,810,47.6115,3440
325000.0,3,1.75,1810,0,7,1290,520,47.4484,1550
315000.0,5,2.5,2090,0,7,2090,0,47.3538,2070
227000.0,4,1.0,1120,0,6,1120,0,47.508,1120
179000.0,4,1.75,1790,0,6,1410,380,47.4963,1790
276000.0,2,1.0,870,0,7,820,50,47.5702,1500
335000.0,4,1.5,3160,0,6,1840,1320,47.3103,1540
430000.0,3,2.0,2350,0,7,1600,750,47.7661,2160
266490.0,3,2.5,1810,0,7,1810,0,47.3715,1880
655000.0,4,2.75,3160,0,8,1580,1580,47.7004,2050
635500.0,3,2.0,1660,0,7,1000,660,47.6789,1700
235000.0,5,2.5,2500,0,7,1300,1200,47.3946,2120
885000.0,3,2.5,2880,0,9,2880,0,47.5633,2840
352500.0,3,1.0,1470,0,7,1470,0,47.7628,1470
450000.0,3,2.5,1460,0,8,1460,0,47.6012,1910
3635000.0,5,6.0,5490,0,12,5490,0,47.6165,2910
1050000.0,3,2.25,2480,4,9,1330,1150,47.5497,2500
476000.0,2,2.25,1140,0,8,1140,0,47.6543,1140
375000.0,3,2.5,1830,0,8,1830,0,47.3738,1940
600600.0,4,3.5,3110,0,8,3110,0,47.4349,2910
567000.0,4,1.75,2630,2,8,1430,1200,47.7158,2240
650000.0,4,1.75,2390,0,8,1470,920,47.7061,2110
190000.0,5,2.0,1750,0,5,1750,0,47.5094,1560
858000.0,4,3.5,4370,2,10,2580,1790,47.2332,3260
435500.0,1,1.75,1020,0,7,770,250,47.6724,1230
685000.0,3,2.0,2500,0,8,1770,730,47.6691,1770
252000.0,3,2.0,1540,0,7,1540,0,47.3128,1500
512500.0,4,2.25,2200,0,8,2200,0,47.7682,2400
423800.0,3,2.5,1940,0,8,1940,0,47.542,1940
460000.0,3,2.25,1453,0,8,1453,0,47.5429,1860
434000.0,3,2.75,1830,0,8,1830,0,47.7155,2030
244000.0,3,1.0,2000,0,6,1000,1000,47.4816,1760
348125.0,3,1.0,1400,0,7,1400,0,47.7719,1590
585000.0,4,3.25,2400,0,8,2400,0,47.743,2280
230000.0,3,1.0,1390,0,6,1390,0,47.2898,1420
450000.0,3,2.0,1680,0,8,1680,0,47.4861,1760
393000.0,5,2.0,1820,0,7,910,910,47.5547,1180
517000.0,2,1.0,1140,0,7,1140,0,47.6619,1660
400000.0,3,1.0,1060,0,7,1060,0,47.6736,1920
890000.0,2,1.75,3050,0,10,3050,0,47.6744,3050
205950.0,3,1.0,970,0,6,970,0,47.3776,1210
209000.0,3,1.0,1320,0,6,1320,0,47.202,1270
430000.0,4,1.75,1890,0,6,1110,780,47.7274,1560
534000.0,4,1.75,2040,0,6,1260,780,47.6698,1940
735000.0,4,3.0,2370,0,7,1650,720,47.678,2140
873000.0,3,2.25,2720,0,11,2720,0,47.5473,3170
475000.0,4,2.25,1970,0,8,1390,580,47.7219,1970
325000.0,3,1.75,2180,0,7,1090,1090,47.5158,2130
500000.0,3,2.25,2990,0,9,2990,0,47.754,2840
279000.0,4,2.75,2180,0,7,1330,850,47.4045,1500
350000.0,3,2.0,1440,0,8,1440,0,47.5753,1980
660000.0,4,2.25,3180,0,9,3180,0,47.6316,2910
324950.0,2,1.5,1643,1,7,1643,0,47.3973,2270
500000.0,4,2.0,1530,0,7,1530,0,47.7309,1480
187300.0,2,1.0,1310,0,6,850,460,47.4982,1270
345600.0,5,3.5,2800,0,9,2800,0,47.6059,1780
400000.0,3,1.5,1510,0,7,1510,0,47.5978,2180
935000.0,5,3.0,2700,0,10,2700,0,47.6811,1610
374000.0,4,1.75,2220,0,7,1140,1080,47.492,1670
328000.0,3,1.75,1440,0,7,1440,0,47.7078,2080
257500.0,3,2.0,1300,0,7,1300,0,47.4865,2210
1003000.0,4,2.5,2230,0,8,1630,600,47.6304,2410
216500.0,2,1.75,1390,0,8,1390,0,47.3785,1390
1185000.0,3,2.25,2760,0,10,2760,0,47.6501,3030
360000.0,4,2.5,3200,0,9,3200,0,47.4318,3030
699999.0,3,0.75,1240,0,7,1240,0,47.6239,1460
535000.0,3,2.5,1960,0,8,1960,0,47.7573,2020
464950.0,3,2.0,2190,0,7,2190,0,47.5106,1640
925000.0,4,2.5,3540,0,10,3540,0,47.5441,4130
930000.0,3,3.25,2640,0,9,1840,800,47.6636,1990
727500.0,3,2.0,2660,3,8,1940,720,47.5829,2270
325000.0,4,1.75,1670,0,7,1670,0,47.7254,1620
695000.0,3,3.25,3080,0,8,2080,1000,47.695,2100
585000.0,4,2.75,2890,0,8,1560,1330,47.734,1900
319000.0,3,2.25,1800,2,7,1200,600,47.4516,1700
265000.0,6,2.5,2000,0,7,1790,210,47.3841,1710
359000.0,5,1.75,1940,0,7,1940,0,47.4663,2300
390000.0,5,1.75,1940,0,7,1940,0,47.4663,2300
374500.0,3,1.0,960,0,7,960,0,47.7619,1670
661000.0,2,1.5,1750,0,8,1750,0,47.7397,2220
900000.0,3,2.5,2320,0,8,1620,700,47.6278,2160
600000.0,5,2.5,2380,0,8,1540,840,47.7,2270
2000000.0,5,4.25,6490,3,11,3940,2550,47.5728,3290
512500.0,4,1.75,1620,0,7,1620,0,47.5746,1450
229500.0,3,1.75,1770,0,8,1770,0,47.3377,1690
589000.0,3,2.5,2320,0,8,2320,0,47.539,2500
539950.0,3,2.5,1330,0,8,1330,0,47.6987,1310
640000.0,4,2.5,3420,0,9,3420,0,47.45,2110
218250.0,3,1.0,1270,0,7,970,300,47.305,1290
675000.0,4,3.5,2550,2,8,1880,670,47.7709,2090
338000.0,5,2.0,1860,0,7,1860,0,47.4484,1390
231750.0,3,1.0,1020,0,7,1020,0,47.4292,1470
199900.0,1,1.0,720,0,6,720,0,47.5119,1140
1059000.0,4,3.5,4460,2,11,4460,0,47.5862,4540
263000.0,4,2.75,1830,0,7,1250,580,47.2989,1730
279950.0,3,1.5,1520,0,7,1160,360,47.3855,1460
395000.0,3,1.5,1080,0,7,1080,0,47.6832,1400
252500.0,3,2.0,1900,0,7,1900,0,47.2909,1900
1150000.0,4,3.75,5300,0,11,5300,0,47.7283,3730
205000.0,3,1.0,1370,0,7,1370,0,47.2769,1770
654000.0,5,2.5,2960,0,8,1640,1320,47.6233,1890
200000.0,3,1.0,960,0,6,960,0,47.5621,1520
700000.0,3,2.5,2190,0,8,2190,0,47.6869,2090
2720000.0,4,3.25,3990,0,11,3990,0,47.6177,3450
306000.0,2,1.75,1200,0,7,800,400,47.7175,1310
270000.0,3,2.5,1780,0,7,1780,0,47.3352,2010
340000.0,3,2.25,2630,0,9,2630,0,47.3314,2470
450000.0,4,2.5,2300,0,7,2300,0,47.4793,1460
580000.0,4,2.75,3210,0,7,1810,1400,47.7338,1840
435000.0,4,1.75,2290,3,7,1290,1000,47.5698,1820
690000.0,4,2.5,2780,0,9,2780,0,47.5225,3000
720000.0,4,2.5,2650,0,8,2110,540,47.683,2000
403000.0,3,2.25,1840,0,8,1390,450,47.6923,2210
440000.0,3,2.75,1560,0,7,1030,530,47.7382,1870
178500.0,3,1.0,1200,0,7,1200,0,47.3864,1200
270000.0,4,2.5,1900,0,7,1900,0,47.2089,1420
129888.0,2,1.0,710,0,6,710,0,47.479,1070
260000.0,3,1.75,1360,0,7,1360,0,47.3657,1610
339950.0,5,2.5,2990,0,8,2990,0,47.3604,2150
250000.0,3,1.0,1640,0,6,1640,0,47.7656,1620
680000.0,3,3.5,3650,0,10,2050,1600,47.4002,2550
660000.0,10,3.0,2920,0,7,1860,1060,47.6635,1810
1225000.0,3,3.5,3680,2,11,3680,0,47.5647,3710
550000.0,3,2.0,1830,0,8,1830,0,47.5531,1770
675000.0,5,2.75,2570,0,8,2570,0,47.5814,2580
981000.0,3,3.25,2730,1,10,1900,830,47.6339,2730
168000.0,3,1.0,1150,0,6,1150,0,47.2749,1170
1000000.0,4,3.0,4260,0,11,4260,0,47.5874,3490
320000.0,3,1.0,1260,0,7,1260,0,47.4444,1530
959000.0,6,3.25,4440,1,9,2220,2220,47.5791,2660
372000.0,4,1.0,2300,0,7,1270,1030,47.524,1840
391500.0,3,2.5,1920,0,8,1920,0,47.4876,1920
390000.0,2,1.0,1080,0,7,1080,0,47.5275,1520
302000.0,2,1.0,890,0,6,890,0,47.5526,1160
495000.0,3,3.5,1650,0,7,1100,550,47.6302,1580
504500.0,3,2.5,1820,2,8,1640,180,47.6523,1440
555000.0,4,1.75,2320,0,7,2170,150,47.6893,1390
1550000.0,4,3.5,3260,0,9,2630,630,47.6598,2600
550000.0,3,1.5,1730,0,7,1250,480,47.5645,1370
1800000.0,4,2.5,3320,0,10,3320,0,47.6263,3680
655000.0,1,1.0,1660,0,7,830,830,47.6821,1100
685000.0,3,2.5,3290,0,10,3290,0,47.3154,2700
721000.0,4,2.0,2280,0,7,1220,1060,47.6986,1970
1518630.0,4,4.25,3650,0,9,2330,1320,47.638,1710
365000.0,4,2.5,1620,0,7,1620,0,47.4014,2240
458000.0,3,2.0,2020,0,7,1220,800,47.7278,1600
280000.0,2,1.0,1150,0,6,1150,0,47.4493,1170
628000.0,4,1.75,1940,0,7,1000,940,47.6786,1320
781500.0,4,2.5,3440,0,10,3440,0,47.5347,3310
295000.0,3,1.75,2000,0,7,1300,700,47.4346,1900
435000.0,2,1.0,750,0,7,750,0,47.6892,1700
300000.0,3,1.75,1420,0,7,1000,420,47.5069,1550
208500.0,2,1.0,880,0,5,880,0,47.3107,1010
930000.0,2,2.5,2680,0,9,2680,0,47.7078,2305
316000.0,2,2.0,860,0,6,860,0,47.5633,1290
249900.0,3,2.0,1310,0,7,1310,0,47.3694,1290
675000.0,3,2.25,1780,0,8,1540,240,47.6004,2220
447000.0,3,2.25,1440,0,7,1440,0,47.5662,1610
675000.0,3,2.0,1510,0,8,1510,0,47.6088,1510
546000.0,4,2.5,2100,0,8,1580,520,47.5928,1490
310000.0,3,2.0,1310,0,7,1310,0,47.7337,1370
190000.0,3,1.0,1280,0,7,880,400,47.5035,1360
650000.0,3,1.5,1320,0,8,1320,0,47.5827,2110
585000.0,3,2.5,1740,0,8,1130,610,47.6207,1740
1430800.0,4,2.5,2910,0,10,2910,0,47.6906,2480
565000.0,4,2.5,2500,0,9,2500,0,47.6346,3380
174900.0,3,1.0,1100,0,6,1100,0,47.5279,960
360000.0,3,2.25,1381,0,8,1381,0,47.711,1381
234000.0,3,1.0,960,0,7,960,0,47.7758,1540
575000.0,8,3.0,3840,0,7,2530,1310,47.7111,1380
315000.0,3,2.5,2200,0,7,2200,0,47.3709,2200
225000.0,3,1.0,1250,0,7,1250,0,47.3397,1300
370000.0,3,1.5,2380,0,7,1850,530,47.7714,1830
606000.0,3,1.0,1500,0,7,1000,500,47.6718,1640
272500.0,3,2.0,1410,0,7,1410,0,47.4273,1830
475000.0,3,1.75,1680,0,7,960,720,47.6855,1680
270000.0,3,1.0,1500,0,7,1500,0,47.4666,1350
624000.0,4,1.75,2710,0,8,1440,1270,47.5523,1960
355000.0,3,1.75,1730,0,7,1730,0,47.76,1390
345000.0,3,1.0,960,0,7,960,0,47.7027,1020
342000.0,4,2.5,2380,0,8,2380,0,47.3273,2260
316000.0,3,1.75,1120,2,7,1120,0,47.1853,1620
539950.0,4,2.5,2960,0,9,2960,0,47.3988,2800
221347.0,3,2.0,1580,0,6,790,790,47.4927,1090
330000.0,3,2.5,1870,0,8,1870,0,47.4615,2290
279000.0,4,2.5,1810,0,8,1470,340,47.2202,1850
850000.0,4,3.0,2550,0,8,1750,800,47.6559,2100
746000.0,3,1.75,1910,0,7,1100,810,47.5995,1910
478000.0,2,2.0,1200,0,7,600,600,47.627,1790
820000.0,4,2.75,2420,0,7,2420,0,47.682,1590
2160000.0,3,3.5,3080,3,11,2530,550,47.6321,4120
820000.0,3,3.0,3850,1,10,3850,0,47.5535,2970
887000.0,3,2.0,3000,2,8,2470,530,47.7745,2600
159000.0,3,1.0,1360,0,7,1360,0,47.2861,1530
824000.0,7,4.25,3670,1,8,2800,870,47.6375,2010
812000.0,4,2.5,2270,0,9,2270,0,47.6916,1210
242000.0,4,2.5,1750,0,7,1750,0,47.3149,1890
625000.0,4,2.5,3550,0,9,3550,0,47.5422,3920
399888.0,4,1.0,2370,0,7,1570,800,47.5108,1640
289000.0,3,2.25,1670,0,7,1670,0,47.3604,1670
400000.0,3,2.0,1860,0,9,1860,0,47.4298,2500
1550000.0,3,2.5,4460,0,12,4460,0,47.6573,3770
345000.0,2,1.0,1080,0,7,1080,0,47.6902,1530
874950.0,2,1.0,1080,0,7,1080,0,47.6902,1530
875000.0,3,2.75,2280,0,7,1280,1000,47.6685,1650
628990.0,4,2.5,2540,0,9,2540,0,47.6324,2740
535000.0,2,3.5,2560,0,6,1280,1280,47.6681,1390
770126.0,4,2.75,2390,0,8,1430,960,47.6035,1910
710000.0,4,2.5,2870,0,8,1870,1000,47.5678,2670
465000.0,3,1.75,1510,2,7,860,650,47.5667,1510
359000.0,3,1.75,2200,0,7,2200,0,47.7659,1690
151000.0,2,0.75,720,0,4,720,0,47.5323,1290
820000.0,3,2.5,2970,0,9,2970,0,47.5422,2970
160000.0,3,1.5,960,0,7,960,0,47.3018,1160
535000.0,4,1.75,1420,0,7,1420,0,47.6771,1490
365000.0,3,2.25,1800,0,7,1300,500,47.7722,1950
708000.0,4,2.5,3090,0,9,3090,0,47.597,3080
215000.0,3,1.0,1200,0,7,1200,0,47.3724,1200
1950000.0,4,3.5,4065,0,10,4065,0,47.6209,3070
390000.0,4,2.5,2570,0,7,2570,0,47.4833,2460
570000.0,3,2.0,1530,0,7,1530,0,47.686,1640
383000.0,3,1.75,1500,0,7,1500,0,47.7527,1500
370000.0,4,3.0,2490,0,9,2490,0,47.3509,2650
454000.0,4,2.5,3040,0,7,3040,0,47.7247,2490
1400000.0,5,3.25,4140,4,10,2190,1950,47.7633,3220
371000.0,4,1.75,1690,0,7,1690,0,47.5241,2390
530000.0,3,1.75,1430,0,7,1430,0,47.6353,1890
608000.0,4,2.75,2490,0,8,1400,1090,47.7496,2060
450000.0,3,1.75,1350,0,7,1350,0,47.713,1100
780000.0,4,2.5,3140,0,10,3140,0,47.5943,3140
290000.0,4,2.5,2340,0,8,2340,0,47.3468,2480
225000.0,3,1.75,1610,0,7,1100,510,47.3174,1510
805000.0,4,2.5,3320,0,10,3320,0,47.7478,3270
660000.0,3,2.5,2390,0,9,2390,0,47.7446,2640
299000.0,3,1.75,1180,0,7,1180,0,47.4818,1400
530000.0,2,2.25,1260,0,8,1260,0,47.6538,1300
680000.0,3,2.5,1800,0,7,1350,450,47.6599,1920
199900.0,4,1.75,1790,0,6,1790,0,47.2664,1550
224000.0,3,1.75,1760,0,7,1060,700,47.5003,1340
244000.0,3,1.75,1540,0,7,1440,100,47.4031,1540
485000.0,4,1.75,1260,0,7,860,400,47.687,1000
330000.0,4,2.5,2240,0,8,2240,0,47.3824,2250
509000.0,4,2.0,1630,0,6,1030,600,47.6472,1780
440000.0,4,2.5,2350,0,8,2350,0,47.5123,2260
244000.0,3,2.0,1350,0,7,1350,0,47.2073,1350
399700.0,4,1.75,1320,0,7,870,450,47.5534,940
519000.0,4,2.5,1950,0,7,1250,700,47.6696,1520
211000.0,4,1.0,2100,0,7,1050,1050,47.476,1540
950000.0,3,2.5,3480,0,7,1750,1730,47.7047,3010
410000.0,3,2.5,1830,0,8,1830,0,47.6022,1830
750000.0,4,2.0,2640,0,7,2040,600,47.678,1330
133400.0,3,1.0,900,0,6,900,0,47.3036,1120
240000.0,3,2.0,1553,0,7,1553,0,47.2056,1010
539000.0,3,2.5,1710,0,8,1570,140,47.6743,2120
688000.0,4,3.0,3400,0,10,3400,0,47.4883,1760
465000.0,3,1.5,1270,0,7,1270,0,47.676,1580
936000.0,3,1.75,2960,2,8,1480,1480,47.5739,2700
620000.0,4,2.5,3040,0,7,3040,0,47.6884,1690
429950.0,3,1.75,1430,0,7,1430,0,47.7441,1630
296475.0,3,2.5,1520,0,7,1520,0,47.3842,1560
330000.0,4,2.0,1820,0,7,1100,720,47.7607,1540
445000.0,3,2.25,1800,0,8,1270,530,47.7072,1940
846000.0,4,3.25,2720,1,10,2070,650,47.5554,1450
725000.0,4,1.75,1980,1,8,1380,600,47.5607,1810
369000.0,4,2.5,2550,0,9,2550,0,47.3059,2400
625000.0,3,1.75,2210,0,8,1390,820,47.5924,2050
535000.0,3,2.0,2120,0,7,2120,0,47.682,2280
229950.0,4,1.5,1570,0,6,1570,0,47.307,1140
229999.0,3,1.75,1310,0,7,1310,0,47.2761,1580
850000.0,5,3.5,3150,0,8,2460,690,47.6754,2080
589900.0,4,4.5,3870,0,10,2530,1340,47.4677,3020
513000.0,2,1.0,1840,0,7,1160,680,47.5764,1750
401000.0,3,1.0,1120,0,6,1120,0,47.5631,1980
260000.0,3,2.5,1440,0,7,1440,0,47.511,1440
525000.0,4,2.75,2300,0,8,2300,0,47.7771,2000
470000.0,3,3.5,2070,0,8,1370,700,47.537,1930
205000.0,4,1.5,1420,0,7,940,480,47.4174,1330
620000.0,3,2.25,2010,0,8,1570,440,47.5613,2050
229000.0,3,1.5,1200,0,6,1200,0,47.5122,1440
445000.0,2,2.0,1150,0,7,860,290,47.7001,1680
215000.0,2,1.0,1240,0,7,1240,0,47.4971,1130
504975.0,2,2.5,1900,0,8,1900,0,47.7132,1640
495000.0,4,2.25,2350,0,8,2350,0,47.7628,2210
205000.0,3,1.0,1120,0,7,1120,0,47.3732,1190
152275.0,1,1.0,1020,0,6,1020,0,47.5051,1260
586000.0,4,2.25,1930,0,8,1930,0,47.7026,2280
779950.0,2,2.5,2680,0,9,2680,0,47.7094,2310
557000.0,4,1.75,2660,0,8,2660,0,47.6204,1980
610000.0,4,2.25,2200,2,8,1220,980,47.5818,1940
405000.0,3,1.5,1010,0,7,1010,0,47.72,1550
320000.0,4,2.25,2310,0,8,2310,0,47.4379,2310
356000.0,3,1.0,920,0,6,920,0,47.5524,1080
794500.0,5,3.0,3030,0,7,1930,1100,47.6771,1280
349000.0,3,1.75,1590,0,7,1590,0,47.4815,2980
549000.0,4,2.25,2740,0,7,2740,0,47.4734,2740
193000.0,3,1.0,960,0,6,960,0,47.2819,960
700000.0,3,1.5,2240,1,9,1440,800,47.6208,3150
523000.0,3,2.5,2400,0,8,2400,0,47.5363,2420
565000.0,5,3.25,2860,0,7,1800,1060,47.7757,1920
500000.0,4,2.5,2960,0,7,2960,0,47.5328,2760
1450000.0,4,3.25,3770,0,9,2710,1060,47.641,2560
710000.0,6,3.5,3830,0,9,3830,0,47.4574,2410
333000.0,4,2.0,2750,0,8,2750,0,47.457,1340
580000.0,3,1.75,2100,0,7,1300,800,47.6724,2220
289950.0,4,1.75,1500,0,7,1200,300,47.4531,1780
375000.0,2,1.0,710,1,5,710,0,47.64,1810
505000.0,2,3.0,2770,0,8,1910,860,47.6082,2140
324950.0,3,1.75,2050,2,7,1050,1000,47.5058,2380
490000.0,4,2.25,1960,0,7,1960,0,47.6887,1560
630000.0,4,2.0,1770,0,7,1770,0,47.6493,1340
595000.0,3,2.75,3290,0,8,3290,0,47.5241,2750
872500.0,4,2.0,1990,0,9,1260,730,47.6515,1770
490000.0,2,1.0,1760,2,7,1000,760,47.5577,1760
1900000.0,4,3.25,5080,0,11,5080,0,47.5423,4730
310000.0,2,1.0,1020,0,7,1020,0,47.5135,1770
450000.0,3,1.0,1350,0,6,1200,150,47.4657,1860
539000.0,3,1.5,1740,0,9,1740,0,47.6276,2580
888550.0,3,2.5,3540,0,10,3540,0,47.6892,3540
269950.0,3,2.5,1520,0,7,1080,440,47.4267,1720
142000.0,0,0.0,290,0,1,290,0,47.5308,1620
300000.0,3,1.75,1310,0,7,1310,0,47.721,1490
780000.0,2,3.25,3000,0,10,2410,590,47.611,4270
545000.0,3,2.5,2660,0,8,2660,0,47.5234,2720
278000.0,3,2.25,2120,0,7,2120,0,47.3596,2120
342000.0,3,2.25,1200,0,7,1200,0,47.7151,1220
190000.0,4,1.75,1900,0,7,1900,0,47.3615,1720
387000.0,2,1.5,1010,0,8,1010,0,47.6529,1330
279950.0,3,2.25,1850,0,7,1850,0,47.452,1870
550000.0,6,4.5,4520,0,9,3580,940,47.407,2870
439000.0,3,2.0,2010,0,8,1510,500,47.7416,1780
774888.0,3,2.25,2420,0,8,2420,0,47.5107,2540
480000.0,5,2.5,2732,2,8,1870,862,47.3436,2720
835000.0,4,2.0,1910,0,8,1910,0,47.6893,1360
1500000.0,5,3.5,3520,0,9,2400,1120,47.6364,1360
771000.0,4,2.0,2220,0,7,1370,850,47.6876,1620
1225000.0,4,2.25,2020,3,9,1760,260,47.6471,3100
600000.0,4,2.5,2090,0,8,1420,670,47.624,2110
305000.0,3,1.0,1580,0,7,1010,570,47.4607,1710
1388000.0,5,1.75,2650,0,8,2650,0,47.626,2780
216500.0,3,1.0,1020,0,6,1020,0,47.4459,1690
370000.0,3,2.5,1070,0,7,720,350,47.5618,1070
492650.0,4,1.75,2120,0,8,1640,480,47.7753,2310
431200.0,5,1.75,1360,0,7,1060,300,47.7203,1490
277500.0,4,2.0,1700,0,7,1700,0,47.3748,1960
278000.0,5,1.5,1820,0,7,1090,730,47.3712,1820
351000.0,4,1.0,1430,0,6,730,700,47.7417,1310
850000.0,4,3.5,4140,0,10,3160,980,47.7059,2640
885000.0,2,2.0,1313,0,8,1313,0,47.6369,1080
399950.0,3,2.0,1590,3,8,1590,0,47.2241,2780
185000.0,3,1.75,1080,0,7,1080,0,47.4883,1090
440000.0,5,3.0,2730,0,8,1470,1260,47.4994,2590
2395000.0,4,3.25,3800,0,10,3800,0,47.5684,3940
299000.0,3,2.25,2540,0,8,1320,1220,47.41,1870
299500.0,3,1.75,1810,0,8,1230,580,47.3707,2090
420000.0,3,1.5,1540,0,7,1540,0,47.7565,2180
234000.0,4,1.0,1390,0,7,1390,0,47.3885,1390
540000.0,2,1.75,1460,0,7,850,610,47.6928,2050
649950.0,4,2.5,2350,0,8,2350,0,47.7545,2370
330000.0,3,1.0,1160,0,7,1160,0,47.7336,1190
840000.0,4,3.25,3500,0,9,3500,0,47.6944,3390
370000.0,3,2.5,1980,0,8,1980,0,47.396,2090
410000.0,3,1.5,1250,0,7,1250,0,47.5383,1430
257000.0,2,1.0,770,0,7,770,0,47.7143,1320
350000.0,3,1.0,1920,0,7,1320,600,47.5346,1810
380000.0,2,1.0,1120,1,6,1120,0,47.77,1120
344000.0,3,1.0,1150,0,6,1150,0,47.7422,1400
488000.0,3,2.5,1590,0,7,1590,0,47.6772,1260
465000.0,3,1.0,910,0,7,780,130,47.6862,1220
229500.0,2,1.75,1870,0,7,960,910,47.5071,1680
445000.0,5,3.0,2420,0,8,2420,0,47.5082,1510
246000.0,4,1.5,2120,0,6,2120,0,47.3846,1540
545000.0,5,2.5,2730,0,7,1660,1070,47.7646,2250
518000.0,4,2.5,2560,1,8,2560,0,47.5222,2190
565000.0,4,2.5,2620,0,8,2620,0,47.5295,2620
445000.0,4,2.5,2760,0,7,2760,0,47.4802,2760
968000.0,5,2.5,2900,0,8,1450,1450,47.6255,2810
725000.0,3,2.0,1820,0,7,910,910,47.6823,1850
315500.0,3,1.75,1870,0,7,990,880,47.454,1750
487585.0,4,1.75,2010,0,7,1470,540,47.7206,1840
246500.0,2,1.0,940,0,7,940,0,47.4631,1890
819000.0,3,1.75,1850,0,8,1650,200,47.6528,1540
349900.0,5,2.5,2530,0,7,2530,0,47.3531,2070
267000.0,3,1.0,940,0,6,940,0,47.5117,1020
480000.0,3,2.25,1820,0,7,1480,340,47.7401,1930
525000.0,2,1.0,1510,0,7,880,630,47.6135,1330
578000.0,4,2.5,2070,0,8,2070,0,47.5706,2120
345000.0,3,2.5,1380,0,8,1380,0,47.6908,1380
499000.0,3,1.0,1270,0,7,910,360,47.5694,2000
425000.0,3,1.5,1390,0,7,1390,0,47.634,1460
268000.0,4,3.0,1840,0,8,1840,0,47.2595,1650
240000.0,3,1.0,1600,0,7,1600,0,47.4431,1600
147000.0,3,1.5,1480,0,7,1100,380,47.2978,1600
500000.0,4,2.0,2120,0,6,1770,350,47.6859,1560
1010000.0,4,2.75,2940,2,8,1940,1000,47.6366,1970
991500.0,4,3.0,3820,2,11,3820,0,47.7253,3820
510000.0,5,2.0,2740,0,7,1370,1370,47.6819,1660
1980000.0,4,4.0,4360,0,10,4360,0,47.6377,2180
484998.0,4,2.5,1540,0,8,1540,0,47.5524,1540
1280000.0,4,3.5,4660,2,11,4660,0,47.5422,5080
210000.0,3,1.75,1590,0,7,1590,0,47.3819,1490
450000.0,2,1.0,1180,0,7,1180,0,47.5893,1420
875000.0,4,1.75,2360,0,7,1320,1040,47.6226,1680
529950.0,4,2.75,1860,0,8,1220,640,47.5398,2020
415000.0,3,1.75,1470,0,7,1070,400,47.6067,1280
590000.0,4,2.0,2990,2,7,1960,1030,47.7605,2500
379950.0,3,1.5,1690,0,7,1140,550,47.739,1840
385000.0,1,1.0,660,0,6,660,0,47.5659,1520
588000.0,3,1.75,2310,0,8,2310,0,47.7266,2200
252500.0,2,1.0,770,0,6,770,0,47.5512,940
530000.0,3,3.5,2320,0,9,2060,260,47.6897,2320
385000.0,2,1.5,1370,0,7,1370,0,47.7592,1370
419000.0,3,2.25,1700,0,7,1340,360,47.7214,1980
175000.0,2,1.0,960,0,6,770,190,47.5307,1280
515000.0,2,1.0,1150,0,7,870,280,47.6894,1380
945000.0,4,2.5,2910,0,9,1850,1060,47.6745,1960
359900.0,5,2.25,2290,0,7,1290,1000,47.4375,1660
419950.0,4,2.5,2260,0,8,2260,0,47.509,2260
460000.0,3,1.75,1300,0,7,900,400,47.6368,1750
255000.0,3,2.25,1850,0,7,1850,0,47.2843,1710
481000.0,4,1.75,1920,0,7,1470,450,47.5683,1820
719521.0,4,1.75,1920,0,7,1470,450,47.5683,1820
1080000.0,3,3.0,4910,0,10,4000,910,47.5911,3540
334000.0,4,2.5,2210,2,8,1410,800,47.4915,2210
675000.0,4,2.75,2280,0,8,1520,760,47.6709,1970
556000.0,3,1.75,1640,0,7,1090,550,47.5324,1640
900000.0,4,2.0,1980,3,8,1700,280,47.6318,2490
400000.0,3,1.0,900,0,7,900,0,47.684,1280
724950.0,4,1.75,1960,0,8,980,980,47.6847,1630
321000.0,4,2.25,1800,0,8,1800,0,47.394,2010
1356920.0,4,3.5,4270,3,10,3170,1100,47.6474,3100
171000.0,4,2.0,1520,0,6,1020,500,47.4683,1810
1360000.0,4,3.0,5430,0,10,5430,0,47.6582,3170
323000.0,3,1.75,1950,0,7,1950,0,47.6892,1760
491500.0,4,1.75,2190,2,9,2190,0,47.2703,3000
226000.0,4,1.5,1200,0,7,1200,0,47.3423,1250
580000.0,6,1.75,2180,0,7,1380,800,47.6643,1720
640000.0,4,2.5,2320,0,9,2320,0,47.6443,2820
619790.0,3,1.75,1040,0,7,800,240,47.6385,1630
383962.0,4,2.5,2700,0,8,2700,0,47.4694,2350
373000.0,3,2.0,1400,0,7,840,560,47.5926,1400
541338.0,3,2.5,2060,0,8,1010,1050,47.6642,1760
254922.0,2,1.0,780,0,6,780,0,47.7356,1310
575000.0,3,2.25,2400,0,7,1440,960,47.6897,1630
650000.0,4,3.0,2900,2,7,1870,1030,47.612,2330
269950.0,3,1.5,1740,0,7,1740,0,47.4475,1780
270950.0,2,1.0,780,0,6,780,0,47.5099,1280
495000.0,3,2.75,2430,0,9,1530,900,47.7461,2230
794154.0,4,2.0,2210,1,8,1210,1000,47.6498,2190
340768.0,3,1.5,1510,0,8,1510,0,47.3347,2110
375000.0,2,1.0,900,0,7,900,0,47.7047,1280
820000.0,4,2.5,3670,0,10,3670,0,47.5854,3680
555000.0,2,2.25,1160,0,8,960,200,47.6647,1160
312500.0,2,1.5,1070,0,7,1070,0,47.697,1070
450000.0,2,1.0,950,0,7,950,0,47.6288,2040
739000.0,3,2.75,2950,0,9,2950,0,47.5577,3340
320000.0,3,2.0,1420,0,7,1050,370,47.7364,1420
235000.0,3,1.0,1590,0,6,1590,0,47.4789,1460
275500.0,4,1.0,1290,0,7,1290,0,47.5128,1440
564000.0,2,2.0,1690,0,8,1690,0,47.7133,1640
263000.0,4,1.75,1340,0,6,1340,0,47.4514,1240
257000.0,3,1.75,1397,0,7,1397,0,47.3388,1950
725000.0,4,2.5,3750,0,10,3750,0,47.3045,2540
300000.0,3,2.25,2000,0,7,1400,600,47.4798,2040
328000.0,3,2.0,2250,0,8,2250,0,47.3165,2460
187500.0,3,1.0,840,0,6,840,0,47.3281,1030
400000.0,3,1.0,1100,0,7,1100,0,47.679,1540
515000.0,3,1.5,1660,0,7,1210,450,47.5345,1440
1410000.0,2,2.0,2180,4,9,1580,600,47.5036,2480
235000.0,3,1.0,1460,0,7,1460,0,47.4243,1460
669000.0,4,2.5,2470,0,8,2470,0,47.6898,2510
282000.0,3,1.0,1250,0,6,1250,0,47.526,1450
663000.0,3,2.0,1480,0,7,860,620,47.6808,1660
279900.0,3,3.25,2240,0,9,1540,700,47.4114,1800
335000.0,3,2.0,1570,0,7,1570,0,47.7501,1410
689000.0,4,2.75,3250,0,9,3250,0,47.7557,1620
413100.0,3,2.25,1790,0,7,1250,540,47.7558,2090
506950.0,3,2.5,2080,0,8,2080,0,47.5342,1890
500000.0,3,2.5,1480,0,8,1480,0,47.62,1480
540000.0,5,3.0,3610,0,8,3610,0,47.3545,2800
812000.0,3,2.5,2040,0,9,2040,0,47.6156,1500
1200000.0,4,3.25,3850,3,11,3180,670,47.6239,4320
370000.0,3,2.25,3230,0,9,3230,0,47.3065,2760
338000.0,3,2.0,2440,0,6,1640,800,47.4594,1630
185000.0,4,1.0,1490,0,7,1490,0,47.4835,1280
450000.0,3,1.0,1150,0,7,1010,140,47.5974,2460
451000.0,2,1.0,900,0,7,900,0,47.6855,1460
785000.0,4,2.5,3210,0,11,3210,0,47.6399,3280
850000.0,5,3.0,3900,1,8,2620,1280,47.5577,1950
235000.0,3,1.0,1240,0,7,1240,0,47.3514,1240
1150000.0,3,1.75,1760,4,7,1760,0,47.7336,1630
377500.0,3,2.25,1410,0,7,1290,120,47.5342,1445
825500.0,3,2.5,2780,0,9,2780,0,47.7127,1760
1059500.0,5,3.25,3230,0,9,2480,750,47.6785,1480
880000.0,5,3.5,4600,0,10,3180,1420,47.5491,3210
413800.0,3,2.0,1440,0,8,1440,0,47.7188,1440
504200.0,2,1.5,1200,0,8,1200,0,47.6491,1240
421500.0,4,3.0,2793,0,9,2793,0,47.3682,2793
855169.0,4,2.5,2970,0,8,2970,0,47.7043,2810
380000.0,3,2.0,1440,0,7,850,590,47.5655,1170
580000.0,3,2.25,1480,0,8,1480,0,47.6536,1570
377000.0,3,2.5,1870,0,8,1870,0,47.7447,2100
329900.0,4,2.75,2475,0,7,2475,0,47.3452,2475
921800.0,4,2.5,2950,0,10,2950,0,47.6651,2950
529500.0,3,2.25,1410,0,9,1410,0,47.5818,1510
363990.0,4,2.5,2240,0,8,2240,0,47.3551,2530
834950.0,5,2.75,3230,0,9,3230,0,47.6237,3180
399000.0,3,2.0,2100,0,8,2100,0,47.6907,1860
338900.0,3,2.25,1936,0,8,1936,0,47.3714,1410
419950.0,3,2.5,3120,0,9,3120,0,47.3473,2670
493000.0,4,2.5,2070,0,8,2070,0,47.773,2070
650000.0,4,2.5,3700,0,9,3700,0,47.7473,3050
456000.0,3,2.5,2130,0,8,2130,0,47.4832,2250
425000.0,3,2.25,1620,0,8,1540,80,47.54,1620
348000.0,3,2.5,1490,0,8,1490,0,47.7236,1270
1040890.0,5,4.0,4180,0,9,4180,0,47.7049,3570
299000.0,2,2.5,1400,0,8,1160,240,47.5342,1060
1264000.0,4,3.75,3490,0,9,3490,0,47.5991,1810
155000.0,3,1.0,1300,0,7,1300,0,47.7074,1300
319500.0,4,2.5,2730,0,8,2730,0,47.3363,2150
274000.0,3,2.5,1830,0,8,1830,0,47.4496,1610
429000.0,5,2.5,2340,0,7,2340,0,47.4911,2190
267800.0,3,1.75,1410,0,8,1410,0,47.5171,1410
369950.0,3,2.5,1930,0,7,1930,0,47.4973,1540
480000.0,6,5.0,3028,0,7,3028,0,47.3651,1400
440000.0,4,3.5,3180,0,8,2390,790,47.4482,2850
839704.0,4,3.25,2950,0,10,2210,740,47.5297,2790
535000.0,3,3.25,1430,0,8,1430,0,47.6712,1430
290000.0,2,1.5,1020,0,8,1020,0,47.7003,980
370000.0,3,2.5,1650,0,8,1650,0,47.7107,1650
405000.0,3,2.0,1060,0,7,1060,0,47.6828,1440
499431.0,4,2.75,2620,0,8,2620,0,47.484,2790
275000.0,4,2.5,1830,0,7,1830,0,47.5186,2330
320000.0,3,2.25,998,0,7,798,200,47.6983,998
425000.0,4,2.5,2070,0,7,2070,0,47.5208,2070
1450000.0,4,3.5,2860,0,10,2860,0,47.6262,1990
340000.0,3,2.0,1920,3,9,1920,0,47.1952,2384
299900.0,3,2.5,1210,0,9,920,290,47.5212,1070
865950.0,5,3.5,4890,0,9,3590,1300,47.7338,4590
720000.0,4,2.5,3420,0,9,3420,0,47.718,2520
460000.0,4,3.5,2870,3,9,2070,800,47.5009,1770
375000.0,3,2.5,1600,0,8,1600,0,47.5341,1445
386180.0,2,1.5,960,0,7,960,0,47.6032,1470
280000.0,3,2.75,1740,3,7,1740,0,47.1942,2380
359000.0,4,2.5,2575,0,8,2575,0,47.3058,2575
785000.0,5,3.25,3660,2,10,3660,0,47.5337,3320
425000.0,3,2.25,1420,0,8,940,480,47.5703,1400
575000.0,5,2.5,3070,0,8,3070,0,47.4939,2590
465000.0,3,2.5,1920,0,8,1920,0,47.2683,2010
1850000.0,4,3.25,4160,0,10,4160,0,47.6235,1840
720000.0,4,3.25,3276,0,9,3276,0,47.4585,2010
390000.0,5,3.75,2890,0,7,1310,1580,47.5701,1930
2205000.0,3,2.5,3430,0,10,3430,0,47.7159,3110
1054690.0,4,3.5,3390,0,9,2610,780,47.6482,3350
915000.0,6,3.75,2930,3,9,2930,0,47.5441,3210
562000.0,2,2.25,1300,0,8,1300,0,47.6536,1300
349000.0,2,1.75,1250,0,7,1040,210,47.6004,1250
375000.0,4,2.5,2310,0,8,2310,0,47.3737,2310
479950.0,2,2.25,1360,0,8,1360,0,47.6714,1280
319000.0,4,2.5,2020,0,7,2020,0,47.2822,2300
325000.0,3,1.5,1270,0,8,1270,0,47.7236,1090
505657.0,4,2.75,2790,0,8,2790,0,47.4834,2790
340000.0,4,2.5,2320,0,7,2320,0,47.3662,2150
250000.0,3,2.5,1750,0,7,1750,0,47.2589,1398
349500.0,4,2.5,2030,0,8,2030,0,47.3515,2040
290750.0,3,2.5,1270,0,7,1080,190,47.5351,1630
715000.0,5,3.25,2710,0,8,2230,480,47.5394,2160
689950.0,4,2.75,2520,0,8,2520,0,47.7214,1890
425000.0,2,2.5,1340,0,8,1340,0,47.6788,1510
657000.0,2,3.0,1570,0,8,1570,0,47.6741,1570
359950.0,4,3.5,2690,0,7,2690,0,47.3537,2210
319900.0,4,2.75,2475,0,7,2475,0,47.345,2475
532000.0,3,3.75,2260,0,9,1170,1090,47.566,2130
291000.0,2,1.0,840,0,8,840,0,47.6974,1110
675000.0,3,3.25,1720,0,8,1030,690,47.62,1720
885000.0,3,2.25,2940,0,9,2940,0,47.5482,1680
1450000.0,5,3.5,4170,0,10,4170,0,47.5918,1930
780000.0,6,4.25,4310,0,8,2950,1360,47.6214,2100
839950.0,4,2.75,3010,0,9,3010,0,47.6948,3010
645000.0,3,2.5,2170,0,8,2170,0,47.5401,2150
263000.0,3,2.5,1584,0,7,1584,0,47.3451,1584
345000.0,2,2.25,1110,0,8,1110,0,47.6968,1360
505000.0,4,2.5,2420,0,8,2420,0,47.4795,2750
522500.0,2,2.25,1430,0,8,1340,90,47.6765,1430
400000.0,3,2.5,2393,0,8,2393,0,47.4517,2439
543000.0,3,2.25,1240,0,8,1240,0,47.6488,1310
495000.0,4,2.5,2980,0,8,1910,1070,47.5074,2240
549995.0,4,3.5,2970,0,8,2260,710,47.4776,2970
327555.0,3,2.5,2329,0,8,2329,0,47.362,2197
690000.0,5,3.25,3340,0,8,2600,740,47.5446,2770
673000.0,4,2.25,2580,0,9,2580,0,47.5674,1290
384435.0,3,2.5,2029,0,9,2029,0,47.341,2029
780000.0,4,2.75,3430,0,9,3050,380,47.7079,3070
1375000.0,5,3.75,3330,2,9,2470,860,47.6497,1780
950968.0,5,3.5,3220,0,8,3220,0,47.7048,2970
334950.0,2,2.25,1240,0,7,1150,90,47.5322,1240
489000.0,3,3.5,1500,0,8,1240,260,47.6727,1440
600000.0,3,3.0,3530,0,10,3530,0,47.7338,1940
282000.0,3,2.25,1260,0,8,1020,240,47.555,1260
442000.0,4,4.0,4168,0,10,3222,946,47.3029,4362
220000.0,2,1.5,1030,0,7,1030,0,47.3845,1030
489000.0,3,2.5,3080,0,8,3080,0,47.4372,3080
250000.0,3,1.5,1072,0,7,1072,0,47.386,1443
484259.0,4,2.75,2790,0,8,2790,0,47.4831,2620
1680000.0,3,2.5,4090,2,11,3590,500,47.7258,3740
450000.0,3,2.5,1800,0,8,1800,0,47.5337,1800
299000.0,2,1.5,830,0,7,830,0,47.6175,1540
450000.0,3,2.5,2280,0,8,2280,0,47.7733,2070
585000.0,4,3.0,2110,0,9,1710,400,47.5444,2000
660000.0,3,2.25,1570,0,8,1570,0,47.6585,1290
301500.0,2,1.5,830,0,7,830,0,47.5506,1120
949950.0,4,3.75,4120,0,10,4120,0,47.5872,3730
759990.0,4,2.5,2540,0,9,2540,0,47.5405,2580
355000.0,4,2.75,2050,0,8,2050,0,47.3522,2050
889950.0,4,2.75,3080,0,9,3080,0,47.6948,3010
629800.0,3,2.5,2390,0,8,2220,170,47.5405,2150
745000.0,4,2.5,3170,0,9,3170,0,47.5187,1580
379900.0,2,1.5,1240,0,7,1050,190,47.5959,1250
335000.0,3,2.5,1090,0,8,960,130,47.5664,1400
809000.0,5,4.5,4630,0,9,3210,1420,47.5382,4420
569950.0,4,2.5,3230,0,8,3230,0,47.515,2720
723000.0,4,3.5,3510,0,10,3510,0,47.5413,3690
282000.0,4,2.5,1785,0,8,1785,0,47.3582,1691
569900.0,5,3.25,2360,0,8,1990,370,47.5635,1720
385000.0,4,2.0,2340,0,7,2340,0,47.4842,1180
420000.0,3,2.25,1620,0,8,1540,80,47.5405,1620
2250000.0,3,3.25,3890,0,12,2890,1000,47.626,2860
1205000.0,4,3.5,3590,2,9,3140,450,47.6762,2100
292000.0,4,3.0,1984,0,7,1984,0,47.3532,2095
645000.0,3,2.25,1640,0,8,1640,0,47.6636,1720
304500.0,4,2.0,1350,0,7,1350,0,47.5394,1390
489500.0,4,3.5,2730,0,8,2000,730,47.7327,2430
1583000.0,4,4.0,5610,0,11,4750,860,47.65,4560
390000.0,2,1.0,962,0,7,962,0,47.6911,1130
815000.0,4,3.5,3040,0,8,2350,690,47.5439,2050
719000.0,3,3.5,2540,1,9,2010,530,47.547,3240
331210.0,4,2.5,2240,0,8,2240,0,47.2911,2240
245000.0,3,1.5,1260,0,7,1040,220,47.7111,1260
465000.0,5,4.0,3210,0,8,2410,800,47.7329,2750
580000.0,3,2.5,1620,4,8,1470,150,47.6681,1620
540000.0,3,2.0,1580,2,8,1180,400,47.5903,1500
399000.0,3,2.5,1430,0,7,1430,0,47.6904,1360
328000.0,4,2.5,1850,0,8,1850,0,47.3494,2140
701000.0,4,2.5,3340,0,10,3340,0,47.5167,3220
408000.0,3,2.75,2670,0,8,2670,0,47.3483,2340
2641100.0,5,4.25,4660,2,11,4660,0,47.6326,3340
445000.0,3,2.5,1550,0,8,1060,490,47.5857,1550
672500.0,4,2.5,3470,0,9,3470,0,47.5426,2730
538000.0,3,2.5,3010,0,8,3010,0,47.4949,3030
450000.0,5,3.5,3931,0,10,2650,1281,47.3008,3510
362500.0,3,2.5,1800,0,8,1800,0,47.5458,1380
414950.0,3,2.5,1570,0,8,1570,0,47.6961,1570
679950.0,3,2.5,2230,0,8,2230,0,47.73,2230
290000.0,4,2.5,2423,0,8,2423,0,47.3227,2495
230000.0,3,2.0,1160,0,7,790,370,47.5225,1160
439950.0,2,2.0,1440,0,8,1440,0,47.709,1510
349900.0,4,2.5,2052,0,8,2052,0,47.2824,2052
550000.0,5,2.5,2780,0,8,2780,0,47.5168,1150
1050000.0,4,4.25,3720,2,9,2960,760,47.5632,2550
655000.0,2,2.25,1460,0,9,1180,280,47.6461,1800
385000.0,3,3.5,1370,0,8,1100,270,47.5638,1370
729999.0,6,4.5,3600,0,9,2510,1090,47.5687,1360
523950.0,3,2.25,1420,0,8,1420,0,47.6533,1530
369000.0,2,2.5,980,0,8,670,310,47.5874,980
509900.0,3,2.5,1790,0,8,1790,0,47.564,1890
282000.0,3,2.5,2010,0,7,2010,0,47.3338,2280
387865.0,3,2.5,2370,0,8,2370,0,47.3696,2370
385000.0,4,2.5,2560,0,8,2560,0,47.4899,2560
536000.0,3,2.5,1900,0,7,1900,0,47.5941,2260
395000.0,2,2.25,1350,0,8,1050,300,47.5421,1250
545000.0,4,2.75,2650,0,10,2650,0,47.4947,2740
715000.0,4,2.5,3020,4,9,3020,0,47.5344,3020
348000.0,3,2.5,1500,0,7,1500,0,47.5538,1440
455000.0,3,1.75,1320,0,9,1320,0,47.6047,1380
575000.0,4,2.75,3120,0,10,3120,0,47.5156,2980
449950.0,3,2.25,1540,0,7,1540,0,47.6935,1230
364000.0,3,2.5,1800,0,8,1800,0,47.5455,1580
932990.0,4,2.5,3640,0,9,3640,0,47.7049,3570
710000.0,3,2.5,2440,0,9,2440,0,47.665,2030
949990.0,4,4.0,3970,0,9,3970,0,47.6173,3560
326989.0,3,2.5,2060,0,8,2060,0,47.3706,2370
335606.0,3,2.5,2538,0,8,2538,0,47.2584,2570
1532500.0,5,4.5,4270,0,11,3400,870,47.699,4100
299950.0,3,2.5,1320,0,7,1320,0,47.5328,1390
962000.0,4,2.75,3340,0,11,3340,0,47.5059,3340
395825.0,2,2.5,1590,0,8,1590,0,47.5449,1590
419354.0,5,2.75,2710,0,8,2710,0,47.3547,2710
920000.0,4,2.75,3140,1,10,3140,0,47.7064,2990
366000.0,3,2.25,1445,0,7,1300,145,47.5339,1445
480000.0,4,2.5,2430,0,7,2430,0,47.515,2430
388000.0,3,3.25,1370,0,8,1100,270,47.5639,1370
2320000.0,4,3.5,5050,0,11,3610,1440,47.6364,2430
730000.0,3,2.5,1860,0,9,1240,620,47.6179,1710
950000.0,5,3.75,5330,2,10,3570,1760,47.5401,4420
358990.0,3,3.25,1710,0,7,1400,310,47.5434,1380
398651.0,4,2.5,2650,0,8,2650,0,47.5019,2030
530000.0,4,2.5,2590,0,9,2590,0,47.5055,1400
610360.0,4,2.5,2610,0,9,2610,0,47.5137,2720
436110.0,3,2.5,1770,0,8,1600,170,47.6965,1680
925000.0,4,2.75,3730,0,10,3730,0,47.6036,3670
449950.0,4,2.5,2420,0,9,2420,0,47.4729,1400
760000.0,4,2.5,3330,0,9,3330,0,47.679,2640
293000.0,3,2.25,1910,0,8,1910,0,47.4293,1714
695000.0,2,2.5,2170,2,8,2170,0,47.7112,2300
285000.0,3,2.5,2437,0,7,2437,0,47.3517,2437
1255780.0,5,4.0,4180,0,10,4180,0,47.5959,1800
379900.0,3,2.5,1800,0,8,1800,0,47.5442,1580
472000.0,5,2.5,2570,0,8,2570,0,47.7265,2890
300000.0,4,2.5,2090,0,7,2090,0,47.3986,2090
272000.0,4,2.5,2789,0,7,2789,0,47.3059,2547
418395.0,4,2.5,2906,0,9,2906,0,47.2599,2680
465000.0,5,2.5,2550,0,7,2550,0,47.5191,2190
659950.0,4,2.75,3550,0,9,3550,0,47.4827,3550
484950.0,3,2.25,1590,0,8,1590,0,47.5402,1640
359000.0,3,2.25,1950,0,7,1160,790,47.5179,1950
519000.0,4,2.5,3250,0,8,3250,0,47.4944,3030
1710000.0,5,4.5,4590,0,10,4590,0,47.664,3030
535000.0,4,2.75,3070,0,9,3070,0,47.4897,2880
622950.0,4,3.25,3030,0,8,2830,200,47.5457,3400
515000.0,3,2.5,2610,0,8,2610,0,47.4821,2810
330000.0,4,3.5,3150,0,7,3150,0,47.3993,2950
318000.0,3,1.5,1240,0,8,1240,0,47.7235,1240
439000.0,3,2.5,1680,0,7,1680,0,47.745,1920
540000.0,3,2.5,2220,0,8,2220,0,47.5132,1610
1079000.0,4,3.25,4800,0,10,4800,0,47.5311,4750
435000.0,4,2.5,3100,0,9,3100,0,47.3785,2450
2700000.0,4,4.0,7850,0,12,7850,0,47.5406,6210
1100000.0,4,2.75,3590,0,10,3590,0,47.6959,3590
293467.0,4,2.0,1590,0,7,1590,0,47.54,1390
328000.0,3,2.5,2242,0,8,2242,0,47.2581,2009
550000.0,3,3.5,2490,0,8,1720,770,47.5338,1445
649000.0,3,2.0,1530,0,9,1530,0,47.6692,1620
435000.0,4,2.5,2150,0,7,2150,0,47.5048,2640
625000.0,3,2.5,2440,0,10,2440,0,47.5595,1180
415000.0,3,1.5,1270,0,8,1270,0,47.6987,1270
400000.0,3,2.25,1450,0,7,1450,0,47.761,1490
979000.0,3,2.5,2690,0,10,2690,0,47.6797,2040
625250.0,4,2.5,2755,0,7,2755,0,47.685,2510
665000.0,4,3.5,2650,0,8,2230,420,47.5377,2330
589500.0,3,3.25,2310,0,8,1730,580,47.5644,2310
437000.0,2,3.0,1460,0,8,1140,320,47.5224,1460
320000.0,3,1.0,1400,0,7,1400,0,47.5022,1440
333500.0,3,2.5,2196,0,8,2196,0,47.3803,1860
430000.0,3,2.25,2020,0,8,1680,340,47.5633,1720
995500.0,5,4.5,4280,0,10,4280,0,47.7325,2990
427874.0,3,3.0,2340,0,8,2340,0,47.4831,2790
334990.0,4,2.5,2220,0,8,2220,0,47.5014,2220
909500.0,4,4.0,4420,0,10,3410,1010,47.5397,4510
210000.0,3,2.0,1580,0,7,1580,0,47.3338,2280
952990.0,4,2.75,3550,0,9,3550,0,47.7076,3140
622500.0,2,1.75,1510,0,8,1420,90,47.6536,1300
515000.0,3,3.5,1360,0,8,1040,320,47.6697,1560
350000.0,3,2.5,2040,0,8,2040,0,47.3122,1850
310000.0,1,1.5,1120,0,7,1120,0,47.5924,1380
700000.0,4,3.5,4490,0,9,3390,1100,47.5394,4290
907687.0,4,2.5,3560,0,9,2930,630,47.5756,3560
741500.0,2,2.5,2150,0,8,2150,0,47.7094,1640
395000.0,3,2.5,2130,0,8,1840,290,47.7329,2130
559950.0,5,2.75,2990,0,8,2990,0,47.4853,2730
215000.0,4,2.5,1847,0,7,1847,0,47.2872,1847
390000.0,4,2.5,2610,0,9,2610,0,47.314,2630
425000.0,3,2.25,1670,0,7,1670,0,47.2743,3310
472000.0,3,2.5,1860,0,7,1860,0,47.3974,2070
1330000.0,4,3.5,3440,0,10,3440,0,47.5374,2400
695000.0,4,3.5,3510,0,10,3510,0,47.54,3510
545000.0,3,2.5,1740,0,8,1740,0,47.589,1740
389950.0,4,2.5,2240,0,8,2240,0,47.496,700
380000.0,3,2.25,1550,0,8,1550,0,47.6989,1550
288790.0,4,2.0,1390,0,7,1390,0,47.5401,1390
432500.0,3,3.0,2500,0,8,2500,0,47.4408,2130
615000.0,3,3.5,2710,0,8,1650,1060,47.5371,2280
500000.0,3,2.5,1720,0,9,1720,0,47.7312,1720
615000.0,3,2.25,1760,0,9,1760,0,47.6073,1346
500000.0,4,2.25,2270,0,7,1150,1120,47.7214,1920
622000.0,3,3.5,1690,0,8,1370,320,47.6536,1690
802945.0,5,3.5,4000,0,9,4000,0,47.5265,3690
1260000.0,4,2.5,2880,0,10,2880,0,47.6844,2640
598950.0,3,2.5,1480,0,8,1480,0,47.669,1530
430000.0,3,2.5,1950,0,7,1950,0,47.5155,2200
515000.0,4,2.75,2700,0,9,2700,0,47.5209,2700
1262000.0,2,3.0,2210,0,10,1500,710,47.6166,1720
400000.0,4,3.5,2370,0,8,2370,0,47.5044,2520
390000.0,3,2.5,1310,0,7,850,460,47.5622,1310
450000.0,3,2.5,2410,0,7,2410,0,47.5196,2190
804995.0,5,1.5,3360,0,9,3360,0,47.6067,3360
825000.0,4,3.25,3040,0,8,2350,690,47.5429,2680
435000.0,4,2.25,2140,0,7,2140,0,47.5367,2480
398000.0,3,2.5,1720,0,7,1240,480,47.5481,1610
411605.0,4,2.5,2658,0,9,2658,0,47.2603,2578
315000.0,3,3.25,1480,0,8,1180,300,47.5555,1330
455000.0,2,2.0,1350,0,8,1350,0,47.649,1310
452950.0,3,2.5,1150,0,8,1020,130,47.6684,1450
380000.0,3,1.75,1690,0,8,1380,310,47.563,1690
340000.0,2,1.75,1270,0,8,1270,0,47.5648,1140
409950.0,3,2.5,2655,0,8,2655,0,47.2972,2879
360000.0,2,1.0,880,0,8,880,0,47.6192,1640
1595000.0,4,4.25,4645,0,10,3855,790,47.6248,2150
440000.0,3,1.5,1270,0,8,1270,0,47.699,1270
730000.0,2,1.75,1728,3,9,1728,0,47.4579,1720
408000.0,3,2.25,1950,0,8,1950,0,47.431,2310
820000.0,4,2.5,3170,0,8,3170,0,47.6705,2840
360000.0,2,2.5,1233,0,7,963,270,47.5533,1230
339990.0,3,2.5,2570,0,8,2570,0,47.2582,2570
515000.0,3,2.0,1560,0,8,1560,0,47.605,1560
541000.0,3,1.75,1630,0,8,1020,610,47.6646,1420
375000.0,4,2.5,2510,0,9,2510,0,47.5096,1830
320000.0,4,2.5,2223,0,8,2223,0,47.3586,1690
325000.0,2,2.25,1230,0,7,1160,70,47.5325,1240
740000.0,5,2.75,3050,0,8,3050,0,47.5245,2180
450000.0,5,2.75,2710,0,8,2710,0,47.3555,2530
455000.0,4,2.5,2090,0,8,2090,0,47.5403,2090
292500.0,3,2.5,1440,0,8,1160,280,47.5393,1580
650000.0,3,2.5,2500,0,9,1510,990,47.4694,2270
530000.0,4,2.75,2740,0,10,2740,0,47.4954,1220
829995.0,5,3.25,3360,0,9,3360,0,47.607,3230
395000.0,4,2.75,2280,0,8,2280,0,47.7333,2130
859990.0,4,2.75,3520,0,9,3520,0,47.6181,3340
342500.0,2,1.5,1320,0,8,1100,220,47.5879,1340
743000.0,4,2.75,3410,0,9,3410,0,47.6931,3420
345000.0,3,2.25,2730,0,7,1390,1340,47.3785,2255
443000.0,3,2.5,1780,0,8,1530,250,47.5487,1380
260000.0,3,2.5,1427,0,7,1427,0,47.3857,1443
810000.0,4,2.5,2910,0,9,2910,0,47.6659,2910
570000.0,4,2.75,3250,0,8,3250,0,47.4806,2730
1563100.0,5,3.5,3630,0,10,3630,0,47.5951,1730
840000.0,2,2.5,1680,0,9,1680,0,47.6321,1680
950000.0,3,2.5,2280,0,9,1890,390,47.6256,1390
572800.0,3,2.5,3310,0,9,2380,930,47.5201,2660
305000.0,3,3.0,1290,0,7,1290,0,47.7282,1230
1695000.0,5,4.75,3940,0,10,3230,710,47.6232,1910
445000.0,4,2.5,2170,0,7,1630,540,47.5589,1720
801000.0,4,3.5,3290,0,9,3290,0,47.5573,3290
711000.0,3,2.5,2550,0,9,2550,0,47.6647,2250
268500.0,3,2.25,1140,0,7,850,290,47.5439,1140
320000.0,4,2.5,2300,0,7,2300,0,47.3594,2110
500000.0,4,3.25,2670,0,9,1640,1030,47.5666,1610
631625.0,4,2.5,2440,0,9,2440,0,47.6971,1350
850000.0,2,2.5,1611,2,10,1611,0,47.6291,2070
600000.0,3,3.5,2710,0,8,1650,1060,47.5367,2440
988500.0,3,2.75,2015,4,9,2015,0,47.45,1780
430236.0,4,3.25,3444,0,8,2714,730,47.2966,2848
1266520.0,3,2.5,3060,0,10,3060,0,47.5928,3060
689500.0,4,2.5,2050,0,8,2050,0,47.5431,1800
175003.0,3,1.5,1390,0,7,1390,0,47.5667,1490
459000.0,2,2.5,1240,0,8,1240,0,47.6718,1240
1180000.0,4,3.25,3750,0,10,3750,0,47.658,4920
358000.0,3,3.25,1410,0,8,1360,50,47.7183,1500
447055.0,4,2.5,2448,0,9,2448,0,47.3428,2815
415000.0,3,2.75,2600,0,8,2600,0,47.7185,1740
1210000.0,4,3.25,3330,0,9,2870,460,47.6836,2550
495000.0,2,2.25,1160,0,8,1000,160,47.6207,1200
479000.0,2,2.25,1330,0,8,1060,270,47.577,1580
1898000.0,3,2.5,2830,4,10,2830,0,47.6318,2830
249900.0,3,2.5,1610,0,8,1610,0,47.4496,1830
1465000.0,4,2.5,2800,0,9,2800,0,47.6695,1770
1037000.0,5,3.75,4570,0,11,4570,0,47.718,2040
897000.0,4,2.5,2820,0,9,2820,0,47.6911,1510
1100000.0,4,2.5,2570,0,9,2570,0,47.6548,2570
685000.0,3,2.25,1710,0,9,1140,570,47.6173,1510
295000.0,3,1.5,1220,0,7,1220,0,47.7168,1220
619000.0,3,2.25,1650,0,8,1650,0,47.6536,1570
439108.0,2,1.5,1130,0,8,910,220,47.5761,1310
260000.0,3,2.25,1489,0,7,1489,0,47.3452,1584
279000.0,5,2.5,2690,0,7,2690,0,47.4914,2090
380000.0,3,2.25,1530,0,7,1116,414,47.7034,1320
287000.0,3,2.5,1600,0,8,1600,0,47.2611,1608
377000.0,2,1.5,1000,0,7,930,70,47.6529,1420
649950.0,4,3.5,2440,1,8,2440,0,47.6923,1860
445000.0,3,2.5,1260,0,8,1260,0,47.675,1320
605000.0,3,2.5,1660,0,7,1610,50,47.6801,1210
475000.0,3,2.25,1190,0,7,960,230,47.677,1190
399000.0,3,3.0,1520,0,8,1520,0,47.7176,1360
718000.0,5,2.75,3250,0,8,3250,0,47.7133,1270
1400000.0,4,3.25,4700,4,11,2520,2180,47.5744,2240
341000.0,3,2.5,1480,0,9,1180,300,47.5443,1380
818000.0,2,2.5,2380,2,8,2380,0,47.7095,1610
759000.0,3,2.25,1640,0,8,1640,0,47.6196,1640
547500.0,3,3.5,1650,0,8,1650,0,47.6823,1620
2700000.0,5,4.75,5305,2,11,3745,1560,47.6864,2960
358000.0,2,2.5,1278,0,7,1002,276,47.5532,1220
412000.0,3,2.5,1200,0,9,1200,0,47.5894,1750
245000.0,2,1.5,690,0,7,690,0,47.6951,690
460940.0,4,2.5,3202,0,9,3202,0,47.3412,2425
321000.0,3,2.25,1347,0,7,1347,0,47.7306,1480
633634.0,4,3.5,2960,0,9,2960,0,47.5183,2960
290000.0,1,0.75,740,0,6,740,0,47.6741,1430
445000.0,2,2.25,1200,0,7,1200,0,47.6715,1280
887250.0,5,3.5,4320,0,9,3500,820,47.5235,3250
739000.0,3,2.5,2310,3,8,2310,0,47.7116,2310
429900.0,3,2.0,1490,0,8,1490,0,47.57,1420
459000.0,3,2.0,1480,0,8,1000,480,47.5492,1480
240000.0,3,2.25,1481,0,7,1481,0,47.3457,1481
566950.0,3,3.0,1730,0,8,1730,0,47.6944,1830
1040000.0,4,3.5,3900,0,10,3900,0,47.6979,3820
343000.0,3,3.5,1130,0,7,1130,0,47.6968,1130
572115.0,4,3.25,3230,0,9,3230,0,47.3559,2980
918000.0,5,3.5,3920,0,9,2820,1100,47.6638,3170
555000.0,2,1.5,1190,0,8,1190,0,47.6161,1280
399440.0,4,2.5,2311,0,9,2311,0,47.3276,2458
450000.0,3,2.5,1810,0,8,1380,430,47.5732,1810
648000.0,4,2.5,3290,0,9,3290,0,47.5441,2990
580000.0,4,2.5,3250,0,8,3250,0,47.4988,3230
415000.0,4,2.5,2544,0,9,2544,0,47.341,2358
527500.0,3,2.5,1380,0,8,1380,0,47.6427,1380
384000.0,3,2.25,1430,0,8,1140,290,47.5477,1430
692000.0,3,2.5,3490,2,9,2242,1248,47.365,2120
455000.0,2,1.5,910,0,8,820,90,47.627,2740
1280000.0,4,3.25,3080,0,9,2380,700,47.6845,1410
415000.0,3,2.5,2280,0,8,2280,0,47.7322,2430
975000.0,3,2.5,1660,0,8,1660,0,47.644,1750
799950.0,4,2.5,3320,0,9,3320,0,47.7189,1840
545000.0,5,4.0,1680,0,8,1370,310,47.5571,2040
429900.0,4,3.5,2584,0,8,2584,0,47.296,2767
275000.0,3,2.5,2217,0,7,2217,0,47.2776,1470
498000.0,3,2.5,2480,0,8,2480,0,47.493,2510
754950.0,3,2.5,2610,0,9,2610,0,47.695,2610
895000.0,4,3.0,3240,0,10,3240,0,47.5919,3380
580000.0,4,3.25,3569,0,10,3569,0,47.4595,2550
379900.0,4,2.5,3181,0,8,3181,0,47.2716,2056
245000.0,4,2.5,1921,0,7,1921,0,47.2689,1921
417000.0,3,2.5,1570,0,8,1570,0,47.5342,1800
555000.0,3,2.5,1940,0,8,1940,0,47.5644,1880
555000.0,3,2.5,1940,0,8,1940,0,47.5644,1880
353000.0,4,2.5,2210,0,8,2210,0,47.3122,1850
539000.0,3,2.25,1280,0,8,1080,200,47.6651,1280
434900.0,3,2.0,1520,0,7,1520,0,47.777,1860
325000.0,2,2.25,1230,0,7,1160,70,47.5324,1240
650000.0,3,2.5,1480,0,8,1480,0,47.6533,1480
379950.0,4,2.5,2612,0,8,2612,0,47.3751,2419
700000.0,3,2.5,2350,0,8,2350,0,47.5418,2350
675000.0,3,2.5,1300,0,8,1100,200,47.6384,1070
379000.0,4,1.5,2020,0,7,2020,0,47.502,1410
571000.0,3,2.5,2140,0,8,1960,180,47.5357,2280
475000.0,3,2.25,1380,0,8,1140,240,47.678,1460
769900.0,4,3.5,2730,0,8,2400,330,47.5797,1980
633000.0,4,3.5,4220,0,9,2910,1310,47.5392,4290
635000.0,3,2.5,1570,0,8,1570,0,47.6858,1570
1238000.0,4,3.5,4670,3,11,3820,850,47.5414,4310
524000.0,3,2.25,1370,0,8,1330,40,47.6682,1570
485000.0,4,3.5,3273,0,8,2671,602,47.4477,2996
1030000.0,3,4.0,3880,3,11,3700,180,47.6996,3880
650000.0,3,3.5,1494,0,8,1494,0,47.6826,1494
754842.0,3,2.5,2930,0,8,2930,0,47.71,3300
428900.0,4,2.5,2598,0,9,2598,0,47.3412,2502
329900.0,3,2.5,2242,0,8,2242,0,47.2595,1798
1035290.0,4,2.5,2830,0,9,2830,0,47.6479,2840
544999.0,4,2.5,2710,0,7,2710,0,47.5153,2380
449950.0,4,2.75,2320,0,8,2320,0,47.4862,2310
635000.0,4,2.5,2720,0,9,2720,0,47.7168,1590
599000.0,3,1.75,1650,0,8,1650,0,47.6638,1650
478000.0,3,3.25,1430,0,8,1160,270,47.6743,1160
388000.0,4,2.5,2090,0,9,2090,0,47.4797,1430
809950.0,4,3.5,3660,0,9,2760,900,47.7184,3630
1060000.0,4,3.5,4220,0,10,4220,0,47.5869,3730
659000.0,2,2.5,1450,0,9,1110,340,47.6692,1620
971971.0,4,3.75,3460,0,11,3460,0,47.506,3340
389000.0,3,2.5,1350,0,8,1270,80,47.5491,1350
355000.0,4,2.75,3000,0,8,3000,0,47.3613,2420
551500.0,4,2.5,2950,0,9,2950,0,47.489,2790
417838.0,4,2.5,2530,0,8,2530,0,47.3559,2530
1750000.0,4,4.5,4650,0,11,3640,1010,47.6349,1710
399950.0,2,1.0,710,0,7,710,0,47.6413,1370
740000.0,4,2.5,3050,0,9,3050,0,47.7465,1910
335000.0,3,2.5,1150,0,7,1150,0,47.5323,1150
2250000.0,5,5.25,3410,0,11,3410,0,47.6295,3410
667000.0,3,1.75,1370,0,8,1370,0,47.6595,1370
920000.0,4,2.5,3540,0,9,3540,0,47.6749,2150
368000.0,3,2.5,1370,0,7,1010,360,47.5534,1450
307000.0,4,2.5,1714,0,8,1714,0,47.429,1714
550000.0,4,2.75,3650,0,7,2940,710,47.7397,2400
594491.0,4,2.5,2990,0,9,2990,0,47.4766,2990
460458.0,4,2.5,3284,0,8,3284,0,47.3393,2555
859000.0,4,2.25,3550,0,8,1830,1720,47.5681,2770
399950.0,3,3.0,1860,0,8,1710,150,47.5511,1350
547500.0,3,3.25,1720,0,8,1360,360,47.6127,1720
310000.0,3,2.5,2540,0,7,2540,0,47.3341,2270
939000.0,4,2.75,3270,0,9,3270,0,47.6679,2420
329900.0,2,2.5,980,0,8,980,0,47.6844,980
436000.0,3,2.5,1150,0,8,1020,130,47.6684,1450
320000.0,3,2.5,1820,0,8,1570,250,47.4643,1470
375000.0,3,2.5,1580,0,8,1580,0,47.5458,1380
392137.0,3,2.0,1460,0,7,1460,0,47.6861,1720
520000.0,4,2.5,2900,0,8,2900,0,47.7717,2590
535000.0,5,2.75,2620,0,9,2620,0,47.77,2620
407000.0,2,2.5,1340,0,8,940,400,47.5655,1470
424950.0,4,3.25,3266,0,8,3266,0,47.2975,3087
290000.0,2,1.5,1076,0,7,1076,0,47.7167,1076
399000.0,3,3.25,1680,0,8,1360,320,47.5674,1530
439990.0,3,2.5,1930,0,8,1300,630,47.6513,1630
635000.0,4,2.5,2880,0,9,1940,940,47.5711,1560
635000.0,4,2.25,2240,0,8,2240,0,47.6212,1760
351000.0,3,2.5,2594,0,8,2594,0,47.3054,2981
437500.0,2,1.5,1210,0,8,1210,0,47.6712,1330
919204.0,4,3.5,3760,0,9,2860,900,47.6826,1340
923990.0,4,2.5,3600,0,9,3600,0,47.7053,3590
639888.0,4,2.5,2050,0,8,2050,0,47.5421,2050
675000.0,3,3.25,1510,0,8,1220,290,47.6398,1670
899900.0,4,2.5,2580,0,8,2580,0,47.6852,1820
252000.0,3,2.5,1670,0,7,1670,0,47.53,1670
925000.0,4,2.5,3190,0,9,3190,0,47.6379,2110
552000.0,3,2.5,1280,0,8,1280,0,47.6621,1450
388500.0,4,2.5,2718,0,8,2718,0,47.3255,2667
548000.0,2,2.0,1370,0,8,1370,0,47.6721,1280
254950.0,3,2.5,1794,0,7,1794,0,47.3052,3557
1237500.0,4,4.5,5120,0,10,3290,1830,47.7009,3360
629000.0,3,2.5,2160,0,9,1970,190,47.5642,1810
734000.0,4,2.5,2180,0,8,2180,0,47.7221,1500
309000.0,3,2.25,1490,0,7,1220,270,47.5569,1490
554950.0,3,2.5,2950,0,9,2950,0,47.4888,2800
785000.0,3,2.75,2990,0,9,2990,0,47.662,2590
550000.0,4,2.5,2700,0,9,2700,0,47.5071,3160
1010000.0,4,3.5,3130,0,10,3130,0,47.5656,1950
1575000.0,3,2.0,3620,0,8,3220,400,47.5767,2370
309000.0,5,2.75,2481,0,8,2481,0,47.2602,2363
328423.0,3,2.5,1730,0,8,1730,0,47.5019,2030
345000.0,3,1.5,1420,0,8,1140,280,47.5881,1340
660000.0,5,3.5,3160,0,9,3160,0,47.755,2100
385000.0,3,3.25,1320,0,8,1040,280,47.6506,1440
459000.0,2,2.25,1010,0,8,710,300,47.6363,1140
248000.0,3,2.5,1870,0,7,1870,0,47.342,2130
1481000.0,4,3.5,5220,3,11,3550,1670,47.592,3110
379000.0,4,2.5,2260,0,8,2260,0,47.3496,2240
2945000.0,5,4.5,4340,4,10,4340,0,47.6715,1770
395000.0,2,2.25,1620,0,8,1540,80,47.5483,1530
535000.0,3,2.5,2280,0,8,1880,400,47.5375,2280
970000.0,5,3.5,3400,0,9,2550,850,47.543,2380
205000.0,2,1.5,830,0,7,830,0,47.5604,830
310000.0,4,2.5,2310,0,8,2310,0,47.3737,2310
334500.0,2,1.5,830,0,7,830,0,47.5828,1480
995000.0,5,3.25,4130,0,10,4130,0,47.6022,3730
370228.0,4,3.0,2050,0,8,2050,0,47.3525,2050
383000.0,4,2.5,2050,0,9,2050,0,47.3448,2340
384500.0,3,2.5,1600,0,8,1600,0,47.5344,1445
865000.0,5,2.5,3190,0,9,3190,0,47.7246,1650
1051000.0,4,3.75,3860,0,10,3860,0,47.5396,3040
502000.0,4,2.5,2040,0,8,2040,0,47.7737,2380
1750000.0,4,3.5,3845,0,10,3845,0,47.6354,1710
569995.0,4,2.5,2650,0,8,2650,0,47.479,2650
749950.0,4,2.5,3430,0,8,3430,0,47.7694,3580
550000.0,3,2.5,2430,0,8,2430,0,47.6062,2640
525000.0,3,3.5,2876,0,8,2360,516,47.7511,2390
516000.0,4,3.5,2550,0,7,2550,0,47.5216,2430
1350000.0,4,3.75,4100,0,9,4100,0,47.5626,2010
440000.0,4,2.5,2730,0,7,2730,0,47.491,2190
660000.0,3,2.5,1780,0,8,1080,700,47.6594,1780
261950.0,3,2.5,1880,0,7,1880,0,47.3359,2260
551000.0,5,3.75,3090,0,10,3090,0,47.4594,3191
665000.0,3,3.5,2460,0,8,1900,560,47.7743,2440
610000.0,4,3.5,2910,0,9,2910,0,47.5168,2910
645000.0,4,3.5,2910,0,9,2910,0,47.5168,2910
536751.0,3,1.75,1930,0,9,1930,0,47.5181,2770
260000.0,3,2.25,1413,0,8,1413,0,47.4196,1763
1312000.0,3,3.25,4030,0,10,3630,400,47.6664,1660
429900.0,4,3.25,2880,0,8,2880,0,47.2752,2880
535000.0,4,2.75,2360,0,8,2360,0,47.5117,1440
462550.0,2,1.75,1070,0,8,1070,0,47.6719,1290
602000.0,3,3.25,1460,0,8,1460,0,47.6485,1310
730000.0,4,2.75,3800,0,9,3800,0,47.7368,3400
300500.0,2,1.5,1190,0,8,1190,0,47.5212,1190
675000.0,5,2.5,3200,0,9,3200,0,47.5446,3290
415000.0,3,2.25,1970,0,8,1680,290,47.5631,1690
614000.0,3,2.5,2830,0,9,2830,0,47.7744,2830
385000.0,4,2.5,2630,0,7,2630,0,47.375,2770
594000.0,4,2.75,2720,0,9,2720,0,47.7352,2830
860000.0,4,2.75,3160,0,9,3160,0,47.6709,2200
1104500.0,4,4.0,3770,0,10,2940,830,47.6476,3300
775000.0,4,2.75,3500,0,9,3500,0,47.6846,3480
430760.0,5,2.75,2710,0,8,2710,0,47.3555,2710
755000.0,2,2.5,2170,2,8,2170,0,47.7109,2310
640000.0,2,2.25,1540,0,9,1540,0,47.6179,1410
613500.0,3,3.25,1876,0,9,1876,0,47.6864,1876
780000.0,4,3.5,3720,2,10,3720,0,47.3216,2190
550000.0,4,2.5,3148,3,9,3148,0,47.3994,3000
789500.0,4,3.25,3240,0,9,3240,0,47.695,3320
592000.0,5,3.5,3340,0,8,2580,760,47.5168,3420
454950.0,4,2.5,2413,0,8,2413,0,47.3731,2380
475000.0,4,2.5,2500,0,7,2500,0,47.4928,2230
659000.0,2,1.75,1180,0,10,780,400,47.6396,1380
570000.0,4,2.5,2890,0,9,2890,0,47.7349,2890
347500.0,5,3.0,2230,0,7,1330,900,47.487,2230
205000.0,4,2.5,1767,0,8,1767,0,47.2607,1949
380000.0,3,3.25,1450,0,8,1100,350,47.5664,1450
718000.0,5,2.75,2930,0,9,2930,0,47.5308,2750
515805.0,5,2.75,2710,0,8,2710,0,47.4786,2590
1029280.0,4,3.25,3600,1,10,3000,600,47.5294,3970
437718.0,3,2.5,1800,0,8,1800,0,47.5338,1800
450000.0,4,2.5,2290,0,8,2290,0,47.5518,1380
515000.0,3,2.5,1510,0,8,1060,450,47.6181,1510
204000.0,2,2.5,1090,0,7,1090,0,47.4166,1380
360000.0,3,2.0,1270,0,8,1270,0,47.6934,1330
550000.0,3,2.25,1540,0,8,1540,0,47.6827,1510
650880.0,3,2.5,2930,0,9,2930,0,47.5151,2760
1789950.0,5,3.75,4360,4,10,3530,830,47.6936,2680
895900.0,4,3.5,3640,3,9,2790,850,47.5619,3270
585000.0,4,2.5,2430,0,8,2430,0,47.5285,1930
380000.0,3,2.25,1520,0,8,1240,280,47.543,1710
565997.0,5,2.75,2730,0,8,2730,0,47.4856,2730
459000.0,3,3.0,2440,0,8,1930,510,47.5476,2440
550000.0,3,3.75,1580,0,8,1340,240,47.5875,1560
500000.0,3,2.25,1420,0,8,1420,0,47.6533,1530
461500.0,5,3.25,2820,0,8,2230,590,47.5339,2610
2150000.0,4,5.5,5060,0,11,5060,0,47.6245,3010
790000.0,4,2.5,2650,0,8,2650,0,47.5605,1110
735000.0,3,2.25,1490,0,9,1040,450,47.6226,1490
588000.0,4,2.5,3060,0,9,3060,0,47.4828,3040
724500.0,3,3.25,3240,0,8,2770,470,47.5794,2660
749000.0,3,2.75,2820,0,9,2820,0,47.7073,3140
720000.0,5,3.5,4140,0,8,4140,0,47.591,3330
250000.0,2,1.5,982,0,8,806,176,47.7034,1010
790000.0,3,2.75,2460,0,9,2460,0,47.5409,2570
392440.0,4,2.5,2547,0,9,2547,0,47.2592,2598
280000.0,4,2.25,1834,0,8,1834,0,47.3568,1979
1333000.0,4,4.5,3130,0,10,2450,680,47.6239,2540
649000.0,4,2.5,2730,0,9,2730,0,47.549,1250
457000.0,2,2.5,1380,0,8,1050,330,47.6903,1360
2225000.0,4,4.25,4700,1,11,3910,790,47.6882,2370
453000.0,3,3.0,2330,0,9,1920,410,47.5547,2330
329780.0,3,2.5,1730,0,8,1730,0,47.5014,2030
1050000.0,2,2.5,2350,2,10,2000,350,47.5999,1950
771005.0,5,4.5,4000,0,9,4000,0,47.5254,3690
1300000.0,3,2.5,3350,0,9,2180,1170,47.6263,2570
607500.0,3,3.25,1530,0,8,1530,0,47.6706,1530
278000.0,2,2.25,1610,0,7,1610,0,47.5184,1950
475000.0,4,2.75,2620,0,8,2620,0,47.4823,2790
270000.0,3,2.0,1300,0,8,850,450,47.5183,1300
1302000.0,4,3.5,3590,2,9,3140,450,47.6763,2100
778983.0,4,2.5,2490,0,8,2490,0,47.7043,2970
221000.0,3,2.5,1320,0,7,880,440,47.528,3040
338800.0,4,2.25,1800,0,8,1800,0,47.5165,1800
834995.0,5,1.5,3360,0,9,3360,0,47.6072,3230
550000.0,4,2.5,3220,0,8,3220,0,47.7273,3020
575000.0,3,3.5,2514,0,8,2024,490,47.7044,2090
649000.0,4,2.75,3130,0,9,3130,0,47.4823,1570
545000.0,4,2.5,2720,0,8,2720,0,47.515,2590
625000.0,2,2.25,1390,0,8,1165,225,47.6168,1415
1042000.0,4,4.5,4920,3,10,3820,1100,47.4695,4920
611000.0,3,2.5,2134,0,8,2134,0,47.5402,2170
300000.0,3,2.5,1741,0,8,1741,0,47.379,2002
577000.0,3,2.5,2560,0,8,2560,0,47.6887,2560
349990.0,4,2.5,2220,0,8,2220,0,47.3561,2530
650000.0,3,2.5,1910,0,9,1910,0,47.5482,1890
378000.0,2,1.5,980,0,7,820,160,47.5925,1130
313200.0,3,2.5,1950,0,7,1950,0,47.3613,2300
1206690.0,5,4.25,4150,0,10,4150,0,47.5816,3230
252500.0,2,1.5,1110,0,7,950,160,47.5427,1110
308000.0,3,2.5,1250,0,8,1080,170,47.5582,1250
803100.0,4,2.5,3310,0,9,3310,0,47.6635,2600
415000.0,4,2.5,2020,0,7,2020,0,47.4937,2020
785000.0,4,3.5,3310,0,9,3310,0,47.6954,3320
499950.0,4,2.5,2798,0,9,2798,0,47.4295,2358
216000.0,4,2.5,1847,0,7,1847,0,47.2874,1767
380000.0,4,2.5,2420,0,9,2420,0,47.3785,2420
345000.0,4,2.5,2020,0,7,2020,0,47.3535,2210
456500.0,4,2.5,2400,0,8,2400,0,47.4959,2710
382495.0,3,2.5,1760,0,8,1760,0,47.3482,2310
324950.0,4,2.5,2110,0,7,2110,0,47.3612,2300
436472.0,4,2.5,2692,0,9,2692,0,47.3519,2574
365250.0,3,2.25,1490,0,7,1490,0,47.7611,1580
919990.0,5,3.25,3960,0,10,3960,0,47.5806,2930
316475.0,4,2.5,1740,0,7,1740,0,47.3686,1950
425000.0,4,2.5,1940,0,8,1190,750,47.776,1910
302860.0,2,1.0,970,0,7,790,180,47.5469,1150
298000.0,3,2.5,1852,0,7,1852,0,47.3455,2166
3204000.0,4,4.0,4810,3,11,4810,0,47.6364,3970
950000.0,4,4.0,5635,3,10,4360,1275,47.3389,3726
333000.0,3,2.5,1520,0,7,1520,0,47.4874,1820
289950.0,3,2.5,2099,0,7,2099,0,47.3521,2099
419950.0,3,2.25,1250,0,8,1250,0,47.5419,1250
306000.0,2,1.5,1090,0,8,1090,0,47.6974,1110
498445.0,4,2.5,3216,0,9,3216,0,47.3425,2815
775950.0,4,2.5,2970,0,8,2970,0,47.705,3010
605000.0,3,2.5,2610,0,8,2610,0,47.5373,2580
520000.0,2,1.75,1340,0,7,1060,280,47.618,2480
849990.0,4,2.75,3300,0,9,3300,0,47.6175,3520
767450.0,3,2.0,1630,0,10,1630,0,47.6981,2030
665000.0,3,2.25,1590,0,9,1060,530,47.6172,1510
525000.0,2,2.75,1310,0,8,1310,0,47.6534,1350
870515.0,4,3.5,3600,0,9,2940,660,47.5755,3490
390000.0,4,2.5,2154,0,9,2154,0,47.4557,2154
500000.0,3,1.75,1530,0,8,1530,0,47.5929,1580
399950.0,3,2.25,1360,0,8,1094,266,47.6925,1522
305000.0,3,2.5,1320,0,7,1320,0,47.536,1320
255000.0,4,2.5,1660,0,7,1660,0,47.259,1544
415000.0,4,2.5,2891,0,9,2891,0,47.3359,2550
716500.0,3,2.5,2340,0,10,2120,220,47.53,2640
425000.0,3,2.5,2320,0,8,2320,0,47.7027,1240
540000.0,4,2.5,2190,0,8,2190,0,47.7705,2190
324747.0,3,2.5,2060,0,8,2060,0,47.3706,2370
385000.0,3,2.5,1740,0,7,1740,0,47.6875,1740
270000.0,3,2.25,1400,0,7,1400,0,47.3596,2110
1240000.0,5,4.0,4410,0,11,4410,0,47.6463,2720
672000.0,3,2.5,1780,0,8,1080,700,47.6597,2000
310000.0,3,2.5,1760,0,8,1760,0,47.355,2000
3000000.0,3,3.5,4410,4,11,3430,980,47.5283,3550
2350000.0,6,4.25,5550,2,11,4270,1280,47.6547,3480
427000.0,3,2.5,2432,2,9,2432,0,47.3453,2912
389950.0,3,2.5,2283,0,8,2283,0,47.4221,1760
309620.0,3,2.5,1860,0,8,1860,0,47.7442,2110
399895.0,4,2.5,2701,0,9,2701,0,47.2586,2570
442515.0,4,2.5,2930,0,9,2930,0,47.3421,2815
375000.0,3,2.25,1540,0,8,1540,0,47.6991,1540
309780.0,3,2.5,2242,0,8,2242,0,47.2583,2009
425000.0,3,2.5,1950,0,7,1950,0,47.5202,2260
405000.0,2,3.0,1160,0,7,880,280,47.5788,1250
356250.0,3,2.5,2060,0,9,2060,0,47.3261,2648
550000.0,3,2.25,1230,0,8,1230,0,47.6521,1760
340000.0,2,1.5,1160,0,7,1160,0,47.5917,1220
362865.0,4,2.5,2245,0,8,2245,0,47.3555,2530
1360000.0,4,3.5,4120,1,11,3970,150,47.7089,4120
830000.0,4,2.5,3400,0,9,3400,0,47.708,3070
1598000.0,5,3.75,4270,0,10,3210,1060,47.6845,2410
855000.0,4,3.5,2890,0,9,2370,520,47.5754,3490
1205000.0,5,3.5,3220,0,9,2900,320,47.6834,2100
1385000.0,4,3.5,4010,1,11,4010,0,47.5528,3550
400200.0,4,3.5,2260,0,7,2260,0,47.4493,1270
235000.0,2,1.0,1140,0,8,1010,130,47.5494,1360
349950.0,3,2.0,1640,0,8,1640,0,47.3539,1770
659950.0,4,2.75,3510,0,9,3510,0,47.4827,3550
785000.0,3,2.75,3010,0,9,3010,0,47.5836,2950
475000.0,2,2.25,1060,0,8,980,80,47.6386,1020
263900.0,3,2.5,1658,0,8,1658,0,47.3667,1658
342000.0,3,2.5,1960,0,8,1960,0,47.3568,1840
367899.0,3,2.5,2420,0,8,2420,0,47.371,2370
657044.0,3,3.5,3420,0,9,3420,0,47.4739,1590
359950.0,2,1.5,893,0,8,893,0,47.6187,1340
879950.0,4,2.75,3020,0,9,3020,0,47.6948,3010
550000.0,4,2.5,2470,0,8,2470,0,47.7685,2470
279000.0,4,2.5,2009,0,8,2009,0,47.2586,1798
255000.0,3,2.5,1530,0,7,1530,0,47.7385,1530
609500.0,3,1.75,1590,0,8,1590,0,47.6691,1520
420000.0,5,3.0,2630,0,8,1670,960,47.5065,2240
570000.0,4,2.5,3230,0,9,3230,0,47.4995,2950
439000.0,3,2.25,1430,0,8,1430,0,47.5648,1270
310000.0,3,2.5,2242,0,8,2242,0,47.2597,2009
635000.0,4,2.5,2500,0,8,2500,0,47.5902,1480
399950.0,3,2.5,1230,0,8,1080,150,47.6518,1230
805000.0,4,2.5,3020,0,9,3020,0,47.5407,2570
1800000.0,4,3.5,3480,0,9,2460,1020,47.6356,2620
1205000.0,4,3.0,3330,0,9,1830,1500,47.6889,1200
745000.0,4,2.5,3400,0,10,3190,210,47.5066,3400
329445.0,2,1.5,830,0,7,830,0,47.5828,1480
588000.0,5,3.0,3110,0,8,3110,0,47.7719,2450
494815.0,3,2.5,1910,0,8,1910,0,47.5445,1630
591975.0,3,2.75,3230,0,9,2680,550,47.5196,2710
600000.0,5,2.75,3380,0,9,3380,0,47.4827,2840
673000.0,3,2.75,2830,0,8,2830,0,47.5606,2160
889950.0,5,3.5,3700,0,9,3700,0,47.5929,3170
500000.0,4,3.0,2520,0,7,2520,0,47.5352,2510
500000.0,3,2.25,1530,0,8,1240,290,47.666,1690
890000.0,4,4.25,4420,0,10,3410,1010,47.5404,4420
437000.0,3,3.0,1460,0,8,1460,0,47.6998,1460
419700.0,3,2.25,1450,0,8,1160,290,47.5694,1370
394000.0,3,2.0,1160,0,6,580,580,47.5314,1160
342000.0,3,2.0,1640,0,8,1640,0,47.3538,1940
420000.0,3,1.75,1444,0,7,1444,0,47.4104,1760
580000.0,3,2.5,1620,4,8,1470,150,47.6681,1620
343000.0,2,1.5,1100,0,7,900,200,47.5538,1340
390000.0,2,1.5,1340,0,8,1120,220,47.588,1340
274000.0,3,1.5,1450,0,7,1450,0,47.3654,1870
700000.0,4,2.5,3040,0,9,3040,0,47.7747,2360
838000.0,4,2.5,2560,0,9,2560,0,47.5535,2160
300000.0,6,3.0,2744,0,7,2744,0,47.2773,2470
467000.0,3,2.25,1420,0,8,1420,0,47.6801,1350
395000.0,2,1.0,700,0,6,700,0,47.5348,1500
734000.0,5,4.25,4110,2,10,2970,1140,47.3375,2730
480000.0,5,2.75,2670,0,8,2670,0,47.4866,2560
539000.0,3,2.75,2130,0,9,1080,1050,47.5661,1520
459950.0,5,2.75,3078,0,9,3078,0,47.3587,1979
306500.0,2,1.0,840,0,7,840,0,47.5396,1030
408474.0,3,2.5,1800,0,8,1800,0,47.5342,1800
437000.0,3,2.75,2580,0,8,2580,0,47.496,2700
160797.0,3,1.5,1270,0,7,1270,0,47.5671,1490
729000.0,4,3.5,3065,0,9,3065,0,47.524,2210
499000.0,3,2.5,1861,0,8,1578,283,47.7043,2090
359950.0,4,2.75,2260,0,8,2260,0,47.3726,2260
929000.0,5,3.25,4150,0,10,4150,0,47.6026,3560
529950.0,2,2.5,1500,0,8,1140,360,47.6689,1550
461000.0,3,2.25,1620,0,8,1540,80,47.5394,1620
271115.0,2,1.5,830,0,7,830,0,47.5472,1310
653000.0,4,2.5,3120,0,7,3120,0,47.6842,2755
565000.0,3,2.5,1870,0,8,1380,490,47.6512,1440
529950.0,3,2.25,1240,0,8,1240,0,47.6748,1470
585000.0,4,2.5,2820,0,9,2820,0,47.7477,1620
609000.0,3,1.75,1630,0,8,1630,0,47.6536,1570
267000.0,3,2.25,1584,0,7,1584,0,47.3454,1584
557000.0,4,2.5,2840,0,8,2840,0,47.7678,2840
709950.0,4,3.25,3910,0,9,3130,780,47.5389,4410
625000.0,3,2.5,1730,0,9,1730,0,47.653,1330
599000.0,3,2.75,1840,0,10,1700,140,47.53,2590
920000.0,4,3.75,4030,0,10,4030,0,47.4807,2110
1285000.0,4,3.5,3440,0,9,3440,0,47.6408,1760
324500.0,4,2.5,2110,0,7,2110,0,47.3602,2110
471500.0,3,2.5,2430,0,7,2430,0,47.5158,2380
1015000.0,4,3.75,4690,0,10,4030,660,47.7072,2890
998000.0,4,3.5,3500,0,9,2850,650,47.5481,3640
262000.0,4,2.5,2070,0,7,2070,0,47.4697,2170
844000.0,4,3.5,3350,2,8,2610,740,47.5602,1820
745641.0,4,2.5,2440,0,8,2440,0,47.7043,2970
659950.0,5,3.0,3010,0,9,3010,0,47.7226,2370
339989.0,3,2.5,2060,0,8,2060,0,47.3706,2370
352500.0,2,2.5,1570,0,7,1180,390,47.5488,1590
525000.0,3,2.5,1580,0,8,1010,570,47.6206,1680
1138990.0,5,3.5,4280,3,10,4280,0,47.5941,3960
491000.0,5,3.5,2815,0,9,2815,0,47.3424,2798
675000.0,4,2.5,2620,0,9,2620,0,47.5603,2620
344000.0,3,2.25,1250,0,8,1250,0,47.6907,1250
530000.0,4,2.5,3250,0,8,3250,0,47.4944,3030
290500.0,4,3.25,2510,0,9,2510,0,47.4785,2510
335000.0,2,1.75,1270,0,8,1270,0,47.5646,1270
2998000.0,5,4.0,6670,0,12,4960,1710,47.6409,4800
379000.0,3,2.5,1580,0,8,1580,0,47.545,1710
385000.0,3,1.5,1360,0,8,1360,0,47.6961,1360
500012.0,4,2.5,2400,0,8,1230,1170,47.4799,2430
366750.0,3,3.0,1571,0,8,1571,0,47.7338,1520
405000.0,2,2.0,1405,0,8,1140,265,47.612,1405
356999.0,3,1.5,1010,0,8,1010,0,47.5998,1010
590000.0,2,2.5,1450,0,8,1220,230,47.665,1440
294000.0,3,1.75,1420,0,7,960,460,47.5684,1340
731500.0,4,2.5,2650,0,8,2650,0,47.6945,2640
837219.0,5,2.75,3030,0,9,3030,0,47.593,3080
1600000.0,4,5.5,6530,2,11,6530,0,47.664,1280
798800.0,3,2.75,2670,0,10,1720,950,47.5299,2610
482500.0,2,2.5,1170,0,9,1170,0,47.6875,1170
820000.0,4,2.5,3260,0,9,3260,0,47.5115,3260
319000.0,3,1.5,1480,0,7,1480,0,47.728,1480
950000.0,3,2.5,2700,3,9,2700,0,47.5172,2500
1267500.0,4,3.5,4640,0,10,4640,0,47.531,4690
378000.0,3,2.5,1601,0,7,1536,65,47.719,1420
3345000.0,5,3.75,5350,1,11,3040,2310,47.648,3740
489950.0,3,2.5,2540,0,8,2540,0,47.5492,1800
345000.0,2,1.75,1030,0,7,765,265,47.5397,1030
510000.0,3,2.5,2730,0,8,2730,0,47.3938,2130
432500.0,4,2.5,3172,0,8,3172,0,47.2961,2704
650000.0,4,2.5,3160,0,9,3160,0,47.5075,3160
750000.0,4,2.5,2850,0,9,2850,0,47.6915,2540
870000.0,4,3.5,2780,0,8,2120,660,47.6886,1740
900000.0,4,3.5,3860,0,10,3860,0,47.5934,3760
664950.0,2,1.75,1180,0,10,780,400,47.6395,1380
391000.0,3,2.25,1410,0,7,1290,120,47.5345,1490
1800000.0,4,3.5,6370,0,12,6370,0,47.5016,1490
479349.0,5,3.0,3223,0,9,3223,0,47.3584,1979
661000.0,4,3.25,2600,0,8,2150,450,47.5402,2510
379000.0,3,3.25,1380,0,8,1380,0,47.6935,1370
415000.0,3,2.25,1620,0,8,1540,80,47.5401,1620
375000.0,3,3.25,1370,0,8,1370,0,47.6964,1370
355000.0,3,2.0,1220,0,8,1220,0,47.6972,1280
540000.0,3,2.5,1280,0,8,1280,0,47.6619,1450
290000.0,2,1.5,770,0,7,770,0,47.5644,1350
500000.0,3,2.5,1210,0,8,1210,0,47.6543,1210
416000.0,4,2.5,2890,0,8,2890,0,47.3494,2380
349900.0,3,2.5,1580,0,8,1580,0,47.5444,1580
465000.0,3,2.25,1530,0,9,1050,480,47.6018,1530
950000.0,4,2.5,3670,0,10,3670,0,47.5401,3130
496800.0,4,2.25,1850,0,8,1850,0,47.543,1850
680000.0,4,2.5,2440,0,8,2440,0,47.7321,1480
920000.0,4,3.25,2190,0,9,1540,650,47.6178,1730
1289990.0,5,4.0,4360,0,10,4360,0,47.5923,3570
825000.0,4,2.75,3990,0,9,3990,0,47.6835,3500
292000.0,3,2.5,1270,0,7,1270,0,47.7209,1270
576000.0,4,2.5,3340,0,8,3340,0,47.495,3030
670000.0,2,2.0,1500,3,8,1500,0,47.6522,1360
953007.0,4,3.5,3120,0,9,2480,640,47.6762,1880
399000.0,4,2.5,2480,0,8,2480,0,47.3826,2480
399000.0,2,2.0,1110,0,7,980,130,47.5496,1110
847093.0,4,2.75,2760,0,10,2760,0,47.5819,2760
599950.0,3,2.5,1510,0,8,1510,0,47.669,1530
499000.0,3,2.5,1460,0,8,1180,280,47.6781,1380
760000.0,4,2.75,3980,2,9,3980,0,47.4803,2100
1699990.0,4,3.75,3320,0,10,3320,0,47.5963,1560
1033890.0,4,3.25,3270,0,9,3110,160,47.6966,3600
515000.0,4,2.5,2670,0,9,2670,0,47.4876,2880
355000.0,3,2.25,1410,0,7,1290,120,47.5345,1445
319900.0,4,2.75,2475,0,7,2475,0,47.3452,2166
460000.0,3,3.5,1600,0,8,1240,360,47.6865,1500
305000.0,2,1.0,1290,0,7,1290,0,47.6968,1290
280000.0,3,2.5,1608,0,8,1608,0,47.2583,2009
394950.0,2,2.25,1300,0,8,1010,290,47.5477,1430
382000.0,4,3.5,2530,0,8,1850,680,47.4919,1470
560000.0,3,2.5,1390,0,8,1390,0,47.6485,1350
772000.0,3,2.25,1640,0,8,1640,0,47.6196,1630
324950.0,4,2.5,2229,0,7,2229,0,47.3693,2738
530000.0,3,2.5,1790,0,8,1790,0,47.5638,1890
384000.0,3,2.25,990,0,8,880,110,47.6605,1030
719950.0,5,2.75,3240,0,10,3240,0,47.5033,2360
319950.0,2,2.5,1280,0,8,1060,220,47.6905,1290
292000.0,3,2.5,1610,0,8,1610,0,47.4497,1610
1500000.0,6,3.5,3670,0,10,2410,1260,47.6356,2060
425000.0,2,2.5,1150,0,8,1150,0,47.6534,1360
799950.0,5,3.75,3760,0,9,2780,980,47.7202,2950
499000.0,2,2.5,1320,0,8,990,330,47.6689,1550
572000.0,4,2.75,2700,0,9,2700,0,47.4831,2840
459000.0,2,2.0,1480,0,8,1480,0,47.602,1380
529500.0,3,2.25,1410,0,9,1410,0,47.5818,1510
374500.0,4,2.5,3135,0,9,3135,0,47.3263,3008
584000.0,3,2.5,1480,0,8,1280,200,47.6376,1470
1898000.0,4,4.5,4020,0,10,4020,0,47.6358,1960
505000.0,2,2.25,1060,0,8,940,120,47.6369,1300
565000.0,2,2.5,1950,0,8,1950,0,47.5925,1650
799000.0,4,2.75,3340,0,9,3340,0,47.709,3240
547000.0,3,2.5,1570,0,9,1240,330,47.648,1670
550000.0,3,2.5,1930,0,7,1930,0,47.4692,910
250000.0,3,2.0,1590,0,7,1060,530,47.3611,1590
960000.0,4,4.5,3720,0,10,3720,0,47.7323,3080
2950000.0,4,4.25,4470,1,11,3230,1240,47.6387,2570
441000.0,2,1.0,1290,0,7,1030,260,47.6006,1290
265000.0,3,2.25,1489,0,7,1489,0,47.3454,1584
430000.0,3,2.5,2075,0,7,2075,0,47.3601,1960
286800.0,3,2.5,1413,0,8,1413,0,47.4222,2150
375000.0,3,2.5,1300,0,8,880,420,47.5893,1300
312500.0,3,3.25,1480,0,8,1180,300,47.5555,1330
850000.0,4,2.75,3320,0,9,3320,0,47.5607,3400
390500.0,3,2.25,1530,0,7,1116,414,47.7035,1320
455000.0,3,2.5,1180,0,8,1180,0,47.638,1180
455000.0,2,2.0,1190,0,8,800,390,47.6675,1670
515000.0,3,2.25,1300,0,8,1300,0,47.6871,1300
362500.0,3,3.5,1710,0,7,1400,310,47.5459,1580
460000.0,3,2.5,2390,0,9,2390,0,47.4517,1720
540000.0,4,3.5,3510,0,8,2750,760,47.5168,3090
230000.0,3,1.75,1140,0,8,1140,0,47.5638,1150
425000.0,2,2.5,1320,0,8,1180,140,47.6728,1490
298450.0,5,3.0,2100,0,8,1200,900,47.3341,1270
344000.0,4,2.5,2400,0,8,2400,0,47.3626,1980
416286.0,3,2.5,1408,0,8,1408,0,47.6856,1408
379500.0,4,2.5,2560,0,8,2560,0,47.3404,2586
350000.0,2,2.5,1260,0,8,1260,0,47.6994,1260
258800.0,2,1.75,1290,0,8,1290,0,47.5171,1410
620000.0,4,2.5,2730,0,8,2730,0,47.7222,2730
295000.0,2,2.5,1630,0,7,1280,350,47.5489,1590
908990.0,4,2.75,3530,0,10,3530,0,47.5975,3530
485230.0,4,2.5,2714,0,9,2714,0,47.3522,2873
475000.0,3,2.25,1630,0,7,1630,0,47.5493,1630
1240420.0,5,3.25,5790,3,10,4430,1360,47.5388,5790
635000.0,3,3.0,2230,0,8,1850,380,47.5446,2290
350000.0,3,2.5,1380,0,9,1160,220,47.5444,1380
345000.0,3,3.5,1320,0,8,1320,0,47.7162,1320
700000.0,2,2.0,1490,0,9,1490,0,47.6356,1490
490000.0,3,2.25,1280,0,8,1080,200,47.6651,1280
1299890.0,5,4.0,3870,0,10,3870,0,47.6965,3600
579000.0,2,2.5,1280,0,8,1080,200,47.6273,1580
552500.0,3,1.5,1300,0,8,1120,180,47.6114,1320
467000.0,4,2.75,2170,0,8,2170,0,47.495,2460
305000.0,4,2.25,1763,0,8,1763,0,47.4213,1763
212000.0,2,1.5,1020,0,7,1020,0,47.704,1020
429000.0,4,2.5,1840,0,7,1840,0,47.6866,1740
479950.0,3,2.0,1820,0,9,1820,0,47.5433,1710
825000.0,3,3.5,2670,0,9,1870,800,47.6813,1750
1180000.0,6,6.5,6260,0,11,4840,1420,47.5947,2710
250000.0,3,2.25,1400,0,7,1400,0,47.3584,1610
289000.0,2,1.5,1160,0,7,1160,0,47.7178,1150
265000.0,3,2.5,1400,0,7,1400,0,47.5134,1400
344000.0,3,2.5,1232,0,7,1232,0,47.7185,1232
749000.0,4,2.75,2700,0,8,2100,600,47.586,2050
492000.0,4,2.5,2550,0,7,2550,0,47.5202,2430
552500.0,4,2.5,3260,0,8,3260,0,47.4829,3130
653500.0,2,2.5,1680,0,8,1120,560,47.6372,2060
855000.0,4,3.25,2630,0,10,2030,600,47.6775,1810
333000.0,3,1.5,1260,0,7,1260,0,47.5524,3090
415000.0,4,2.5,2550,0,7,2550,0,47.4916,2340
445000.0,4,3.25,3450,0,8,3450,0,47.4925,1420
273500.0,3,2.5,1550,0,7,1550,0,47.3523,2095
969990.0,4,2.5,4150,0,10,4150,0,47.5802,4070
1200000.0,5,3.5,3900,0,9,2650,1250,47.6607,1190
430000.0,3,3.25,1550,0,8,1550,0,47.6767,1550
392000.0,4,2.5,2130,0,8,2130,0,47.5108,1830
795000.0,4,2.5,2890,0,9,2890,0,47.5456,3300
457000.0,3,2.5,1220,0,8,1010,210,47.6904,1360
453000.0,4,2.5,2502,0,9,2502,0,47.2953,2597
376000.0,3,2.0,1340,0,8,1340,0,47.6973,1110
469995.0,4,2.5,2350,0,8,2350,0,47.4783,2670
540000.0,3,2.5,1810,0,8,1810,0,47.7169,1560
555000.0,4,2.5,3310,0,8,3310,0,47.515,2380
445000.0,3,2.0,1620,0,7,590,1030,47.5448,1700
256950.0,2,2.0,1070,0,9,720,350,47.5212,1070
297000.0,4,2.5,2230,0,8,2230,0,47.3363,2030
320000.0,4,2.5,1970,0,8,1970,0,47.3627,1980
805000.0,5,4.5,4600,0,9,3200,1400,47.5381,4480
799990.0,4,2.75,3110,0,9,3110,0,47.705,3590
680000.0,4,2.5,3490,0,9,2850,640,47.774,3440
395000.0,3,2.5,1600,0,7,1600,0,47.5629,1600
732000.0,3,2.5,1960,0,8,1960,0,47.6764,1220
163800.0,2,2.5,1000,0,7,990,10,47.5419,1330
220000.0,2,2.5,1000,0,7,990,10,47.5419,1330
308625.0,2,2.0,1500,0,7,1500,0,47.7293,1500
375000.0,3,2.5,2424,0,9,2424,0,47.3515,2424
300000.0,4,2.5,2303,0,8,2303,0,47.3258,2516
284000.0,3,2.5,1880,0,7,1880,0,47.3366,2180
610000.0,2,2.0,1210,0,8,780,430,47.6206,1480
955000.0,4,3.25,3720,0,9,3720,0,47.688,3100
982000.0,4,2.75,3610,0,9,3610,0,47.6706,2360
359000.0,3,1.5,1360,0,8,1360,0,47.6961,1360
779380.0,5,2.5,2590,0,8,2590,0,47.7053,3010
1510000.0,5,3.25,4390,0,10,4390,0,47.5785,2160
635000.0,3,3.0,2290,0,8,1890,400,47.5446,2230
1060000.0,4,3.75,3880,0,10,3880,0,47.5408,3130
389500.0,3,2.5,1350,0,8,1270,80,47.549,1350
359800.0,5,2.5,2170,0,8,2170,0,47.5165,1800
399950.0,3,3.0,1296,0,8,1296,0,47.7175,1520
320000.0,3,3.25,1530,0,8,1140,390,47.5555,1450
255900.0,3,2.5,1489,0,7,1489,0,47.3452,1537
380000.0,4,2.5,2130,0,8,2130,0,47.5108,1830
580000.0,3,2.75,1430,0,9,1130,300,47.6353,1930
545000.0,5,3.75,2380,0,8,1430,950,47.5571,2040
451300.0,3,2.5,1420,0,8,1140,280,47.5429,1340
852880.0,4,3.25,3450,0,9,3450,0,47.6072,3020
305000.0,4,2.5,1914,0,8,1914,0,47.43,1714
295000.0,2,1.5,988,0,7,988,0,47.7123,1128
261000.0,3,2.25,1584,0,7,1584,0,47.3451,1584
560000.0,4,2.5,2630,0,8,2630,0,47.5342,2550
795000.0,4,3.25,3520,0,9,3520,0,47.6869,3220
384950.0,4,2.5,2380,0,8,2380,0,47.3607,2580
500000.0,3,1.75,1410,0,8,1410,0,47.6558,1350
640000.0,4,3.5,3220,0,9,3220,0,47.5169,2960
418000.0,4,3.25,3266,0,8,3266,0,47.2975,3087
799000.0,3,2.0,2550,0,9,2550,0,47.6955,1630
552900.0,4,3.5,3828,0,9,3828,0,47.2851,2120
539950.0,3,2.25,1670,0,8,1670,0,47.5402,1640
524225.0,4,2.5,3056,0,9,3056,0,47.2905,2849
424950.0,2,1.5,1000,0,8,1000,0,47.6823,2300
560000.0,3,3.25,1530,0,8,1200,330,47.6783,1390
715000.0,5,3.0,3490,0,9,3490,0,47.7744,2870
300000.0,5,2.5,2760,0,8,2760,0,47.5289,1360
405000.0,3,2.5,1440,0,7,1440,0,47.554,1440
327000.0,3,3.0,1370,0,8,1370,0,47.7302,1399
859950.0,6,4.0,3180,0,9,3180,0,47.6236,3230
560000.0,4,3.0,2720,0,9,2720,0,47.7113,1770
379900.0,3,2.5,1800,0,8,1800,0,47.5442,1580
625000.0,3,2.5,3220,0,9,3220,0,47.4815,3330
398096.0,3,2.5,2370,0,8,2370,0,47.37,2370
315000.0,3,2.5,1410,0,7,1180,230,47.5582,1270
939000.0,4,3.5,3640,0,9,3640,0,47.7049,3590
674000.0,3,2.5,1920,0,9,1920,0,47.6647,1930
306000.0,4,2.5,2267,0,7,2267,0,47.3384,2056
2321000.0,5,4.75,5780,0,11,4260,1520,47.5802,3460
394950.0,2,1.0,1131,0,7,1131,0,47.6912,1131
914154.0,3,3.5,2940,0,10,2940,0,47.5818,2760
496000.0,3,2.5,2180,0,7,2180,0,47.754,2180
430100.0,3,2.25,1400,0,8,940,460,47.5701,1420
449990.0,4,2.5,2680,0,8,2680,0,47.4759,2680
502000.0,4,2.5,2680,0,8,2680,0,47.4759,2680
310000.0,3,2.5,1300,0,7,1300,0,47.5328,1390
349950.0,4,3.5,2796,0,8,2796,0,47.3427,2040
625000.0,2,1.75,1460,0,8,1000,460,47.6853,1440
1054710.0,4,3.5,4210,3,9,3260,950,47.5765,3920
680000.0,4,2.75,2330,0,9,2330,0,47.5525,2410
828950.0,4,3.5,3930,1,9,2820,1110,47.5528,3700
274950.0,3,2.5,1608,0,8,1608,0,47.2582,2009
293000.0,2,2.25,1610,0,7,1610,0,47.5184,1950
795000.0,4,3.5,3200,0,9,2670,530,47.5515,3400
282900.0,4,2.5,1710,0,7,1710,0,47.3448,1710
909950.0,5,3.75,3050,0,9,3050,0,47.6819,2750
922755.0,4,3.5,3560,0,9,3560,0,47.6178,3540
424000.0,4,2.5,2650,0,9,2650,0,47.344,2650
630000.0,3,2.5,3490,0,8,2590,900,47.4714,1740
810000.0,4,3.25,4140,0,9,4140,0,47.7647,2060
256703.0,3,2.0,1670,0,7,1670,0,47.1948,1670
386380.0,3,2.5,1720,0,7,1720,0,47.6856,1720
485000.0,2,2.0,1510,0,8,1510,0,47.709,1510
275000.0,3,2.25,1450,0,7,1450,0,47.3665,1610
370000.0,4,2.5,1812,0,8,1812,0,47.4513,2440
499950.0,2,2.25,1060,0,8,940,120,47.6371,1300
502000.0,3,2.5,1600,0,8,1600,0,47.5934,1130
654000.0,3,3.25,1530,0,8,1280,250,47.6179,1530
575000.0,4,2.25,2070,0,9,1500,570,47.5775,1569
500000.0,4,2.5,3630,0,10,3630,0,47.4565,1600
554000.0,3,2.5,2140,0,8,1960,180,47.5368,2280
360000.0,4,1.75,2010,0,7,1150,860,47.5013,1720
619990.0,4,2.75,2630,0,8,2630,0,47.7748,2380
317500.0,4,2.5,2233,0,7,2233,0,47.2599,1544
564950.0,4,2.75,2990,0,7,2990,0,47.7401,2580
545000.0,2,1.25,1240,0,8,1240,0,47.6884,1340
333700.0,3,2.5,2230,0,7,2230,0,47.3359,2260
1480000.0,3,3.25,3700,0,11,2280,1420,47.6653,3930
530000.0,4,3.0,2290,0,8,2290,0,47.7727,2450
396000.0,2,1.5,950,0,8,950,0,47.6714,1290
305000.0,2,1.75,1120,0,7,1120,0,47.5325,1150
380000.0,5,3.5,2420,0,7,2420,0,47.5241,1430
305000.0,4,2.5,1714,0,8,1714,0,47.429,1714
440000.0,4,2.5,2230,0,7,2230,0,47.5073,1590
459000.0,4,3.0,2530,0,7,2530,0,47.431,1420
530000.0,3,3.5,1550,0,8,1160,390,47.6034,1490
600000.0,4,2.75,3110,0,8,3110,0,47.4865,2610
515000.0,3,3.0,2100,0,8,1660,440,47.5973,1900
275000.0,4,2.5,2150,0,8,2150,0,47.3363,2150
540000.0,3,1.75,1630,0,8,1020,610,47.6646,1420
445000.0,3,2.5,2230,0,7,2230,0,47.5439,2310
285000.0,3,2.5,1320,0,7,1320,0,47.5202,1300
480000.0,3,2.5,1590,0,8,1060,530,47.5893,1620
440000.0,5,3.25,2610,0,8,2080,530,47.535,1750
287450.0,3,2.5,1440,0,7,1440,0,47.5123,1440
507950.0,4,2.5,2630,0,9,2630,0,47.5079,2630
750000.0,3,3.5,3390,0,10,3040,350,47.537,3290
425000.0,3,1.5,1400,0,8,1400,0,47.6989,1270
420000.0,3,3.5,1900,0,8,1520,380,47.5675,1530
394950.0,3,2.5,1350,0,8,1270,80,47.5491,1350
635000.0,4,3.25,3420,2,9,3030,390,47.517,3010
513000.0,3,2.5,2150,0,7,1330,820,47.4178,2400
380000.0,4,2.5,2110,0,8,2110,0,47.356,2250
1130000.0,4,3.25,3810,1,10,2680,1130,47.699,3240
540000.0,5,3.0,2870,0,8,2090,780,47.7449,2640
352499.0,2,2.25,1240,0,7,1150,90,47.5321,1240
603000.0,4,3.5,3610,0,9,2370,1240,47.4283,3010
685000.0,4,2.5,2310,0,9,2310,0,47.7039,1260
330675.0,4,3.0,1930,0,7,1200,730,47.7457,1930
275000.0,3,3.0,1390,0,7,1140,250,47.5323,1450
259950.0,3,2.5,1578,0,7,1578,0,47.3771,1850
441000.0,3,2.0,1720,0,9,1720,0,47.6927,1900
1135000.0,5,3.75,4700,0,10,2930,1770,47.6624,3180
590000.0,3,3.5,1970,0,8,1680,290,47.5816,1940
497000.0,3,2.25,1460,0,8,1050,410,47.5774,1690
345500.0,3,2.5,1930,0,8,1930,0,47.3518,2050
562500.0,3,2.25,1300,0,8,1000,300,47.6371,1300
355000.0,3,2.25,1445,0,7,1300,145,47.5339,1410
345000.0,2,2.25,860,0,9,860,0,47.5663,1100
478000.0,3,2.5,3040,0,9,3040,0,47.51,2670
391500.0,3,2.5,2424,0,9,2424,0,47.3512,2381
265000.0,2,1.5,1084,0,7,1084,0,47.7117,1084
395000.0,3,2.5,2510,0,8,2510,0,47.5374,1820
286308.0,2,1.5,1220,0,7,1220,0,47.7348,1210
370000.0,2,2.25,1280,0,7,1080,200,47.5592,1280
1079000.0,5,3.5,3740,0,9,2860,880,47.6764,1520
298900.0,3,2.5,1852,0,7,1852,0,47.3451,2475
775000.0,4,2.5,2580,0,9,2580,0,47.5416,2580
790000.0,4,3.5,3190,0,9,3190,0,47.501,3000
1050000.0,3,2.5,3400,0,8,2300,1100,47.6843,1740
249000.0,2,1.5,1090,0,7,1090,0,47.717,1160
348000.0,3,2.0,2360,0,8,2360,0,47.3564,2304
358000.0,5,2.5,2460,0,8,2460,0,47.3658,2210
260000.0,5,2.5,2025,0,7,2025,0,47.2671,1664
765000.0,4,3.0,4410,0,9,3400,1010,47.5392,4390
739000.0,3,2.5,2810,0,9,2810,0,47.7065,2870
890000.0,5,3.5,4490,0,10,3200,1290,47.5396,4530
462000.0,4,2.5,3070,0,9,3070,0,47.4487,2910
380000.0,4,2.5,1984,0,8,1564,420,47.36,1390
770000.0,5,3.5,4750,2,10,3350,1400,47.3574,2160
641000.0,4,3.25,2760,0,8,1900,860,47.5286,2760
2300000.0,4,4.0,4360,4,10,3940,420,47.5724,2670
369000.0,4,2.5,3060,0,8,3060,0,47.1967,1760
1112000.0,4,3.0,2770,0,9,2180,590,47.6435,1820
357000.0,5,2.5,2990,0,8,2990,0,47.7384,1970
650000.0,3,2.75,1540,0,8,1230,310,47.6298,1540
563500.0,3,2.5,1400,0,8,1400,0,47.6534,1350
345000.0,3,2.5,1680,0,7,1680,0,47.7484,1230
479950.0,3,2.0,2260,0,9,2260,0,47.4593,2340
660000.0,4,3.5,3400,0,9,3400,0,47.5169,3170
800000.0,4,2.5,2930,0,9,2760,170,47.5424,3230
253101.0,3,2.0,1239,0,7,1239,0,47.3689,2060
555000.0,3,3.5,2100,0,9,1450,650,47.562,1800
240000.0,4,1.0,1200,0,7,1200,0,47.7076,1130
380000.0,4,1.0,1200,0,7,1200,0,47.7076,1130
239000.0,2,1.5,680,0,7,680,0,47.695,690
760000.0,4,3.25,2690,0,9,2060,630,47.532,1810
430000.0,4,2.5,2750,0,8,2750,0,47.7327,2750
660000.0,3,2.5,2450,0,8,2450,0,47.6942,2450
399963.0,4,2.5,2620,0,8,2620,0,47.5017,2030
411000.0,2,2.0,1130,0,9,800,330,47.6023,1350
483453.0,4,2.75,2790,0,8,2790,0,47.4827,2620
469950.0,3,2.0,1820,0,9,1820,0,47.5432,1710
504058.0,4,2.75,2910,0,8,2910,0,47.4841,2790
425996.0,4,2.5,2568,0,9,2568,0,47.2596,2547
760005.0,4,2.75,3090,0,9,3090,0,47.6057,2960
699999.0,2,2.0,1460,0,8,950,510,47.6205,1580
749950.0,3,2.5,2010,0,8,1340,670,47.6088,1500
674600.0,4,2.5,2610,0,8,2610,0,47.6951,1190
450000.0,2,1.5,960,0,8,920,40,47.6489,1200
272000.0,3,2.5,1528,0,7,1528,0,47.3774,1850
450000.0,2,1.5,1310,0,8,1120,190,47.5772,1330
643950.0,3,2.25,1760,0,9,1760,0,47.5633,1420
290000.0,3,2.5,1420,0,8,1310,110,47.7731,1180
378000.0,3,2.5,1650,0,8,1650,0,47.7108,1650
728050.0,3,2.5,2320,0,8,2320,0,47.7158,1680
499160.0,4,2.5,2628,0,9,2628,0,47.2904,2849
536000.0,4,2.5,2520,0,8,2520,0,47.7711,2430
419900.0,5,3.5,2880,0,8,2260,620,47.3455,2590
469000.0,3,2.25,1440,0,7,1440,0,47.6908,1180
374000.0,3,2.5,2185,0,9,2185,0,47.3573,2297
182568.0,4,1.5,1500,0,7,1500,0,47.5669,1490
334888.0,3,2.5,1769,0,9,1769,0,47.3307,2502
799900.0,4,4.0,3650,3,9,3330,320,47.5442,3220
383000.0,4,2.5,2160,0,8,2160,0,47.3494,2160
580000.0,3,2.5,1820,0,7,1820,0,47.6539,1870
351999.0,3,2.5,2370,0,8,2370,0,47.3706,2370
1325000.0,3,3.0,3180,2,11,2240,940,47.6377,2420
312000.0,3,2.5,1780,0,8,1780,0,47.3568,1970
674950.0,4,3.5,2650,0,8,2230,420,47.5381,2330
1105000.0,5,2.75,3300,0,10,3300,0,47.6467,3150
415000.0,2,2.5,1160,0,8,1160,0,47.6543,1320
1250000.0,3,3.0,3460,0,10,2850,610,47.5858,2460
208800.0,3,2.5,1390,0,7,1390,0,47.5298,1390
452000.0,2,2.5,1260,0,8,1260,0,47.6715,1490
837000.0,5,2.75,2940,0,8,2760,180,47.6879,3090
780000.0,5,3.5,3190,0,8,2430,760,47.7016,2580
1485000.0,4,3.5,3930,0,10,3310,620,47.6646,3390
1600000.0,5,3.75,3570,0,10,3570,0,47.5639,1760
369946.0,3,2.5,2420,0,8,2420,0,47.371,2370
530000.0,3,2.75,3400,2,9,2470,930,47.4878,1580
386000.0,4,2.5,2478,0,8,2478,0,47.3524,2279
1900000.0,4,2.5,3070,2,11,1970,1100,47.593,2440
735000.0,4,3.5,3200,2,9,2500,700,47.3443,2240
1750000.0,5,3.25,5790,3,10,4430,1360,47.538,5790
489950.0,3,2.25,1590,0,8,1590,0,47.5402,1640
357500.0,3,3.0,1730,0,8,1440,290,47.5344,1370
329995.0,4,2.5,2303,0,8,2303,0,47.2599,2303
414000.0,3,2.5,1790,0,8,1790,0,47.534,1800
533500.0,3,3.5,2490,0,8,1720,770,47.5341,1600
402395.0,4,2.5,2669,0,9,2669,0,47.3262,2669
725000.0,4,3.25,2610,0,10,2160,450,47.5322,2610
1275000.0,6,5.25,6160,0,11,4040,2120,47.6094,4225
239800.0,2,1.75,1290,0,8,1290,0,47.5171,1410
616950.0,5,3.5,3560,0,8,2810,750,47.5542,2910
1258000.0,4,3.25,4360,3,11,3400,960,47.5408,4310
435000.0,3,2.25,1230,0,8,1080,150,47.6519,1230
925000.0,4,3.25,3640,0,10,3640,0,47.6328,2900
631500.0,2,2.5,1780,0,8,1780,0,47.6704,2050
399995.0,3,1.5,1140,0,8,1140,0,47.6907,1230
369950.0,3,2.0,1270,0,8,1270,0,47.6937,1370
475000.0,5,3.5,2780,0,8,2180,600,47.4879,2640
353000.0,4,2.5,1912,0,8,1912,0,47.3511,2020
329950.0,4,2.5,2300,0,8,2300,0,47.2793,1200
367000.0,3,2.5,2828,0,8,2828,0,47.382,2513
447500.0,4,2.5,2425,0,9,2425,0,47.3003,2725
595000.0,4,3.25,3730,0,9,2760,970,47.6725,1800
325000.0,1,1.0,730,0,7,730,0,47.5943,1020
690000.0,2,2.5,1990,0,9,1780,210,47.6264,1955
329950.0,3,2.5,1300,0,8,880,420,47.5893,1300
399500.0,4,2.5,2560,0,8,2560,0,47.4467,1260
555000.0,5,2.5,2450,0,8,2450,0,47.7724,2450
427000.0,2,1.5,1440,0,8,1100,340,47.5607,1440
375000.0,3,2.25,1140,0,8,1140,0,47.6947,1140
499000.0,2,1.5,1110,0,8,930,180,47.6319,1680
750000.0,3,2.5,2620,0,8,2620,0,47.655,2620
336900.0,3,2.5,1690,0,8,1410,280,47.5388,1740
555000.0,2,2.75,1950,0,8,1950,0,47.5925,910
1275000.0,4,3.5,3530,0,10,3530,0,47.6847,2660
999950.0,4,3.5,3310,0,9,2290,1020,47.579,1850
975000.0,5,3.0,2620,0,10,2620,0,47.6804,1680
299000.0,3,2.25,1350,0,8,1350,0,47.4214,1940
479000.0,2,2.5,1741,0,8,1446,295,47.7043,2090
428000.0,3,2.5,1650,0,8,1650,0,47.7108,1650
409000.0,3,2.5,1890,0,7,1890,0,47.6225,2340
798500.0,3,3.0,1950,0,9,1610,340,47.6078,2040
689000.0,4,3.5,4490,0,9,3390,1100,47.5389,4410
375000.0,6,2.25,3206,0,7,3206,0,47.369,2527
775000.0,4,3.5,4130,2,10,4130,0,47.3229,4130
639983.0,5,3.0,2800,0,8,2800,0,47.4969,2910
300000.0,4,3.0,1984,0,7,1984,0,47.3514,2440
627000.0,4,2.5,2750,0,9,2750,0,47.4698,2310
275000.0,3,2.75,1740,0,7,1740,0,47.1941,2380
352800.0,4,2.25,1800,0,8,1800,0,47.5167,1650
565000.0,3,2.25,1540,0,8,1540,0,47.6828,1510
765000.0,4,2.25,2030,0,9,1610,420,47.679,1420
644000.0,4,2.5,3310,0,9,3310,0,47.773,3240
461000.0,3,1.5,1270,0,8,1270,0,47.6988,1270
270500.0,5,2.5,2406,0,8,2406,0,47.2615,1767
640000.0,2,2.25,1540,0,9,1540,0,47.6181,1410
457000.0,4,2.5,2820,0,9,2820,0,47.2958,2597
355000.0,5,2.5,2540,0,7,2540,0,47.5123,1400
356000.0,2,2.25,1230,0,8,1230,0,47.6975,1230
425000.0,4,2.5,1900,0,8,1900,0,47.543,1900
562500.0,5,2.75,2920,0,8,2920,0,47.4935,2520
460000.0,3,2.5,1450,0,8,940,510,47.6754,1410
790000.0,4,3.0,5370,0,10,3500,1870,47.3166,4443
401000.0,3,2.0,1270,0,8,1270,0,47.6933,1330
1095000.0,3,2.5,2550,0,9,2550,0,47.6757,1250
850000.0,4,3.0,3070,0,9,3070,0,47.7079,3200
274500.0,3,2.25,1450,0,7,1450,0,47.367,1660
1940000.0,5,3.5,4230,0,10,4230,0,47.5933,3000
808000.0,4,2.5,3480,0,9,3480,0,47.6857,3490
312000.0,3,2.25,1490,0,7,1220,270,47.5567,1490
320000.0,3,2.25,1200,0,8,1200,0,47.7046,1370
410000.0,3,2.5,2150,0,8,2150,0,47.7373,2140
725000.0,3,3.5,3690,0,10,3690,0,47.5402,3690
335000.0,4,2.5,1900,0,7,1900,0,47.489,1960
519990.0,4,3.25,1690,0,8,1320,370,47.678,3080
533112.0,4,2.75,2790,0,8,2790,0,47.4842,2790
274900.0,3,2.0,1936,0,7,1936,0,47.2602,1620
325000.0,2,2.25,1150,0,7,1150,0,47.5323,1150
350000.0,4,2.5,2040,0,7,2040,0,47.4991,2020
550000.0,4,2.5,2470,0,9,2470,0,47.7407,2580
311850.0,4,2.5,1890,0,8,1890,0,47.343,2720
526000.0,3,2.5,1626,0,8,1419,207,47.6031,1400
375000.0,4,2.5,2250,0,8,2250,0,47.356,2250
299999.0,3,2.25,1350,0,7,1160,190,47.5565,1420
436000.0,3,2.5,1460,0,8,1200,260,47.6719,1280
303000.0,3,2.5,2056,0,7,2056,0,47.338,2056
525000.0,2,2.5,1160,0,8,1040,120,47.6384,1650
575000.0,3,3.0,1384,0,8,1144,240,47.6295,1570
420000.0,2,1.5,1100,0,8,1100,0,47.6584,1110
329950.0,3,2.5,2456,0,8,2456,0,47.297,2478
1830000.0,4,4.25,4500,3,11,2630,1870,47.559,3030
1175000.0,4,3.25,3780,1,11,2240,1540,47.5508,3120
499950.0,2,2.5,1320,0,8,990,330,47.6689,1550
1149000.0,4,3.0,5940,4,11,4950,990,47.5443,4240
400000.0,3,2.0,1650,0,7,1650,0,47.515,2430
246950.0,3,3.0,1670,0,7,1670,0,47.1948,1670
630000.0,3,3.25,1610,0,8,1220,390,47.6236,1750
561000.0,5,2.75,3370,0,9,3370,0,47.4893,3010
287000.0,4,2.5,2660,0,7,2660,0,47.3414,2390
600000.0,3,3.25,1690,0,8,1380,310,47.6397,1670
490000.0,3,2.25,1620,0,8,1620,0,47.6051,1560
330000.0,3,1.75,1300,0,7,840,460,47.5677,1340
286950.0,4,2.5,1610,0,7,1610,0,47.3603,2110
1550000.0,3,3.25,3530,0,9,2660,870,47.641,1900
880000.0,4,2.5,3550,0,10,3550,0,47.6776,1310
577450.0,3,3.0,1730,0,8,1730,0,47.6944,1830
405000.0,5,2.75,2400,0,8,2400,0,47.355,2110
510000.0,3,2.5,1420,0,8,1420,0,47.674,1510
465000.0,2,1.5,1220,0,8,1110,110,47.6374,2010
1300000.0,4,2.25,2360,0,9,2360,0,47.6198,3040
609000.0,4,3.5,3990,3,9,2930,1060,47.488,1980
336000.0,3,2.5,1260,0,8,1260,0,47.6969,1270
375000.0,3,2.5,1580,0,8,1580,0,47.5455,1580
294500.0,3,2.5,1760,0,7,1760,0,47.4903,1760
925000.0,5,3.5,3420,0,9,2520,900,47.6799,1420
730000.0,5,2.75,2870,0,9,2870,0,47.7075,3150
280000.0,4,2.5,1934,0,8,1934,0,47.2602,1919
500000.0,3,1.5,1220,0,8,1220,0,47.674,1510
605000.0,3,2.75,2450,0,9,2450,0,47.5439,3200
379950.0,3,3.25,1860,0,8,1860,0,47.7563,1830
605000.0,3,2.5,1500,2,7,1110,390,47.6327,1500
720000.0,2,1.75,1570,0,9,1570,0,47.6215,1940
549900.0,3,2.0,1280,0,9,1040,240,47.602,1280
427000.0,3,2.5,3192,0,8,3192,0,47.2956,3000
492000.0,3,2.5,1690,0,8,1420,270,47.6022,1280
419190.0,2,2.5,1590,0,8,1590,0,47.5441,1590
650000.0,3,2.5,2870,0,9,2870,0,47.7745,2870
379950.0,4,2.5,2580,0,8,2580,0,47.3607,2570
269800.0,4,2.75,1830,0,8,1830,0,47.366,1813
407000.0,4,2.5,2927,0,7,2927,0,47.3737,2533
580000.0,3,1.5,1320,0,8,1320,0,47.6536,1560
389700.0,3,2.5,1720,0,7,1720,0,47.6861,1720
110000.0,2,1.0,828,0,6,828,0,47.2655,828
230000.0,3,1.5,1040,0,9,900,140,47.5951,1350
533380.0,4,2.75,2790,0,8,2790,0,47.4838,2790
295500.0,3,2.5,1410,0,7,960,450,47.5683,1410
860000.0,4,4.5,4040,0,9,3220,820,47.7067,3940
812000.0,4,3.5,3370,0,9,2750,620,47.5519,3200
324500.0,3,2.5,1660,0,7,1660,0,47.5298,1670
193000.0,2,1.75,910,0,6,910,0,47.3494,1310
355000.0,3,2.25,1280,0,8,1280,0,47.6914,1130
525000.0,4,2.75,2360,0,8,2360,0,47.7737,2360
370950.0,3,2.5,2529,0,7,2529,0,47.3738,2533
1242000.0,4,3.5,4700,2,11,2660,2040,47.6728,3770
950000.0,3,2.5,2780,0,10,2780,0,47.4496,1680
888990.0,4,2.75,3540,0,9,3540,0,47.6181,3540
705000.0,3,2.5,1580,2,8,1080,500,47.6688,1530
268000.0,3,2.5,1700,0,7,1700,0,47.4914,1520
305450.0,3,2.5,1600,0,7,1600,0,47.507,1500
399900.0,2,1.75,1410,0,9,900,510,47.5446,1440
495000.0,3,1.5,1580,0,8,1580,0,47.6765,1580
857326.0,3,3.5,3940,0,10,3940,0,47.438,2015
845950.0,5,2.75,4450,0,9,3650,800,47.7336,4000
303210.0,4,2.5,2009,0,8,2009,0,47.2577,2009
343000.0,6,5.0,2732,0,7,2732,0,47.3045,3078
300000.0,3,2.5,2090,0,7,2090,0,47.3992,2190
334900.0,2,2.5,980,0,8,980,0,47.6844,980
477500.0,5,3.5,2815,0,9,2815,0,47.4299,2583
820000.0,4,2.5,3170,0,9,3170,0,47.6854,3230
580000.0,5,3.25,3030,0,8,2150,880,47.553,2020
350000.0,2,2.5,1280,0,8,1060,220,47.6904,1290
910000.0,3,2.5,2030,0,9,1970,60,47.6213,1950
414000.0,3,2.5,2490,0,8,2490,0,47.5051,2640
525000.0,3,2.5,3030,0,8,3030,0,47.4944,3030
650000.0,2,2.5,1470,3,8,1470,0,47.6523,1480
450000.0,3,2.25,1620,0,8,1540,80,47.5394,1620
1270000.0,4,3.0,5520,3,9,3570,1950,47.5655,3770
699000.0,3,3.5,3200,0,10,3200,0,47.7636,2550
899000.0,4,2.5,2580,0,8,2580,0,47.6853,1700
353500.0,4,3.0,2050,0,8,2050,0,47.3523,2050
485000.0,3,2.5,2430,0,7,2430,0,47.5162,2620
782900.0,4,3.25,3060,0,10,2300,760,47.5311,2920
529000.0,2,2.0,1540,0,8,1540,0,47.7628,1840
514700.0,3,3.25,1310,0,8,1060,250,47.6744,1160
409316.0,3,2.5,1800,0,8,1800,0,47.5342,1800
388598.0,3,2.5,2370,0,8,2370,0,47.3699,2370
415000.0,3,2.25,1445,0,7,1300,145,47.5341,1445
521500.0,3,2.25,1450,0,8,1140,310,47.6076,1580
580000.0,3,2.5,1740,2,8,1740,0,47.5891,1740
882566.0,4,2.5,3560,0,8,3560,0,47.7047,3220
525000.0,3,2.75,2130,0,9,1080,1050,47.5661,1880
515000.0,5,2.75,2980,0,9,2980,0,47.7698,2850
589410.0,3,3.0,2840,0,9,2840,0,47.5165,2540
757500.0,4,2.5,3420,0,9,3420,0,47.6777,2800
284000.0,3,2.5,1660,0,7,1660,0,47.3595,1800
338500.0,2,2.25,1150,0,7,1150,0,47.5323,1150
379500.0,3,2.25,1410,0,7,1290,120,47.5344,1490
550000.0,3,2.0,1420,0,9,1340,80,47.6472,1540
294900.0,3,2.5,1860,0,8,1860,0,47.3557,2000
345000.0,2,1.5,1340,0,8,1120,220,47.588,1340
450000.0,2,1.5,1530,0,8,1200,330,47.602,1530
420000.0,3,2.5,1509,0,8,1509,0,47.7049,1509
740000.0,3,2.5,2350,0,8,2350,0,47.543,2020
286000.0,2,1.5,1010,0,7,1010,0,47.7124,1128
870000.0,5,3.5,4495,0,9,3580,915,47.7339,4495
727000.0,3,2.5,1580,0,9,1580,0,47.6276,1610
395000.0,4,3.0,2750,0,9,2750,0,47.3479,2750
535000.0,4,2.25,1890,0,7,1890,0,47.5493,1630
255000.0,3,2.25,1320,0,7,1040,280,47.5199,1300
260000.0,4,2.5,2150,0,8,2150,0,47.3363,2150
810000.0,4,2.5,3340,0,9,3340,0,47.6761,1560
359782.0,3,2.5,1850,0,7,1850,0,47.6871,1850
500000.0,2,2.5,1950,0,9,1500,450,47.5622,1800
1049990.0,5,3.25,4240,0,9,4240,0,47.6901,4080
810000.0,4,3.5,2700,0,11,1920,780,47.5685,1430
605000.0,5,4.0,3040,0,8,2280,760,47.5189,3070
730000.0,4,2.5,2460,0,8,2460,0,47.6684,1850
327000.0,4,2.5,2110,0,7,2110,0,47.359,1950
370000.0,2,1.0,780,0,7,780,0,47.5924,1130
459000.0,5,3.5,2640,0,7,2640,0,47.5298,2640
2900000.0,5,4.0,5190,1,11,5190,0,47.6102,3840
365000.0,4,2.5,2420,0,8,2420,0,47.372,2440
255000.0,4,2.5,1987,0,7,1987,0,47.2679,1880
375000.0,1,1.0,720,0,6,720,0,47.5811,1140
375000.0,2,1.5,1130,0,8,1000,130,47.5638,1500
518380.0,4,2.5,2810,0,9,2810,0,47.3552,2980
346000.0,3,3.25,1500,0,8,1150,350,47.5592,1500
302059.0,4,2.0,1390,0,7,1390,0,47.5393,1390
575000.0,4,2.5,2500,0,9,2500,0,47.5185,2760
549950.0,4,3.5,3906,2,9,3906,0,47.2931,2673
900000.0,5,6.0,7120,4,12,5480,1640,47.5451,3440
397500.0,3,2.5,1470,0,8,930,540,47.6033,1510
1075000.0,5,3.5,3230,0,10,3230,0,47.6467,3230
775900.0,3,2.5,2700,0,9,2700,0,47.5618,3270
510000.0,4,2.5,4073,0,8,4073,0,47.2949,1780
471275.0,4,2.5,3361,0,9,3361,0,47.3269,2316
288000.0,4,2.25,1610,0,7,1610,0,47.3669,1760
989990.0,4,3.5,3830,0,9,3830,0,47.7049,3640
300000.0,3,3.25,1470,0,7,1180,290,47.5537,1470
664950.0,5,3.0,3190,2,9,1890,1300,47.509,2270
699188.0,4,3.25,3250,0,9,3250,0,47.5178,3250
390000.0,3,2.25,1490,0,7,1490,0,47.7607,1750
670000.0,5,2.75,2900,0,8,2900,0,47.5977,2900
487000.0,4,2.5,2540,0,9,2540,0,47.5423,2360
769995.0,5,2.75,3360,0,9,3360,0,47.7757,3360
321950.0,2,1.25,860,0,7,860,0,47.5842,1280
613500.0,4,2.5,3020,0,9,3020,0,47.773,3240
300000.0,3,2.5,1330,0,7,1330,0,47.7034,1330
400950.0,4,2.5,2578,0,9,2578,0,47.2603,2647
389517.0,4,2.5,2640,0,8,2640,0,47.371,2370
255000.0,3,1.75,1260,0,7,810,450,47.5261,1260
1080000.0,3,2.5,1990,0,9,1990,0,47.6271,1990
637850.0,5,3.25,3340,2,9,2500,840,47.5193,3220
636230.0,4,2.5,2840,0,9,2840,0,47.5135,2790
375000.0,3,2.5,1530,0,8,1530,0,47.6993,1530
586500.0,3,2.5,1780,0,8,1600,180,47.6539,1780
544000.0,4,2.5,2340,0,8,1930,410,47.5451,2950
425000.0,4,2.5,2390,0,7,2390,0,47.5353,2520
374950.0,4,2.5,2090,0,8,2090,0,47.3595,2160
294570.0,3,1.0,1140,0,7,1140,0,47.5022,1400
300000.0,3,2.5,1960,0,7,1670,290,47.4873,1980
395950.0,5,3.5,2738,0,8,2738,0,47.2962,2738
800000.0,4,2.5,3691,1,8,3691,0,47.6122,3190
439990.0,3,2.5,2340,0,8,2340,0,47.4832,2790
680000.0,4,3.5,2510,0,8,1990,520,47.7002,2560
677790.0,6,3.0,2800,0,8,2800,0,47.6892,1440
424950.0,3,2.5,1650,0,8,1650,0,47.5336,1800
223990.0,2,2.25,1061,0,7,1061,0,47.346,1481
498000.0,4,2.5,3402,0,10,2846,556,47.3009,3402
359950.0,4,2.5,2542,0,8,2542,0,47.3751,2419
720000.0,3,2.5,3150,0,9,3150,0,47.572,2410
530000.0,4,2.5,3010,0,8,3010,0,47.4987,3250
295000.0,3,2.5,1660,0,7,1660,0,47.3588,1810
255500.0,3,2.5,1770,0,7,1770,0,47.3358,2230
556000.0,3,3.0,1960,0,9,1600,360,47.5445,2080
277950.0,4,2.5,1889,0,7,1889,0,47.2676,1990
431000.0,4,2.5,3040,0,9,3040,0,47.3473,2640
780000.0,4,2.75,3420,0,9,3420,0,47.6962,3450
649000.0,3,3.25,1720,0,8,1030,690,47.6201,1720
447000.0,3,2.5,1740,0,7,1740,0,47.744,1920
712198.0,4,2.5,2450,0,8,2450,0,47.7048,2970
277140.0,3,1.5,1190,0,8,920,270,47.6781,2820
363000.0,4,2.5,3753,0,10,3336,417,47.3011,3494
598992.0,5,3.5,3440,0,9,3440,0,47.4765,3270
585000.0,3,2.5,2160,0,8,1830,330,47.6515,1870
1274950.0,4,2.75,3820,0,10,3820,0,47.6506,2330
380950.0,2,2.0,1120,0,7,840,280,47.5788,1130
333490.0,4,2.5,2250,0,8,2250,0,47.3413,2156
520000.0,3,3.25,1540,0,8,1540,0,47.5397,1620
315000.0,2,2.25,1240,0,7,1150,90,47.5321,1240
487000.0,2,1.5,1160,0,8,1020,140,47.6754,1210
424950.0,5,3.5,2760,0,8,2760,0,47.5049,2590
542300.0,3,2.25,1580,0,9,1580,0,47.6514,1600
320000.0,3,3.25,1480,0,8,1180,300,47.5556,1330
1139990.0,4,3.25,3740,0,10,3740,0,47.581,2510
425000.0,4,2.5,1950,0,8,1950,0,47.515,2710
474950.0,3,3.0,1530,0,8,1530,0,47.6998,1460
307635.0,3,2.5,1820,0,8,1820,0,47.3693,2370
834538.0,3,2.5,2760,0,10,2760,0,47.5821,2760
769995.0,5,2.75,3010,0,9,3010,0,47.6067,3360
820875.0,5,3.25,3860,2,9,3860,0,47.538,3860
595500.0,4,2.5,2490,0,8,2490,0,47.5185,2520
450000.0,4,2.5,3236,0,10,3236,0,47.3838,3236
695000.0,4,2.5,2830,0,8,2830,0,47.5405,2270
300000.0,3,2.0,1451,0,7,1451,0,47.3754,2303
515000.0,5,3.25,2910,0,8,2040,870,47.5543,2910
545000.0,3,2.5,1280,0,8,1280,0,47.662,1450
365000.0,3,2.25,1110,0,7,960,150,47.5999,1170
718500.0,4,2.75,2840,0,9,2840,0,47.7029,1840
279800.0,3,1.75,1410,0,8,1410,0,47.5171,1410
486940.0,4,2.5,3250,0,9,3250,0,47.3524,2612
525000.0,4,2.75,3030,0,8,3030,0,47.4815,3030
345000.0,4,2.5,1983,0,9,1983,0,47.3281,2502
613000.0,3,3.25,2440,0,8,1710,730,47.5362,2440
370000.0,3,2.5,2313,0,9,2313,0,47.3572,2323
449500.0,3,2.25,1260,0,7,1260,0,47.5482,1630
515000.0,3,2.5,2000,0,8,2000,0,47.7713,2210
346100.0,2,1.75,1150,0,7,1150,0,47.5323,1150
398500.0,4,2.5,2820,0,9,2820,0,47.3473,1880
310000.0,2,1.75,1160,0,7,1160,0,47.6489,970
250000.0,3,2.25,1481,0,7,1481,0,47.3457,1481
1880000.0,5,3.5,4390,3,9,3170,1220,47.6789,2740
695000.0,2,1.75,1570,0,9,1570,0,47.6215,1570
1085000.0,4,3.0,3410,2,9,2680,730,47.5416,2300
864327.0,5,3.25,3480,0,9,3480,0,47.607,3360
749995.0,4,3.25,3430,0,9,3430,0,47.776,3360
525000.0,5,2.75,2880,0,9,2880,0,47.4893,3010
659950.0,3,2.5,2990,0,10,2990,0,47.7341,1940
1800000.0,5,5.0,4490,0,10,3930,560,47.5974,2490
950000.0,5,4.0,4100,0,9,4100,0,47.6917,4100
1399950.0,4,2.75,3870,0,11,3870,0,47.6651,3560
265050.0,2,1.5,800,0,7,800,0,47.554,1020
450000.0,3,2.25,1620,0,8,1540,80,47.5396,1390
915000.0,4,2.5,2910,0,8,2910,0,47.6705,2840
963000.0,4,3.25,3530,0,10,3530,0,47.6975,2470
270000.0,4,2.5,2701,0,7,2701,0,47.2873,2566
294000.0,2,2.5,1380,0,7,1140,240,47.5441,1580
700000.0,3,2.5,2050,0,9,2050,0,47.6922,1150
1065000.0,3,4.0,3370,0,10,3370,0,47.5965,3710
494900.0,3,2.5,2040,0,7,1470,570,47.573,1410
415000.0,3,2.5,1610,0,8,1610,0,47.771,2210
459990.0,3,2.5,2680,0,8,2680,0,47.4761,2990
882990.0,4,3.5,3560,0,10,3560,0,47.5929,3710
620000.0,4,3.5,3880,0,10,3060,820,47.7426,3180
375900.0,3,2.0,1824,0,9,1824,0,47.3457,2409
654000.0,3,2.5,2220,0,10,2010,210,47.5311,2290
1839900.0,4,3.25,4140,0,10,4140,0,47.5707,2150
215000.0,3,2.5,1322,0,7,1322,0,47.2706,1440
630500.0,3,2.5,1909,0,8,1766,143,47.6538,1780
855000.0,4,3.5,3460,0,10,3460,0,47.5942,3380
235245.0,4,2.5,1954,0,8,1954,0,47.2606,1934
770000.0,5,2.5,3000,0,9,1610,1390,47.6765,2700
734990.0,4,2.5,2650,0,8,2650,0,47.6901,2520
880000.0,4,2.5,2580,0,8,2580,0,47.6853,1780
525000.0,4,3.0,2650,0,8,2650,0,47.7734,2380
775000.0,4,3.5,3390,0,10,3390,0,47.5406,2990
687015.0,3,1.75,1470,0,10,1470,0,47.6256,1410
663000.0,3,2.5,1910,0,9,1910,0,47.5481,1910
815000.0,4,2.5,3030,0,9,3030,0,47.6934,3030
1050000.0,4,3.25,2930,0,9,2930,0,47.5514,2400
433190.0,3,2.5,1650,0,8,1650,0,47.5336,1760
725000.0,4,2.5,2870,0,9,2870,0,47.5544,2940
279950.0,3,2.5,1608,0,8,1608,0,47.2585,2009
272167.0,2,2.5,1620,0,7,1620,0,47.5321,1620
468500.0,3,2.5,1350,0,8,1120,230,47.6786,1500
298000.0,3,2.5,1950,0,7,1950,0,47.3658,1870
303500.0,6,4.5,3390,0,8,2440,950,47.5205,2040
308000.0,3,1.75,1300,0,7,1060,240,47.539,1350
646800.0,3,3.0,2230,0,8,1850,380,47.5446,2230
530200.0,4,2.5,1880,0,8,1880,0,47.5636,1890
405000.0,5,2.5,3370,0,7,3370,0,47.3594,2910
529000.0,2,2.5,1320,0,8,990,330,47.6689,1550
675900.0,3,2.5,2920,0,9,2920,0,47.4855,2930
570000.0,3,3.25,1550,0,9,1220,330,47.6493,1550
375500.0,4,2.5,2301,0,9,2301,0,47.346,2650
445000.0,3,3.25,1710,0,8,1360,350,47.5479,1420
1100000.0,4,3.75,2890,0,9,2240,650,47.676,2354
477000.0,3,2.5,2100,0,7,2100,0,47.563,1520
450000.0,3,2.75,2240,0,8,2100,140,47.4999,1790
427005.0,3,3.0,1460,0,8,1460,0,47.7,1460
720000.0,3,1.75,1370,0,9,1370,0,47.6434,1730
2230000.0,3,3.5,3760,4,11,2830,930,47.5285,3560
450800.0,4,3.25,2510,0,9,2510,0,47.5028,1590
461100.0,2,2.25,1210,0,8,1120,90,47.6783,1360
1061600.0,4,3.0,2990,0,10,2990,0,47.5817,2760
590000.0,3,2.5,1710,0,8,1710,0,47.5787,1640
478830.0,4,2.5,3274,0,9,3274,0,47.2603,2578
760000.0,4,2.25,3300,0,9,3300,0,47.5363,1290
1025000.0,4,3.5,4370,0,11,4370,0,47.5066,3560
385000.0,4,2.5,2050,0,7,2050,0,47.491,2480
500000.0,2,2.5,1310,0,8,1160,150,47.6112,1320
425000.0,3,1.5,1680,0,7,1680,0,47.6923,1990
552100.0,3,3.0,1330,0,8,1120,210,47.6126,1810
785000.0,3,3.0,1950,0,9,1610,340,47.6078,2040
615000.0,5,3.25,3090,0,9,3090,0,47.5114,2480
309000.0,3,2.5,1950,0,7,1950,0,47.3588,1950
369500.0,3,2.0,1108,0,7,1108,0,47.6961,1285
391000.0,4,2.25,2190,0,7,2190,0,47.4861,2190
465000.0,3,1.75,1590,0,8,1060,530,47.5753,1530
879950.0,4,2.75,3010,0,9,3010,0,47.6952,3010
372000.0,3,2.0,1330,0,8,1060,270,47.5522,1440
259000.0,3,2.5,1550,0,7,1550,0,47.3528,2095
374000.0,2,1.5,1260,0,7,1260,0,47.5914,1220
561000.0,4,2.5,2550,0,8,2550,0,47.5355,2850
610000.0,3,2.5,1300,0,8,1300,0,47.6607,1450
635000.0,3,3.0,2230,0,8,1850,380,47.5446,2290
235000.0,1,1.5,1170,0,8,1070,100,47.5493,1360
623300.0,4,3.5,4170,0,9,3500,670,47.7726,3510
412500.0,3,2.0,1680,0,7,1680,0,47.5206,2430
380000.0,4,3.25,2864,0,8,2864,0,47.3746,2419
497000.0,3,2.25,1630,0,7,1630,0,47.5485,1630
452000.0,4,2.5,2716,0,9,2716,0,47.352,2580
312000.0,3,2.5,1750,0,7,1750,0,47.3597,1810
469950.0,5,3.0,3223,0,9,3223,0,47.3588,1979
775000.0,5,2.5,2600,0,9,2600,0,47.5409,1620
679990.0,4,2.75,3320,0,8,3320,0,47.7521,2140
288790.0,4,2.0,1350,0,7,1350,0,47.5401,1390
800000.0,5,2.5,3410,0,9,3410,0,47.5459,2810
299000.0,3,2.5,1572,0,8,1572,0,47.2615,1608
332000.0,4,2.5,2300,0,7,2300,0,47.3599,2300
525000.0,1,1.5,1030,0,8,1030,0,47.6653,2650
620000.0,3,1.75,1458,0,8,950,508,47.592,1458
452000.0,4,2.5,2190,0,7,2190,0,47.5191,2190
630000.0,4,3.0,3640,0,8,2740,900,47.5428,1910
485000.0,4,2.75,2790,0,8,2790,0,47.4823,2620
349950.0,4,2.5,2632,0,8,2632,0,47.3428,2040
499990.0,4,2.75,2910,0,8,2910,0,47.4826,2790
510000.0,2,2.25,1470,0,8,1340,130,47.6768,1470
1080000.0,3,2.5,2240,2,8,2240,0,47.5745,2930
494000.0,3,2.5,2310,0,8,2310,0,47.7734,2440
429900.0,3,2.5,2370,0,8,2370,0,47.7333,2130
505000.0,4,2.75,2980,0,8,1910,1070,47.5073,2580
272000.0,4,2.0,1870,3,7,1870,0,47.1934,2280
671500.0,3,2.5,1770,0,8,1770,0,47.6532,1720
729950.0,4,3.5,3510,0,10,3510,0,47.5412,4200
471835.0,4,2.5,3281,0,9,3281,0,47.3273,2598
249950.0,3,2.0,1670,0,7,1670,0,47.1948,1670
424950.0,5,3.5,2760,0,8,2760,0,47.5047,2760
1240000.0,5,3.5,5430,2,10,4010,1420,47.5476,4340
440000.0,4,2.5,2990,0,9,2990,0,47.3139,2810
495000.0,4,3.5,3170,0,8,2530,640,47.5049,2640
870000.0,4,2.5,3520,0,9,2650,870,47.5317,2930
559000.0,2,3.0,1650,0,8,1350,300,47.6611,1650
495000.0,4,2.75,2656,0,9,2656,0,47.3162,1860
722000.0,3,2.5,2230,0,8,2230,0,47.7295,2230
567500.0,3,2.5,2280,0,8,1880,400,47.5364,2280
440000.0,4,2.5,2798,0,9,2798,0,47.3308,2502
400000.0,4,2.5,2398,0,8,2398,0,47.452,2370
459995.0,4,2.5,2350,0,8,2350,0,47.4786,2590
365000.0,5,2.75,2410,0,7,1410,1000,47.5298,1590
389950.0,3,2.25,1580,0,8,1580,0,47.5578,1250
320000.0,3,3.25,1450,0,8,1180,270,47.5556,1450
415500.0,4,2.5,1750,0,7,1750,0,47.7608,1580
775000.0,3,2.5,3020,0,9,2360,660,47.5714,2280
590000.0,3,3.0,1740,0,8,1740,0,47.67,1370
950000.0,2,2.25,2200,0,9,1760,440,47.6213,2020
378950.0,4,2.5,1867,0,9,1867,0,47.3524,2616
441750.0,2,1.5,1020,0,8,1020,0,47.6801,1340
335900.0,4,2.75,2475,0,7,2475,0,47.345,2475
229800.0,2,1.75,1110,0,8,1110,0,47.5647,1420
645000.0,3,2.5,1900,0,7,1700,200,47.6465,1780
448000.0,3,3.25,1560,0,8,1260,300,47.5637,1560
706000.0,4,2.5,2510,0,8,2510,0,47.6894,2520
988990.0,4,4.75,4150,0,9,4150,0,47.7047,3570
716000.0,3,3.0,1660,0,9,1660,0,47.6649,1660
319000.0,2,1.5,1090,0,8,1090,0,47.7235,1090
300000.0,4,2.5,1914,0,8,1914,0,47.4297,1714
625000.0,4,3.25,2730,0,9,1560,1170,47.5133,2730
773000.0,3,2.75,2470,0,9,2470,0,47.5406,2570
392000.0,5,2.5,2340,0,7,2340,0,47.4913,2190
549995.0,4,3.5,2660,0,8,1920,740,47.4775,2970
480000.0,3,2.5,2410,0,7,2410,0,47.5203,2410
355000.0,3,2.25,1430,0,7,1430,0,47.4867,1639
208400.0,2,2.5,1570,0,7,1570,0,47.534,1570
831548.0,5,2.75,3010,0,9,3010,0,47.6067,3230
279500.0,4,2.5,1613,0,7,1613,0,47.3859,1427
445000.0,3,2.5,2380,0,8,2380,0,47.5066,2150
492500.0,5,2.5,2570,0,8,2570,0,47.7275,2890
435000.0,4,2.5,2550,0,7,2550,0,47.4919,2550
325000.0,3,2.25,1330,0,7,1330,0,47.7177,1310
453000.0,2,1.5,1160,0,7,970,190,47.6608,1700
612995.0,5,3.5,3240,0,8,2760,480,47.4779,2970
540000.0,4,2.5,2710,0,7,2710,0,47.5164,2710
465000.0,3,1.0,1150,0,7,1150,0,47.4262,1714
799950.0,3,2.25,1860,0,9,1860,0,47.6368,1680
495000.0,3,2.25,1280,0,8,1080,200,47.6651,1280
579950.0,3,2.5,1810,0,7,1810,0,47.6957,1560
331000.0,2,2.25,1240,0,7,1150,90,47.5322,1260
580000.0,4,3.5,1460,0,8,1460,0,47.6821,1430
669000.0,2,2.5,1640,0,10,1640,0,47.5639,1820
2351960.0,4,4.25,5010,1,11,4000,1010,47.5455,3820
539900.0,3,3.25,1300,0,8,1080,220,47.6584,1290
490000.0,4,2.5,2510,0,8,2510,0,47.4927,2510
627000.0,3,3.5,2710,0,8,1650,1060,47.5359,2440
458000.0,4,3.5,3217,0,8,2587,630,47.4483,2996
440000.0,3,2.5,1650,0,7,1520,130,47.5634,1520
1698000.0,4,3.5,3950,0,11,3950,0,47.6221,2040
935000.0,2,2.5,1680,0,9,1680,0,47.632,1680
641000.0,5,3.5,3420,2,8,2700,720,47.5162,2710
452000.0,3,2.75,2300,0,8,1700,600,47.545,1530
625000.0,4,2.75,3010,2,9,2570,440,47.5171,1830
1350000.0,4,3.5,4680,0,10,3040,1640,47.6984,3240
834950.0,5,3.5,3630,0,9,2790,840,47.718,3600
1500000.0,3,3.5,3530,0,10,2370,1160,47.6857,1780
305000.0,4,2.5,2280,0,7,2280,0,47.3586,2630
659000.0,3,2.5,3090,0,8,3090,0,47.7072,2200
353000.0,1,1.0,550,0,7,550,0,47.616,1460
535000.0,4,3.25,2840,3,9,2330,510,47.5529,2160
999000.0,4,2.5,3130,0,10,3130,0,47.6828,2470
375000.0,3,2.5,1440,0,8,1440,0,47.6995,1440
685000.0,4,3.5,2840,0,8,2840,0,47.7033,1730
333000.0,4,2.5,2623,0,8,2623,0,47.259,2010
245000.0,1,1.0,390,0,6,390,0,47.6938,1340
1999950.0,4,3.25,5640,2,11,4900,740,47.5491,4920
329950.0,2,2.25,1260,0,7,1170,90,47.5323,1240
403000.0,2,1.0,894,0,7,894,0,47.6911,1131
559630.0,4,2.5,3370,0,9,3370,0,47.3562,2980
344000.0,3,2.25,1250,0,8,1250,0,47.6907,1250
435000.0,3,1.5,1180,0,7,1180,0,47.6845,1280
430000.0,2,2.5,1520,0,8,1240,280,47.5825,1660
417000.0,3,2.5,2000,0,7,2000,0,47.4937,2230
895950.0,5,2.75,3180,0,9,3180,0,47.6232,3180
563950.0,4,2.75,3050,0,8,3050,0,47.4857,2730
332220.0,3,1.5,2580,0,7,1360,1220,47.5333,1760
1488000.0,5,6.0,6880,3,12,4070,2810,47.4624,4690
680000.0,3,2.5,2570,0,9,2570,0,47.5412,2570
825750.0,4,3.5,2950,0,10,2270,680,47.5313,2580
338000.0,3,2.5,1690,0,8,1410,280,47.5387,1740
535365.0,4,2.75,2790,0,8,2790,0,47.4836,2620
608000.0,3,2.25,1720,0,9,1240,480,47.5547,1720
930000.0,3,2.25,2890,0,9,2890,0,47.6983,2020
565000.0,2,1.75,1130,0,8,1130,0,47.2673,2092
495000.0,2,2.25,1460,0,8,1260,200,47.6764,1460
667000.0,3,2.5,2510,0,8,2510,0,47.6987,2520
495000.0,4,2.5,3390,0,8,3390,0,47.4536,1960
928990.0,4,2.5,3570,0,9,3570,0,47.7053,3600
345000.0,4,2.5,2280,0,7,2280,0,47.3593,2910
1065000.0,5,3.5,2920,0,9,2260,660,47.6846,1580
519995.0,4,3.0,2590,0,8,2590,0,47.4784,2670
924000.0,5,2.75,3210,0,9,3210,0,47.5935,3190
295000.0,3,2.0,1230,0,7,1230,0,47.438,1440
472000.0,3,2.5,3800,0,8,3210,590,47.4304,2040
405000.0,3,2.5,1500,0,7,1500,0,47.5537,1440
410000.0,4,2.25,2510,0,8,1840,670,47.7345,2070
419500.0,3,1.5,1400,0,8,1400,0,47.6989,1270
382000.0,3,2.25,1450,0,7,1450,0,47.7611,1490
370000.0,2,2.5,1390,0,7,1180,210,47.5537,1350
553000.0,3,2.75,3160,0,9,3160,0,47.5147,3160
2065000.0,4,3.75,4350,0,10,4350,0,47.6289,2190
455950.0,4,2.5,2720,0,8,2720,0,47.4917,1940
331000.0,3,3.25,1290,0,7,1290,0,47.6904,1290
417250.0,3,2.25,1606,0,8,1606,0,47.7175,1516
490000.0,5,3.5,4460,2,10,3280,1180,47.6313,2490
325000.0,4,3.25,2800,0,7,2800,0,47.1937,2380
705000.0,5,3.5,3250,0,9,2410,840,47.5618,1330
1174660.0,6,3.5,4310,0,10,3260,1050,47.5297,4620
365000.0,3,2.25,1310,0,7,1060,250,47.5738,1500
403000.0,2,1.5,1240,0,8,1080,160,47.5758,1530
409000.0,3,2.5,1950,0,7,1950,0,47.5194,2190
391000.0,3,2.5,1800,0,8,1800,0,47.5436,1800
542525.0,4,2.5,2650,0,8,2650,0,47.4786,2650
339950.0,2,1.0,820,0,8,820,0,47.6619,820
499990.0,4,2.75,2620,0,8,2620,0,47.4838,2620
1765000.0,4,3.25,3980,0,10,3980,0,47.5873,2450
608000.0,3,3.5,1660,0,8,1260,400,47.5809,1500
392000.0,4,2.5,2130,0,8,2130,0,47.5108,1830
320000.0,3,1.75,1790,0,7,1790,0,47.7179,1440
274800.0,3,1.75,1410,0,8,1410,0,47.5171,1410
325000.0,3,2.25,1330,0,8,1080,250,47.555,1260
418500.0,4,2.5,2190,0,7,2190,0,47.4907,2190
300000.0,3,2.5,2540,0,7,2540,0,47.3358,2280
269950.0,3,2.5,2244,0,7,2244,0,47.2606,2077
358000.0,3,2.5,2026,0,8,2026,0,47.3733,2270
350000.0,3,2.5,1730,0,8,1730,0,47.5016,2030
782000.0,4,3.5,3910,0,9,3130,780,47.5588,3770
779000.0,3,2.5,1580,1,9,1580,0,47.6276,1610
685000.0,4,2.5,2510,0,8,2510,0,47.6981,2540
305000.0,2,2.25,1000,0,8,1000,0,47.6842,980
350000.0,4,2.5,1660,0,7,1660,0,47.5437,1030
775000.0,4,3.5,3060,0,9,2410,650,47.5522,3170
317750.0,3,2.5,1980,0,7,1980,0,47.3682,1980
438000.0,2,1.0,980,0,8,980,0,47.6381,1190
325000.0,2,2.5,1050,0,7,1050,0,47.5854,1120
830000.0,4,3.25,3080,0,10,2230,850,47.5313,2250
353000.0,3,2.25,1900,0,7,1900,0,47.4866,1950
460000.0,4,2.5,2200,0,8,2200,0,47.4856,2600
370000.0,3,1.5,1360,0,8,1360,0,47.6962,1360
330000.0,3,2.5,2238,0,8,2238,0,47.2966,2456
569888.0,4,2.5,2590,0,8,2590,0,47.5164,1960
353900.0,3,2.5,2517,0,8,2517,0,47.3211,2390
695000.0,4,3.5,3510,0,10,3510,0,47.5402,3690
288790.0,3,1.75,1290,0,7,1060,230,47.54,1370
334950.0,5,3.0,2230,0,7,1330,900,47.487,2100
869950.0,4,2.75,3140,0,9,3140,0,47.5923,3500
557500.0,3,3.5,3350,2,8,2670,680,47.5699,2030
389990.0,4,2.5,2245,0,8,2245,0,47.3557,2530
455000.0,3,1.75,1420,0,8,1420,0,47.6625,1380
598500.0,3,3.0,1560,0,8,1560,0,47.6604,1530
750000.0,4,2.75,2810,0,9,2810,0,47.7081,2990
729999.0,2,2.25,1630,0,10,1330,300,47.6113,1570
299950.0,3,2.5,1740,0,7,1740,0,47.3697,1950
374950.0,3,2.25,1390,0,8,1390,0,47.6912,1250
386950.0,3,2.5,1070,0,7,900,170,47.5902,1450
535000.0,5,3.25,2850,0,8,2370,480,47.4916,2850
890000.0,5,3.25,4100,2,10,4100,0,47.5955,3710
1050000.0,4,2.5,3260,1,9,2820,440,47.6772,2260
1107460.0,4,3.5,3660,0,9,2840,820,47.6482,3210
436952.0,4,2.5,2708,0,9,2708,0,47.3413,2502
365000.0,3,2.5,1800,0,8,1800,0,47.5458,1580
288000.0,3,2.5,1150,0,7,1150,0,47.7072,1180
700000.0,3,2.5,2230,0,8,2230,0,47.73,2230
800000.0,4,3.25,3540,0,9,3540,0,47.6285,1940
899000.0,4,3.5,2490,0,9,1780,710,47.5499,1710
465750.0,3,2.5,2670,0,9,2670,0,47.51,3040
485000.0,2,2.5,1430,0,8,1410,20,47.6683,1620
494995.0,5,2.75,2670,0,8,2670,0,47.4783,2670
255000.0,3,2.5,2555,0,8,2555,0,47.386,2844
530000.0,3,2.5,1970,0,7,1970,0,47.5158,2710
435000.0,3,2.0,1980,0,8,1980,0,47.5524,1440
639000.0,3,2.5,2010,0,9,1610,400,47.5573,1660
440000.0,3,1.5,1270,0,8,1270,0,47.6989,1270
914500.0,4,2.5,3950,0,10,3950,0,47.5818,3200
580000.0,3,2.0,1870,0,8,1870,0,47.7106,1870
250000.0,1,1.5,1180,0,8,1070,110,47.549,1380
410000.0,3,2.5,1420,0,7,1420,0,47.6904,1420
531155.0,4,2.75,2810,0,9,2810,0,47.3559,3060
358000.0,3,2.5,1400,0,7,1400,0,47.5535,1440
425000.0,3,2.5,1950,0,7,1950,0,47.5158,2190
326000.0,3,2.25,1930,0,7,1930,0,47.7453,1930
650000.0,4,2.5,2210,0,9,2210,0,47.6959,1590
749950.0,4,3.5,2630,0,10,2200,430,47.5322,2620
239950.0,3,1.75,1600,0,6,1600,0,47.383,2520
315000.0,3,2.5,1480,0,8,1150,330,47.5302,1480
375000.0,2,2.5,750,0,8,750,0,47.6093,1320
375000.0,3,1.5,1290,0,8,1290,0,47.6965,1360
349000.0,3,3.25,1340,0,7,1340,0,47.6904,1290
450000.0,2,1.5,1020,0,8,1020,0,47.68,1350
669950.0,3,3.0,2330,0,8,1950,380,47.5446,2290
504600.0,5,3.0,2360,0,7,1390,970,47.6931,2180
400000.0,3,2.5,1495,0,8,1405,90,47.593,1495
1020000.0,4,3.5,3770,0,10,3770,0,47.6744,1520
518000.0,5,2.5,2890,0,8,2890,0,47.7277,3020
535000.0,3,2.75,1320,0,8,1320,0,47.6598,1320
337500.0,4,2.5,2330,0,7,2330,0,47.359,2300
380000.0,4,2.5,3120,0,9,3120,0,47.2779,3120
875000.0,5,3.0,2960,0,9,2960,0,47.6689,1850
385000.0,3,2.25,1630,0,8,1630,0,47.6904,1320
1987500.0,5,3.5,5230,0,11,4450,780,47.5964,2310
649500.0,4,3.0,3150,0,9,3150,0,47.5279,2680
1050000.0,4,3.75,3280,0,10,2320,960,47.6855,2400
249000.0,3,1.0,1030,2,5,1030,0,47.3343,2810
525000.0,4,2.5,3130,0,9,3130,0,47.4997,2950
402000.0,3,3.5,1240,0,7,1000,240,47.5496,1110
1750000.0,4,2.75,3560,0,10,3560,0,47.6322,3440
359800.0,5,2.5,2170,0,8,2170,0,47.5167,1800
330000.0,3,2.5,1520,0,7,1520,0,47.4876,1820
433000.0,3,2.5,1270,0,8,1060,210,47.6568,1260
1010800.0,4,3.25,3610,0,9,2640,970,47.658,1980
599832.0,3,2.75,3230,0,9,2680,550,47.519,3100
312891.0,5,3.0,2300,0,8,2300,0,47.3052,2594
449000.0,2,2.5,1460,0,8,1160,300,47.5923,1460
495000.0,3,2.5,1750,0,9,1750,0,47.5532,1750
819995.0,5,2.75,3030,0,9,3030,0,47.5305,2720
407500.0,3,3.5,1522,0,8,1248,274,47.6922,1522
850000.0,4,3.75,3890,0,10,3890,0,47.5052,1610
1720000.0,5,4.0,4590,0,10,4590,0,47.6647,3350
1459000.0,4,4.0,4620,0,10,4620,0,47.5885,4620
579000.0,4,2.75,3220,0,8,3220,0,47.4863,2820
890776.0,5,2.75,3170,0,9,3170,0,47.5933,3210
352500.0,2,2.5,980,0,8,980,0,47.6844,980
529000.0,3,1.75,2340,0,10,2340,0,47.4593,3040
484000.0,3,2.25,1620,0,8,1540,80,47.5405,1620
400000.0,3,2.5,1910,0,8,1910,0,47.7634,1910
649950.0,3,2.5,2420,0,9,2420,0,47.7329,1180
915000.0,3,4.5,3850,0,10,3120,730,47.6735,2630
534950.0,5,2.5,3220,0,8,3220,0,47.7268,2890
776000.0,4,2.5,3040,0,8,3040,0,47.6788,3040
370000.0,3,1.75,1496,0,8,1248,248,47.715,1460
610000.0,3,1.75,1630,0,8,1630,0,47.6536,1570
850000.0,5,3.5,4200,0,9,3140,1060,47.7077,3300
443000.0,3,2.5,2430,0,8,2430,0,47.5399,1770
1150000.0,5,4.25,4010,0,10,4010,0,47.5974,3370
453000.0,3,2.5,1510,0,8,1330,180,47.6515,1350
735000.0,4,3.5,2340,2,8,1730,610,47.5403,2600
810000.0,2,2.75,2700,0,9,2700,0,47.7236,2680
1555000.0,3,3.5,4360,3,10,2960,1400,47.6791,1920
2238890.0,5,6.5,7270,0,12,6420,850,47.5371,1800
377500.0,3,2.5,1350,0,8,1270,80,47.5491,1350
482000.0,3,3.25,1380,0,8,1380,0,47.6617,1310
600000.0,2,2.5,1830,0,9,1530,300,47.5779,1800
420000.0,3,2.5,1470,0,8,1180,290,47.5722,1580
480000.0,4,2.5,2940,0,9,2940,0,47.3444,2660
406000.0,2,2.0,1110,0,7,980,130,47.5494,1110
505000.0,4,2.5,2790,0,8,2790,0,47.4959,2790
1865000.0,4,3.75,3790,0,11,3290,500,47.6351,2660
942990.0,4,2.5,3570,0,9,3570,0,47.7046,3230
440000.0,3,2.25,1230,0,8,1230,0,47.6697,1420
390000.0,3,3.25,1370,0,8,1100,270,47.5636,1370
475000.0,3,3.25,1380,0,8,1380,0,47.6617,1310
420000.0,1,2.0,1070,0,8,880,190,47.5574,1220
1408760.0,4,4.0,4920,0,10,4280,640,47.6575,4920
1378000.0,5,3.5,5150,2,10,3700,1450,47.6249,2940
462500.0,6,3.0,2390,0,7,2390,0,47.5173,1680
579950.0,4,2.75,2460,0,9,2460,0,47.4828,3110
861111.0,4,2.5,3650,0,10,3650,0,47.606,3860
1450000.0,4,3.5,4300,0,11,4300,0,47.6258,4650
290000.0,3,2.25,1610,0,7,1610,0,47.3589,1610
535000.0,4,2.5,2610,0,8,2610,0,47.7728,2440
585000.0,3,2.5,1750,0,8,1750,0,47.6021,1940
670000.0,3,2.5,3310,2,8,2440,870,47.5178,2140
3000000.0,4,3.75,5090,0,11,4180,910,47.62,3030
346000.0,3,2.0,1060,0,7,730,330,47.5443,1270
1325000.0,4,4.0,4420,0,11,4420,0,47.5914,3510
999999.0,3,2.5,2100,0,9,2100,0,47.5983,1780
599000.0,3,1.75,1650,0,8,1650,0,47.6636,1720
332000.0,4,2.5,2380,0,7,2380,0,47.2815,2380
336750.0,2,2.25,1170,0,7,1170,0,47.5321,1240
370000.0,4,2.5,2531,0,8,2531,0,47.385,2604
324000.0,3,2.25,998,0,7,798,200,47.6983,998
338500.0,3,2.25,1333,3,7,1333,0,47.7058,1360
1881580.0,5,3.5,4410,3,10,2920,1490,47.5382,5790
402723.0,3,2.75,1160,0,7,880,280,47.5788,1250
715000.0,4,3.25,2630,0,9,2630,0,47.5459,1370
459000.0,3,1.5,1160,0,8,1160,0,47.6538,1268
589999.0,3,2.5,2140,0,8,1960,180,47.537,2280
405000.0,4,2.5,1980,0,7,1980,0,47.5147,1980
509900.0,3,2.5,3030,0,8,3030,0,47.4945,3010
327000.0,2,2.0,1490,0,8,1190,300,47.5455,1400
1057000.0,2,1.5,2370,0,11,2370,0,47.4543,3860
327500.0,3,2.5,1820,0,8,1570,250,47.4643,1660
249000.0,3,2.0,1260,0,7,810,450,47.5262,1260
1375000.0,5,4.5,4350,0,11,4350,0,47.6018,3990
516500.0,1,1.25,1100,0,9,1100,0,47.6228,1110
465000.0,3,2.5,2050,0,9,2050,0,47.3619,1300
388000.0,3,2.5,2198,2,8,2198,0,47.3906,2198
549000.0,3,2.25,1230,0,8,1230,0,47.6521,1760
553000.0,2,2.0,1400,0,8,940,460,47.6719,1400
530000.0,3,2.5,1410,0,8,1140,270,47.6515,1720
747450.0,3,2.5,2110,0,8,1410,700,47.6088,1630
305000.0,2,2.5,1590,0,7,1220,370,47.5489,1590
540000.0,5,2.5,3370,0,9,3370,0,47.5078,2900
750000.0,5,4.0,4500,0,10,4500,0,47.4832,2840
422000.0,4,2.5,2930,0,10,2930,0,47.3846,3038
337000.0,4,2.5,2470,0,8,2470,0,47.3622,2240
579950.0,5,2.75,3080,0,9,3080,0,47.4922,3000
341780.0,4,2.75,2260,0,7,2260,0,47.3507,2260
710200.0,4,3.0,1670,0,8,1350,320,47.6397,1670
690000.0,3,3.25,1540,0,9,1540,0,47.6648,1660
1700000.0,4,3.5,3830,0,10,3120,710,47.599,2190
329000.0,2,2.5,980,0,8,980,0,47.6844,980
330000.0,3,2.5,1450,0,7,840,610,47.5435,2120
608500.0,4,3.5,2850,0,8,1950,900,47.5252,2850
230000.0,3,1.75,1140,0,8,1140,0,47.5637,1210
785000.0,4,3.5,3070,0,10,2190,880,47.5316,2290
610950.0,3,3.0,1680,0,8,1680,0,47.6572,1640
399950.0,3,2.5,3087,0,8,3087,0,47.2974,2927
3567000.0,5,4.5,4850,4,10,3540,1310,47.5943,3470
579000.0,4,3.25,1900,0,9,1250,650,47.5869,1710
362500.0,2,1.5,940,0,7,940,0,47.5925,1130
645000.0,3,3.25,1730,2,9,1320,410,47.6374,1710
594866.0,3,3.0,2780,0,9,2780,0,47.5184,2850
625000.0,3,3.0,2780,0,9,2780,0,47.5184,2850
490000.0,3,2.25,1500,0,8,1220,280,47.6785,1460
399950.0,2,1.0,710,0,7,710,0,47.6413,1370
380000.0,3,2.5,1260,0,7,940,320,47.5621,1310
270000.0,3,2.5,1870,0,7,1870,0,47.3339,2170
505000.0,2,2.5,1430,0,8,1430,0,47.6707,1430
385000.0,3,2.5,1520,0,8,1520,0,47.7337,1520
414500.0,2,1.5,1210,0,8,1020,190,47.6756,1210
347500.0,3,2.5,2540,0,8,2540,0,47.3452,2540
1222500.0,4,3.5,4910,0,11,3110,1800,47.6502,4560
572000.0,4,2.75,2770,0,8,2770,0,47.5001,1810
475000.0,3,2.25,1190,0,8,1190,0,47.6542,1180
1088000.0,5,3.75,4170,2,10,4170,0,47.5354,3030
350000.0,4,2.75,2500,0,8,2500,0,47.3749,2530
520000.0,2,2.25,1530,0,8,1480,50,47.6533,1530
679950.0,5,2.75,3600,0,9,3600,0,47.4822,3550
1575000.0,4,3.25,3410,0,10,3410,0,47.5653,2290
541800.0,4,2.5,3118,2,9,3118,0,47.2931,2673
810000.0,4,3.0,3990,0,9,3990,0,47.6857,3370
1537000.0,5,3.75,4470,0,11,4470,0,47.6321,2780
467000.0,3,2.5,1425,0,8,1425,0,47.6963,1285
224000.0,3,1.75,1500,0,6,1500,0,47.3095,1320
507250.0,3,2.5,2270,0,8,2270,0,47.5389,2270
429000.0,3,2.0,1490,0,8,1490,0,47.5699,1400
610685.0,4,2.5,2520,0,9,2520,0,47.5137,2520
1007500.0,4,3.5,3510,0,9,2600,910,47.5537,2050
475000.0,3,2.5,1310,0,8,1180,130,47.5773,1330
360000.0,3,2.5,1530,0,8,1530,0,47.6993,1530
400000.0,4,2.5,2310,0,8,2310,0,47.5107,1830
402101.0,2,0.75,1020,0,7,1020,0,47.5944,1020
400000.0,3,2.5,1600,0,8,1600,0,47.5345,1410
325000.0,2,0.75,1020,0,7,1020,0,47.5941,1020
